"","unitid","instnm","semester","quarter","year","totcohortsize","w_cohortsize","m_cohortsize","tot4yrgrads","m_4yrgrads","w_4yrgrads","women_gradrate_4yr","total_gradrate_4yr","man_gradrate_4yr","instatetuition","costs","faculty","white_cohortsize","rate_for_white_student"
"1",100654,"ALABAMA A&M UNIVERSITY",1,0,1991,1010,527,483,152,32,120,0.228,0.15,0.066,1298,53.121007,223,11,0.0108910891089109
"2",100654,"ALABAMA A&M UNIVERSITY",1,0,1992,876,444,432,157,46,111,0.25,0.179,0.106,1600,52.536624,267,5,0.00570776255707763
"3",100654,"ALABAMA A & M UNIVERSITY",1,0,1993,1019,543,476,189,55,134,0.247,0.185,0.116,1600,50.39972,262,7,0.00686947988223749
"4",100654,"ALABAMA A & M UNIVERSITY",1,0,1995,849,434,415,185,47,138,0.318,0.218,0.113,2022,68.024267,298,18,0.0212014134275618
"5",100654,"ALABAMA A & M UNIVERSITY",1,0,1996,716,372,344,147,44,103,0.277,0.205,0.128,2312,66.424951,311,17,0.0237430167597765
"6",100654,"ALABAMA A & M UNIVERSITY",1,0,1997,789,412,377,159,41,118,0.286,0.202,0.109,2420,72.461862,306,22,0.0278833967046895
"7",100654,"ALABAMA A & M UNIVERSITY",1,0,1998,995,518,477,182,38,144,0.278,0.183,0.08,2332,78.356177,237,25,0.0251256281407035
"8",100654,"ALABAMA A & M UNIVERSITY",1,0,1999,1111,550,561,97,16,81,0.147,0.087,0.029,1932,75.868666,243,26,0.0234023402340234
"9",100654,"ALABAMA A & M UNIVERSITY",1,0,2000,1020,504,516,118,24,94,0.186,0.116,0.047,2400,79.084093,273.5,26,0.0254901960784314
"10",100654,"ALABAMA A & M UNIVERSITY",1,0,2001,1038,541,497,138,34,104,0.192,0.133,0.068,2400,96.538667,304,18,0.0173410404624277
"11",100654,"ALABAMA A & M UNIVERSITY",1,0,2002,1043,506,537,118,37,81,0.16,0.113,0.069,2520,90.776734,284,18,0.0172579098753595
"12",100654,"ALABAMA A & M UNIVERSITY",1,0,2003,1287,673,614,112,30,82,0.122,0.087,0.049,2832,107.761966,294,17,0.0132090132090132
"13",100654,"ALABAMA A & M UNIVERSITY",1,0,2004,1198,611,587,146,31,115,0.188,0.122,0.053,3120,110.994174,307,10,0.00834724540901502
"14",100654,"Alabama A & M University",1,0,2005,1088,572,516,116,27,89,0.156,0.107,0.052,3120,118.90095,319,13,0.0119485294117647
"15",100654,"Alabama A & M University",1,0,2006,1133,584,549,110,29,81,0.139,0.097,0.053,3120,123.859683,319,12,0.0105913503971756
"16",100654,"Alabama A & M University",1,0,2007,882,475,407,88,21,67,0.141,0.1,0.052,3432,126.371645,311,9,0.0102040816326531
"17",100654,"Alabama A & M University",1,0,2008,1044,568,476,115,23,92,0.162,0.11,0.048,3432,132.165814,309,7,0.00670498084291188
"18",100654,"Alabama A & M University",1,0,2009,1042,537,505,115,22,93,0.173,0.11,0.044,3948,122.977893,311,24,0.0230326295585413
"19",100654,"Alabama A & M University",1,0,2010,1073,549,524,69,18,51,0.093,0.064,0.034,4872,138.956247,276,15,0.0139794967381174
"20",100663,"UNIVERSITY OF ALABAMA AT BIRMINGHAM",0,1,1991,937,500,437,82,33,49,0.098,0.088,0.076,2050,712.376923,709,600,0.64034151547492
"21",100663,"UNIVERSITY OF ALABAMA AT BIRMINGHAM",0,1,1992,898,479,419,54,19,35,0.073,0.06,0.045,2238,812.820108,786,576,0.641425389755011
"22",100663,"UNIVERSITY OF ALABAMA AT BIRMINGHAM",0,1,1993,938,518,420,99,31,68,0.131,0.106,0.074,2358,910.784994,802,613,0.653518123667377
"23",100663,"UNIVERSITY OF ALABAMA AT BIRMINGHAM",0,1,1995,1052,599,453,128,37,91,0.152,0.122,0.082,2604,937.402922,707,602,0.572243346007605
"24",100663,"UNIVERSITY OF ALABAMA AT BIRMINGHAM",0,1,1996,1027,597,430,134,35,99,0.166,0.13,0.081,2700,1024.898335,680,568,0.553067185978578
"25",100663,"UNIVERSITY OF ALABAMA AT BIRMINGHAM",0,1,1997,1115,657,458,161,52,109,0.166,0.144,0.114,2850,1075.711679,690,631,0.565919282511211
"26",100663,"UNIVERSITY OF ALABAMA AT BIRMINGHAM",0,1,1998,1076,646,430,164,48,116,0.18,0.152,0.112,3060,1188.3903,691,611,0.567843866171004
"27",100663,"UNIVERSITY OF ALABAMA AT BIRMINGHAM",0,1,1999,1143,678,465,163,59,104,0.153,0.143,0.127,2730,1180.033219,708,667,0.583552055993001
"28",100663,"UNIVERSITY OF ALABAMA AT BIRMINGHAM",0,1,2000,1234,748,486,173,51,122,0.163,0.14,0.105,2820,1215.222121,564.5,653,0.529173419773096
"29",100663,"UNIVERSITY OF ALABAMA AT BIRMINGHAM",1,0,2001,1224,765,459,175,57,118,0.154,0.143,0.124,2970,1334.286573,421,648,0.529411764705882
"30",100663,"UNIVERSITY OF ALABAMA AT BIRMINGHAM",1,0,2002,1398,820,578,228,86,142,0.173,0.163,0.149,3150,1335.089128,804,775,0.554363376251788
"31",100663,"UNIVERSITY OF ALABAMA AT BIRMINGHAM",1,0,2003,1607,1042,565,266,61,205,0.197,0.166,0.108,3480,1440.737915,833,781,0.485998755444928
"32",100663,"UNIVERSITY OF ALABAMA AT BIRMINGHAM",1,0,2004,1536,973,563,284,82,202,0.208,0.185,0.146,3840,1571.319289,810,846,0.55078125
"33",100663,"University of Alabama at Birmingham",1,0,2005,1515,895,620,350,110,240,0.268,0.231,0.177,3960,1604.47474,824,875,0.577557755775578
"34",100663,"University of Alabama at Birmingham",1,0,2006,1485,895,590,378,124,254,0.284,0.255,0.21,3960,1707.177796,824,905,0.609427609427609
"35",100663,"University of Alabama at Birmingham",1,0,2007,1378,807,571,404,137,267,0.331,0.293,0.24,3384,1824.09488,852,835,0.605950653120464
"36",100663,"University of Alabama at Birmingham",1,0,2008,1246,710,536,406,140,266,0.375,0.326,0.261,3792,2213.659961,849,790,0.634028892455859
"37",100663,"University of Alabama at Birmingham",1,0,2009,1494,819,675,474,188,286,0.349,0.317,0.279,4224,2223.549388,832,932,0.623828647925033
"38",100663,"University of Alabama at Birmingham",1,0,2010,1537,851,686,463,176,287,0.337,0.301,0.257,5806,2338.666019,861,921,0.599219258295381
"39",100751,"THE UNIVERSITY OF ALABAMA",1,0,1991,2511,1348,1163,630,213,417,0.309,0.251,0.183,1936,237.693778,818,2174,0.8657905217045
"40",100751,"THE UNIVERSITY OF ALABAMA",1,0,1992,2436,1310,1126,684,240,444,0.339,0.281,0.213,2068,237.079401,773,2075,0.851806239737274
"41",100751,"THE UNIVERSITY OF ALABAMA",1,0,1993,2516,1318,1198,638,231,407,0.309,0.254,0.193,2172,257.63431,762,2148,0.853736089030207
"42",100751,"THE UNIVERSITY OF ALABAMA",1,0,1995,2493,1387,1106,748,246,502,0.362,0.3,0.222,2374,294.397959,770,2133,0.855595667870036
"43",100751,"THE UNIVERSITY OF ALABAMA",1,0,1996,2049,1195,854,744,240,504,0.422,0.363,0.281,2470,295.929705,738,1777,0.867252318204002
"44",100751,"THE UNIVERSITY OF ALABAMA",1,0,1997,2572,1403,1169,859,307,552,0.393,0.334,0.263,2594,306.024341,750,2111,0.820762052877138
"45",100751,"UNIVERSITY OF ALABAMA",1,0,1998,2597,1437,1160,857,269,588,0.409,0.33,0.232,2684,320.186995,781,2088,0.804004620716211
"46",100751,"UNIVERSITY OF ALABAMA",1,0,1999,2687,1499,1188,948,309,639,0.426,0.353,0.26,2872,341.218829,795,2216,0.824711574246371
"47",100751,"UNIVERSITY OF ALABAMA",1,0,2000,2886,1653,1233,1038,303,735,0.445,0.36,0.246,3014,357.569083,787,2357,0.816701316701317
"48",100751,"UNIVERSITY OF ALABAMA",1,0,2001,2384,1342,1042,920,313,607,0.452,0.386,0.3,3292,380.9844,779,2047,0.858640939597315
"49",100751,"UNIVERSITY OF ALABAMA",1,0,2002,2585,1441,1144,932,318,614,0.426,0.361,0.278,3556,372.067854,794,2230,0.862669245647969
"50",100751,"UNIVERSITY OF ALABAMA",1,0,2003,2982,1685,1297,1121,364,757,0.449,0.376,0.281,4134,392.176082,810,2584,0.866532528504359
"51",100751,"THE UNIVERSITY OF ALABAMA",1,0,2004,3290,1853,1437,1248,426,822,0.444,0.379,0.296,4630,404.323227,800,2873,0.873252279635258
"52",100751,"The University of Alabama",1,0,2005,3642,2038,1604,1373,491,882,0.433,0.377,0.306,4864,449.794843,813,3048,0.836902800658979
"53",100751,"The University of Alabama",1,0,2006,4275,2377,1898,1757,660,1097,0.462,0.411,0.348,5278,496.55614,850,3609,0.84421052631579
"54",100751,"The University of Alabama",1,0,2007,4438,2461,1977,1897,708,1189,0.483,0.427,0.358,5700,565.427668,904,3890,0.876520955385309
"55",100751,"The University of Alabama",1,0,2008,5009,2776,2233,1942,703,1239,0.446,0.388,0.315,6400,629.500088,1067,4280,0.854461968456778
"56",100751,"The University of Alabama",1,0,2009,5062,2746,2316,2093,772,1321,0.481,0.413,0.333,7000,658.67213,1106,4221,0.833860134334255
"57",100751,"The University of Alabama",1,0,2010,5443,3006,2437,2387,856,1531,0.509,0.439,0.351,7900,760.107259,1175,4332,0.795884622450854
"58",100858,"AUBURN UNIVERSITY MAIN CAMPUS",0,1,1991,3024,1496,1528,846,312,534,0.357,0.28,0.204,1596,306.252082,1128,2704,0.894179894179894
"59",100858,"AUBURN UNIVERSITY MAIN CAMPUS",0,1,1992,3141,1621,1520,927,295,632,0.39,0.295,0.194,1755,304.074934,1098,2864,0.911811524992041
"60",100858,"AUBURN UNIVERSITY MAIN CAMPUS",0,1,1993,2997,1552,1445,878,286,592,0.381,0.293,0.198,1950,321.990528,1109,2703,0.901901901901902
"61",100858,"AUBURN UNIVERSITY MAIN CAMPUS",0,1,1995,3486,1832,1654,1106,345,761,0.415,0.317,0.209,2250,368.840182,1131,3175,0.910786001147447
"62",100858,"AUBURN UNIVERSITY MAIN CAMPUS",0,1,1996,3287,1746,1541,1321,446,875,0.501,0.402,0.289,2355,372.270174,1145,2985,0.908122908427137
"63",100858,"AUBURN UNIVERSITY MAIN CAMPUS",0,1,1997,3140,1676,1464,1165,385,780,0.465,0.371,0.263,2565,376.471708,1145,2879,0.91687898089172
"64",100858,"AUBURN UNIVERSITY MAIN CAMPUS",0,1,1998,3654,1913,1741,1229,415,814,0.426,0.336,0.238,2760,393.068124,1139,3278,0.897099069512863
"65",100858,"AUBURN UNIVERSITY MAIN CAMPUS",0,1,1999,3693,1875,1818,1189,393,796,0.425,0.322,0.216,2895,425.358257,1146,3253,0.880855672894666
"66",100858,"AUBURN UNIVERSITY MAIN CAMPUS",1,0,2000,3861,1990,1871,1277,451,826,0.415,0.331,0.241,3050,488.80635,1130.5,3459,0.895881895881896
"67",100858,"AUBURN UNIVERSITY MAIN CAMPUS",1,0,2001,3739,1949,1790,1284,468,816,0.419,0.343,0.261,3260,506.522984,1115,3258,0.8713559775341
"68",100858,"AUBURN UNIVERSITY MAIN CAMPUS",1,0,2002,4148,2184,1964,1424,498,926,0.424,0.343,0.254,3650,481.701655,1142,3596,0.866923818707811
"69",100858,"AUBURN UNIVERSITY MAIN CAMPUS",1,0,2003,3692,1965,1727,1352,444,908,0.462,0.366,0.257,4230,526.647346,1171,3174,0.859696641386782
"70",100858,"AUBURN UNIVERSITY MAIN CAMPUS",1,0,2004,3579,1849,1730,1279,445,834,0.451,0.357,0.257,4610,552.886023,1177,3032,0.847164012293937
"71",100858,"Auburn University Main Campus",1,0,2005,4179,2180,1999,1491,511,980,0.45,0.357,0.256,4800,573.09999,1176,3543,0.84781048097631
"72",100858,"Auburn University Main Campus",1,0,2006,4072,2168,1904,1556,549,1007,0.464,0.382,0.288,5000,580.566562,1139,3328,0.817288801571709
"73",100858,"Auburn University Main Campus",1,0,2007,4165,2207,1958,1565,548,1017,0.461,0.376,0.28,5250,642.808641,1132,3414,0.81968787515006
"74",100858,"Auburn University Main Campus",1,0,2008,3967,2049,1918,1676,627,1049,0.512,0.422,0.327,5880,703.588583,1176,3493,0.88051424250063
"75",100858,"Auburn University Main Campus",1,0,2009,3911,2007,1904,1733,617,1116,0.556,0.443,0.324,6240,722.464527,1184,3363,0.859882383022245
"76",100858,"Auburn University",1,0,2010,4193,2204,1989,1963,730,1233,0.559,0.468,0.367,7008,717.034324,1196,3523,0.840209873598855
"77",101435,"HUNTINGDON COLLEGE",1,0,1991,189,101,88,60,25,35,0.346,0.317,0.284,6400,9.473699,44,158,0.835978835978836
"78",101435,"HUNTINGDON COLLEGE",1,0,1992,166,91,75,53,14,39,0.429,0.319,0.187,7140,10.171244,43,135,0.813253012048193
"79",101435,"HUNTINGDON COLLEGE",1,0,1993,125,80,45,40,7,33,0.413,0.32,0.156,7540,9.918171,44,107,0.856
"80",101435,"HUNTINGDON COLLEGE",1,0,1995,160,106,54,56,17,39,0.368,0.35,0.315,8645,10.530401,41,146,0.9125
"81",101435,"HUNTINGDON COLLEGE",1,0,1996,165,95,70,62,16,46,0.484,0.376,0.229,10140,12.489609,43,140,0.848484848484849
"82",101435,"HUNTINGDON COLLEGE",1,0,1997,191,114,77,89,28,61,0.535,0.466,0.364,10600,9.579237,43,177,0.926701570680628
"83",101435,"HUNTINGDON COLLEGE",1,0,1998,175,96,79,88,31,57,0.594,0.503,0.392,11010,10.739266,44,158,0.902857142857143
"84",101435,"HUNTINGDON COLLEGE",1,0,1999,163,103,60,58,14,44,0.427,0.356,0.233,10500,11.769099,47,144,0.883435582822086
"85",101435,"HUNTINGDON COLLEGE",1,0,2000,151,95,56,67,21,46,0.484,0.444,0.375,11000,12.917579,44.5,134,0.887417218543046
"86",101435,"HUNTINGDON COLLEGE",1,0,2001,146,96,50,58,13,45,0.469,0.397,0.26,11500,12.94124,42,128,0.876712328767123
"87",101435,"HUNTINGDON COLLEGE",1,0,2002,165,108,57,76,21,55,0.509,0.461,0.368,13800,12.133992,41,146,0.884848484848485
"88",101435,"HUNTINGDON COLLEGE",1,0,2003,203,76,127,72,30,42,0.553,0.355,0.236,14560,13.021025,32,171,0.842364532019704
"89",101435,"HUNTINGDON COLLEGE",1,0,2004,192,72,120,71,38,33,0.458,0.37,0.317,15250,13.742147,32,160,0.833333333333333
"90",101435,"Huntingdon College",1,0,2005,185,90,95,78,34,44,0.489,0.422,0.358,15250,13.561949,33,159,0.859459459459459
"91",101435,"Huntingdon College",1,0,2006,214,85,129,72,36,36,0.424,0.336,0.279,15990,14.376885,34,172,0.803738317757009
"92",101435,"Huntingdon College",1,0,2007,257,117,140,78,23,55,0.47,0.304,0.164,17570,16.195889,42,201,0.782101167315175
"93",101435,"Huntingdon College",1,0,2008,253,106,147,76,28,48,0.453,0.3,0.19,19320,17.149742,44,196,0.774703557312253
"94",101435,"Huntingdon College",1,0,2009,237,99,138,58,30,28,0.283,0.245,0.217,19990,19.613024,45,169,0.713080168776371
"95",101435,"Huntingdon College",1,0,2010,271,113,158,71,30,41,0.363,0.262,0.19,18512,18.270813,47,184,0.678966789667897
"96",101480,"JACKSONVILLE STATE UNIVERSITY",1,0,1991,1100,567,533,109,42,67,0.118,0.099,0.079,1420,44.735235,274,829,0.753636363636364
"97",101480,"JACKSONVILLE STATE UNIVERSITY",1,0,1992,1106,615,491,116,34,82,0.133,0.105,0.069,1550,44.403204,274,847,0.765822784810127
"98",101480,"JACKSONVILLE STATE UNIVERSITY",1,0,1993,845,436,409,89,24,65,0.149,0.105,0.059,1680,44.253729,272,648,0.766863905325444
"99",101480,"JACKSONVILLE STATE UNIVERSITY",1,0,1995,798,435,363,136,36,100,0.23,0.17,0.099,1840,51.527144,268,618,0.774436090225564
"100",101480,"JACKSONVILLE STATE UNIVERSITY",1,0,1996,817,446,371,122,23,99,0.222,0.149,0.062,1940,52.688204,255,613,0.75030599755202
"101",101480,"JACKSONVILLE STATE UNIVERSITY",1,0,1997,764,401,363,123,43,80,0.2,0.161,0.118,2040,53.384594,261,582,0.761780104712042
"102",101480,"JACKSONVILLE STATE UNIVERSITY",1,0,1998,752,392,360,112,34,78,0.199,0.149,0.094,2140,54.851891,262,573,0.761968085106383
"103",101480,"JACKSONVILLE STATE UNIVERSITY",1,0,1999,805,455,350,142,44,98,0.215,0.176,0.126,2440,59.640691,262,592,0.735403726708075
"104",101480,"JACKSONVILLE STATE UNIVERSITY",1,0,2000,850,443,407,127,39,88,0.199,0.149,0.096,2640,64.126745,263.5,587,0.690588235294118
"105",101480,"JACKSONVILLE STATE UNIVERSITY",1,0,2001,877,480,397,146,40,106,0.221,0.166,0.101,2940,68.845362,265,569,0.648802736602052
"106",101480,"JACKSONVILLE STATE UNIVERSITY",1,0,2002,1059,567,492,146,41,105,0.185,0.138,0.083,3240,73.23187,289,748,0.70632672332389
"107",101480,"JACKSONVILLE STATE UNIVERSITY",1,0,2003,1044,561,483,139,45,94,0.168,0.133,0.093,3540,78.141276,294,686,0.657088122605364
"108",101480,"JACKSONVILLE STATE UNIVERSITY",1,0,2004,1017,555,462,91,20,71,0.128,0.089,0.043,4040,79.000229,300,657,0.646017699115044
"109",101480,"Jacksonville State University",1,0,2005,1120,595,525,120,37,83,0.139,0.107,0.07,4040,88.692595,305,673,0.600892857142857
"110",101480,"Jacksonville State University",1,0,2006,1106,626,480,106,23,83,0.133,0.096,0.048,4056,94.012203,319,631,0.570524412296564
"111",101480,"Jacksonville State University",1,0,2007,1252,696,556,127,44,83,0.119,0.101,0.079,4056,102.010171,321,633,0.505591054313099
"112",101480,"Jacksonville State University",1,0,2008,1243,663,580,108,31,77,0.116,0.087,0.053,4560,106.1911,322,693,0.557522123893805
"113",101480,"Jacksonville State University",1,0,2009,1220,695,525,137,30,107,0.154,0.112,0.057,5970,107.21413,322,649,0.531967213114754
"114",101480,"Jacksonville State University",1,0,2010,1246,685,561,180,55,125,0.182,0.144,0.098,6780,111.994117,326,755,0.605939004815409
"115",101675,"MILES COLLEGE",1,0,1991,365,144,221,73,41,32,0.222,0.2,0.186,3760,6.785208,33,0,0
"116",101675,"MILES COLLEGE",1,0,1992,226,108,118,107,52,55,0.509,0.473,0.441,3800,7.000046,34,2,0.00884955752212389
"117",101675,"MILES COLLEGE",1,0,1993,331,164,167,162,67,95,0.579,0.489,0.401,3800,7.467967,33,2,0.00604229607250755
"118",101675,"MILES COLLEGE",1,0,1995,229,114,115,120,50,70,0.614,0.524,0.435,4350,10.602918,41,0,0
"119",101675,"MILES COLLEGE",1,0,1996,327,146,181,125,58,67,0.459,0.382,0.32,4500,11.588039,43,0,0
"120",101675,"MILES COLLEGE",1,0,1997,374,169,205,3,2,1,0.006,0.008,0.01,4500,13.616614,45,0,0
"121",101675,"MILES COLLEGE",1,0,1998,340,177,163,133,51,82,0.463,0.391,0.313,4500,15.120712,47,2,0.00588235294117647
"122",101675,"MILES COLLEGE",1,0,1999,319,170,149,113,21,92,0.541,0.354,0.141,4280,16.935835,59,1,0.00313479623824451
"123",101675,"MILES COLLEGE",1,0,2000,425,220,205,85,19,66,0.3,0.2,0.093,4408,18.476231,62.5,0,0
"124",101675,"MILES COLLEGE",1,0,2001,423,213,210,29,9,20,0.094,0.069,0.043,4408,19.047068,66,4,0.00945626477541371
"125",101675,"MILES COLLEGE",1,0,2002,391,195,196,24,7,17,0.087,0.061,0.036,4628,21.703299,87,1,0.00255754475703325
"126",101675,"MILES COLLEGE",1,0,2003,347,179,168,24,6,18,0.101,0.069,0.036,5090,20.421086,111,0,0
"127",101675,"MILES COLLEGE",1,0,2004,427,203,224,49,9,40,0.197,0.115,0.04,5250,17.764171,89,2,0.00468384074941452
"128",101675,"Miles College",1,0,2005,389,177,212,25,4,21,0.119,0.064,0.019,5408,18.373152,92,1,0.0025706940874036
"129",101675,"Miles College",1,0,2006,352,159,193,15,3,12,0.076,0.043,0.016,5950,19.562214,93,3,0.00852272727272727
"130",101675,"Miles College",1,0,2007,486,246,240,29,7,22,0.089,0.06,0.029,6545,23.29124,94,10,0.0205761316872428
"131",101675,"Miles College",1,0,2008,461,213,248,38,5,33,0.155,0.082,0.02,7396,22.606683,102,7,0.0151843817787419
"132",101675,"Miles College",1,0,2009,392,179,213,21,4,17,0.095,0.054,0.019,8506,24.123076,102,3,0.0076530612244898
"133",101675,"Miles College",1,0,2010,343,141,202,44,18,26,0.184,0.128,0.089,9186,25.168124,97,2,0.00583090379008746
"134",101879,"UNIVERSITY OF NORTH ALABAMA",1,0,1991,755,387,368,66,23,43,0.111,0.087,0.062,1296,28.93073,190,664,0.879470198675497
"135",101879,"UNIVERSITY OF NORTH ALABAMA",1,0,1992,554,321,233,74,24,50,0.156,0.134,0.103,1460,30.634016,196,490,0.884476534296029
"136",101879,"UNIVERSITY OF NORTH ALABAMA",1,0,1993,651,371,280,83,16,67,0.181,0.127,0.057,1586,33.092961,200,567,0.870967741935484
"137",101879,"UNIVERSITY OF NORTH ALABAMA",1,0,1995,762,444,318,167,44,123,0.277,0.219,0.138,1910,37.547819,197,638,0.837270341207349
"138",101879,"UNIVERSITY OF NORTH ALABAMA",1,0,1996,790,459,331,99,28,71,0.155,0.125,0.085,1998,37.667269,200,650,0.822784810126582
"139",101879,"UNIVERSITY OF NORTH ALABAMA",1,0,1997,751,448,303,111,20,91,0.203,0.148,0.066,2166,38.513136,193,648,0.862849533954727
"140",101879,"UNIVERSITY OF NORTH ALABAMA",1,0,1998,828,490,338,118,28,90,0.184,0.143,0.083,2256,41.281971,181,648,0.782608695652174
"141",101879,"UNIVERSITY OF NORTH ALABAMA",1,0,1999,809,473,336,127,28,99,0.209,0.157,0.083,2232,43.498762,203,650,0.803461063040791
"142",101879,"UNIVERSITY OF NORTH ALABAMA",1,0,2000,824,481,343,143,35,108,0.224,0.174,0.102,2328,46.720676,199.5,677,0.821601941747573
"143",101879,"UNIVERSITY OF NORTH ALABAMA",1,0,2001,816,465,351,147,36,111,0.239,0.18,0.103,2544,48.111718,196,636,0.779411764705882
"144",101879,"UNIVERSITY OF NORTH ALABAMA",1,0,2002,786,457,329,104,27,77,0.168,0.132,0.082,2784,47.26531,198,586,0.745547073791349
"145",101879,"UNIVERSITY OF NORTH ALABAMA",1,0,2003,789,479,310,142,37,105,0.219,0.18,0.119,3048,50.438912,199,597,0.756653992395437
"146",101879,"UNIVERSITY OF NORTH ALABAMA",1,0,2004,856,469,387,107,27,80,0.171,0.125,0.07,3336,52.826544,200,668,0.780373831775701
"147",101879,"University of North Alabama",1,0,2005,982,526,456,2,1,1,0.002,0.002,0.002,3432,58.125931,208,678,0.690427698574338
"148",101879,"University of North Alabama",1,0,2006,1019,575,444,112,26,86,0.15,0.11,0.059,3528,64.738869,222,622,0.610402355250245
"149",101879,"University of North Alabama",1,0,2007,1023,558,465,126,31,95,0.17,0.123,0.067,3288,72.409169,231,654,0.639296187683284
"150",101879,"University of North Alabama",1,0,2008,988,533,455,119,34,85,0.16,0.12,0.075,4590,83.331019,242,639,0.646761133603239
"151",101879,"University of North Alabama",1,0,2009,1064,597,467,122,33,89,0.149,0.115,0.071,4008,83.368742,236,775,0.728383458646617
"152",101879,"University of North Alabama",1,0,2010,961,562,399,152,43,109,0.194,0.158,0.108,4440,83.854799,238,744,0.774193548387097
"153",102049,"SAMFORD UNIVERSITY",1,0,1991,569,337,232,217,89,128,0.38,0.381,0.384,6540,48.240502,188,536,0.942003514938489
"154",102049,"SAMFORD UNIVERSITY",1,0,1992,662,405,257,295,108,187,0.462,0.446,0.42,7064,52.026138,203,621,0.938066465256798
"155",102049,"SAMFORD UNIVERSITY",1,0,1993,680,438,242,318,117,201,0.459,0.468,0.483,7770,58.215039,215,648,0.952941176470588
"156",102049,"SAMFORD UNIVERSITY",1,0,1995,647,399,248,331,118,213,0.534,0.512,0.476,8648,61.973118,233,617,0.953632148377125
"157",102049,"SAMFORD UNIVERSITY",1,0,1996,646,388,258,329,117,212,0.546,0.509,0.453,9070,86.74612,236,606,0.938080495356037
"158",102049,"SAMFORD UNIVERSITY",1,0,1997,745,470,275,405,139,266,0.566,0.544,0.505,9432,76.461427,240,708,0.950335570469799
"159",102049,"SAMFORD UNIVERSITY",1,0,1998,625,390,235,316,110,206,0.528,0.506,0.468,9904,72.105189,245,594,0.9504
"160",102049,"SAMFORD UNIVERSITY",1,0,1999,674,420,254,353,120,233,0.555,0.524,0.472,10300,73.424281,243,627,0.93026706231454
"161",102049,"SAMFORD UNIVERSITY",1,0,2000,657,427,230,359,122,237,0.555,0.546,0.53,10738,78.166781,250,607,0.923896499238965
"162",102049,"SAMFORD UNIVERSITY",1,0,2001,658,434,224,354,109,245,0.565,0.538,0.487,11490,78.71243,257,597,0.907294832826748
"163",102049,"SAMFORD UNIVERSITY",1,0,2002,652,428,224,5,0,5,0.012,0.008,0,12294,85.76749,260,618,0.947852760736196
"164",102049,"SAMFORD UNIVERSITY",1,0,2003,682,426,256,362,123,239,0.561,0.531,0.48,13154,86.860401,264,615,0.901759530791789
"165",102049,"SAMFORD UNIVERSITY",1,0,2004,665,423,242,359,111,248,0.586,0.54,0.459,13944,92.465026,267,621,0.933834586466165
"166",102049,"Samford University",1,0,2005,699,457,242,358,93,265,0.58,0.512,0.384,14642,98.361913,278,634,0.907010014306152
"167",102049,"Samford University",1,0,2006,644,392,252,326,99,227,0.579,0.506,0.393,16000,108.518914,280,591,0.917701863354037
"168",102049,"Samford University",1,0,2007,711,459,252,348,112,236,0.514,0.489,0.444,17920,121.606795,280,651,0.915611814345992
"169",102049,"Samford University",1,0,2008,705,442,263,336,104,232,0.525,0.477,0.395,19300,117.199761,290,616,0.873758865248227
"170",102049,"Samford University",1,0,2009,730,486,244,430,132,298,0.613,0.589,0.541,20200,121.097466,282,670,0.917808219178082
"171",102049,"Samford University",1,0,2010,711,455,256,417,132,285,0.626,0.586,0.516,21722,123.327778,294,616,0.866385372714487
"172",102094,"UNIVERSITY OF SOUTH ALABAMA",0,1,1991,1245,653,592,117,32,85,0.13,0.094,0.054,2103,266.417287,430,1030,0.827309236947791
"173",102094,"UNIVERSITY OF SOUTH ALABAMA",0,1,1992,1170,668,502,123,38,85,0.127,0.105,0.076,2295,290.55175,418,978,0.835897435897436
"174",102094,"UNIVERSITY OF SOUTH ALABAMA",0,1,1993,1086,621,465,125,38,87,0.14,0.115,0.082,2295,350.467594,434,898,0.826887661141805
"175",102094,"UNIVERSITY OF SOUTH ALABAMA",0,1,1995,1192,674,518,167,54,113,0.168,0.14,0.104,2541,367.218425,447,985,0.826342281879195
"176",102094,"UNIVERSITY OF SOUTH ALABAMA",0,1,1996,1066,590,476,147,37,110,0.186,0.138,0.078,2538,373.112188,442,883,0.828330206378987
"177",102094,"UNIVERSITY OF SOUTH ALABAMA",0,1,1997,1132,663,469,138,38,100,0.151,0.122,0.081,2673,394.685767,432,903,0.797703180212014
"178",102094,"UNIVERSITY OF SOUTH ALABAMA",1,0,1998,1044,618,426,143,36,107,0.173,0.137,0.085,2673,416.897664,435,799,0.765325670498084
"179",102094,"UNIVERSITY OF SOUTH ALABAMA",1,0,1999,882,521,361,122,22,100,0.192,0.138,0.061,2670,409.090635,442,668,0.757369614512472
"180",102094,"UNIVERSITY OF SOUTH ALABAMA",1,0,2000,1064,679,385,167,46,121,0.178,0.157,0.119,2670,452.443943,436,810,0.761278195488722
"181",102094,"UNIVERSITY OF SOUTH ALABAMA",1,0,2001,1116,634,482,160,40,120,0.189,0.143,0.083,2910,449.822503,430,850,0.761648745519713
"182",102094,"UNIVERSITY OF SOUTH ALABAMA",1,0,2002,1004,597,407,135,42,93,0.156,0.134,0.103,3090,477.3036,441,777,0.77390438247012
"183",102094,"UNIVERSITY OF SOUTH ALABAMA",1,0,2003,1218,704,514,155,42,113,0.16,0.127,0.082,3390,496.382826,475,851,0.698686371100164
"184",102094,"UNIVERSITY OF SOUTH ALABAMA",1,0,2004,1278,725,553,180,60,120,0.166,0.141,0.108,3810,436.46,483,882,0.690140845070423
"185",102094,"University of South Alabama",1,0,2005,1198,689,509,199,62,137,0.199,0.166,0.122,3810,450.544,499,836,0.697829716193656
"186",102094,"University of South Alabama",1,0,2006,1355,777,578,190,55,135,0.174,0.14,0.095,3810,469.628,516,941,0.694464944649447
"187",102094,"University of South Alabama",1,0,2007,1457,801,656,200,68,132,0.165,0.137,0.104,4020,493.508,527,991,0.680164722031572
"188",102094,"University of South Alabama",1,0,2008,1543,875,668,230,68,162,0.185,0.149,0.102,4410,548.782,530,1055,0.683732987686325
"189",102094,"University of South Alabama",1,0,2009,1753,927,826,244,83,161,0.174,0.139,0.1,4860,562.493,503,1146,0.65373645179692
"190",102094,"University of South Alabama",1,0,2010,1707,950,757,262,83,179,0.188,0.153,0.11,5448,573.547,514,1074,0.629173989455185
"191",102234,"SPRING HILL COLLEGE",1,0,1991,279,158,121,106,42,64,0.405,0.38,0.347,10149,18.709855,64,229,0.82078853046595
"192",102234,"SPRING HILL COLLEGE",1,0,1992,295,167,128,144,58,86,0.515,0.488,0.453,10763,18.42923,57,255,0.864406779661017
"193",102234,"SPRING HILL COLLEGE",1,0,1993,229,129,100,106,43,63,0.488,0.463,0.43,11425,19.042301,55,205,0.895196506550218
"194",102234,"SPRING HILL COLLEGE",1,0,1995,232,141,91,113,34,79,0.56,0.487,0.374,12489,20.612518,61,198,0.853448275862069
"195",102234,"SPRING HILL COLLEGE",1,0,1996,201,121,80,96,32,64,0.529,0.478,0.4,13140,21.565846,61,176,0.875621890547264
"196",102234,"SPRING HILL COLLEGE",1,0,1997,254,144,110,118,55,63,0.438,0.465,0.5,13890,17.727197,60,221,0.87007874015748
"197",102234,"SPRING HILL COLLEGE",1,0,1998,242,119,123,120,61,59,0.496,0.496,0.496,14620,20.023521,64,210,0.867768595041322
"198",102234,"SPRING HILL COLLEGE",1,0,1999,299,182,117,147,43,104,0.571,0.492,0.368,14390,20.704,65,241,0.806020066889632
"199",102234,"SPRING HILL COLLEGE",1,0,2000,284,186,98,158,47,111,0.597,0.556,0.48,15254,22.569348,66.5,244,0.859154929577465
"200",102234,"SPRING HILL COLLEGE",1,0,2001,251,137,114,112,39,73,0.533,0.446,0.342,16170,23.952361,68,190,0.756972111553785
"201",102234,"SPRING HILL COLLEGE",1,0,2002,289,168,121,151,60,91,0.542,0.522,0.496,16980,24.734786,68,241,0.833910034602076
"202",102234,"SPRING HILL COLLEGE",1,0,2003,308,193,115,157,61,96,0.497,0.51,0.53,17830,25.78484,67,225,0.730519480519481
"203",102234,"SPRING HILL COLLEGE",1,0,2004,309,203,106,156,44,112,0.552,0.505,0.415,18722,26.409427,69,222,0.718446601941748
"204",102234,"Spring Hill College",1,0,2005,274,173,101,139,49,90,0.52,0.507,0.485,19658,28.409001,72,200,0.72992700729927
"205",102234,"Spring Hill College",1,0,2006,345,226,119,189,62,127,0.562,0.548,0.521,20650,32.584827,77,238,0.689855072463768
"206",102234,"Spring Hill College",1,0,2007,380,243,137,179,65,114,0.469,0.471,0.474,21686,34.750036,80,289,0.760526315789474
"207",102234,"Spring Hill College",1,0,2008,344,213,131,175,62,113,0.53,0.509,0.473,22770,37.500046,82,234,0.680232558139535
"208",102234,"Spring Hill College",1,0,2009,355,203,152,152,55,97,0.478,0.428,0.362,23910,39.028934,82,248,0.698591549295775
"209",102234,"Spring Hill College",1,0,2010,392,252,140,180,56,124,0.492,0.459,0.4,25110,36.655935,78,268,0.683673469387755
"210",102368,"TROY STATE UNIVERSITY-MAIN CAMPUS",0,1,1991,793,437,356,205,70,135,0.309,0.259,0.197,1470,36.500128,182,641,0.808322824716267
"211",102368,"TROY STATE UNIVERSITY-MAIN CAMPUS",0,1,1992,935,460,475,217,73,144,0.313,0.232,0.154,1617,39.403478,188,742,0.793582887700535
"212",102368,"TROY STATE UNIVERSITY-MAIN CAMPUS",0,1,1993,926,526,400,303,108,195,0.371,0.327,0.27,1771,52.144416,204,731,0.789416846652268
"213",102368,"TROY STATE UNIVERSITY-MAIN CAMPUS",0,1,1995,877,477,400,354,120,234,0.491,0.404,0.3,2007,59.881931,216,711,0.810718358038769
"214",102368,"TROY STATE UNIVERSITY-MAIN CAMPUS",0,1,1996,877,483,394,340,133,207,0.429,0.388,0.338,2175,52.167403,221,658,0.750285062713797
"215",102368,"TROY STATE UNIVERSITY-MAIN CAMPUS",0,1,1997,803,474,329,307,109,198,0.418,0.382,0.331,2250,53.495511,218,612,0.76214196762142
"216",102368,"TROY STATE UNIVERSITY-MAIN CAMPUS",0,1,1998,768,437,331,251,75,176,0.403,0.327,0.227,2490,56.335477,167,501,0.65234375
"217",102368,"TROY STATE UNIVERSITY-MAIN CAMPUS",1,0,1999,845,510,335,271,85,186,0.365,0.321,0.254,2660,78.209915,169,571,0.675739644970414
"218",102368,"TROY STATE UNIVERSITY-MAIN CAMPUS",1,0,2000,941,513,428,271,105,166,0.324,0.288,0.245,2850,83.562191,217,568,0.603613177470776
"219",102368,"TROY STATE UNIVERSITY-MAIN CAMPUS",1,0,2001,1054,572,482,211,71,140,0.245,0.2,0.147,3020,88.22592,265,666,0.631878557874763
"220",102368,"TROY STATE UNIVERSITY-MAIN CAMPUS",1,0,2002,1353,730,623,288,101,187,0.256,0.213,0.162,3220,90.731765,307,810,0.598669623059867
"221",102368,"TROY STATE UNIVERSITY-MAIN CAMPUS",1,0,2003,1229,672,557,215,66,149,0.222,0.175,0.118,3530,104.401201,314,757,0.615947925142392
"222",102368,"TROY STATE UNIVERSITY-MAIN CAMPUS",1,0,2004,1450,788,662,230,67,163,0.207,0.159,0.101,3850,116.282391,316,866,0.597241379310345
"223",102368,"Troy University",1,0,2005,1434,789,645,201,64,137,0.174,0.14,0.099,4004,169.294425,443,834,0.581589958158996
"224",102368,"Troy University",1,0,2006,1666,964,702,238,77,161,0.167,0.143,0.11,4004,181.050422,444,930,0.558223289315726
"225",102368,"Troy University",1,0,2007,1763,1011,752,222,75,147,0.145,0.126,0.1,4164,201.157077,440,958,0.543391945547362
"226",102368,"Troy University",1,0,2008,1827,1081,746,246,76,170,0.157,0.135,0.102,4248,218.678633,449,988,0.540777230432403
"227",102368,"Troy University",1,0,2009,1997,1192,805,265,78,187,0.157,0.133,0.097,4632,242.41268,490,988,0.494742113169755
"228",102368,"Troy University",1,0,2010,1810,1083,727,295,97,198,0.183,0.163,0.133,5184,255.743537,577,949,0.524309392265193
"229",102377,"TUSKEGEE UNIVERSITY",1,0,1991,837,469,368,167,70,97,0.207,0.2,0.19,6250,60.856009,249,2,0.002389486260454
"230",102377,"TUSKEGEE UNIVERSITY",1,0,1992,612,311,301,123,36,87,0.28,0.201,0.12,6535,65.595003,251,0,0
"231",102377,"TUSKEGEE UNIVERSITY",1,0,1993,595,302,293,104,39,65,0.215,0.175,0.133,6734,73.512513,254,0,0
"232",102377,"TUSKEGEE UNIVERSITY",1,0,1995,645,383,262,139,35,104,0.272,0.216,0.134,7424,73.370861,274,0,0
"233",102377,"TUSKEGEE UNIVERSITY",1,0,1996,810,497,313,180,34,146,0.294,0.222,0.109,8020,72.95511,256,1,0.00123456790123457
"234",102377,"TUSKEGEE UNIVERSITY",1,0,1997,713,466,247,179,29,150,0.322,0.251,0.117,8662,68.289959,227,0,0
"235",102377,"TUSKEGEE UNIVERSITY",1,0,1998,683,412,271,154,37,117,0.284,0.225,0.137,9060,84.325,231,0,0
"236",102377,"TUSKEGEE UNIVERSITY",1,0,1999,679,400,279,119,27,92,0.23,0.175,0.097,9500,79.664577,231,0,0
"237",102377,"TUSKEGEE UNIVERSITY",1,0,2000,591,354,237,149,37,112,0.316,0.252,0.156,9928,86.656778,233.5,0,0
"238",102377,"TUSKEGEE UNIVERSITY",1,0,2001,645,375,270,108,41,67,0.179,0.167,0.152,10326,90.352899,236,0,0
"239",102377,"TUSKEGEE UNIVERSITY",1,0,2002,738,426,312,168,36,132,0.31,0.228,0.115,10584,92.177733,271,0,0
"240",102377,"TUSKEGEE UNIVERSITY",1,0,2003,528,272,256,82,32,50,0.184,0.155,0.125,11060,101.410121,261,0,0
"241",102377,"TUSKEGEE UNIVERSITY",1,0,2004,701,389,312,123,35,88,0.226,0.175,0.112,11290,101.317797,215,3,0.00427960057061341
"242",102377,"Tuskegee University",1,0,2005,730,385,345,112,30,82,0.213,0.153,0.087,11690,102.716507,232,2,0.00273972602739726
"243",102377,"Tuskegee University",1,0,2006,688,395,293,151,33,118,0.299,0.219,0.113,12400,102.156714,275,2,0.00290697674418605
"244",102377,"Tuskegee University",1,0,2007,796,444,352,133,31,102,0.23,0.167,0.088,13520,104.148884,291,2,0.00251256281407035
"245",102377,"Tuskegee University",1,0,2008,722,414,308,154,44,110,0.266,0.213,0.143,14740,109.385376,269,1,0.00138504155124654
"246",102377,"Tuskegee University",1,0,2009,688,410,278,123,25,98,0.239,0.179,0.09,15630,115.530127,273,2,0.00290697674418605
"247",102377,"Tuskegee University",1,0,2010,701,393,308,228,99,129,0.328,0.325,0.321,16100,119.607385,281,0,0
"248",104151,"ARIZONA STATE UNIVERSITY",1,0,1991,2447,1214,1233,442,174,268,0.221,0.181,0.141,1528,473.9779,1514,1864,0.761749080506743
"249",104151,"ARIZONA STATE UNIVERSITY",1,0,1992,2901,1503,1398,452,162,290,0.193,0.156,0.116,1590,473.75,1556,2149,0.740779041709755
"250",104151,"ARIZONA STATE UNIVERSITY-MAIN CAMPUS",1,0,1993,3298,1637,1661,561,203,358,0.219,0.17,0.122,1844,441.428551,1383,2489,0.754699818071559
"251",104151,"ARIZONA STATE UNIVERSITY-MAIN CAMPUS",1,0,1995,3945,2096,1849,854,299,555,0.265,0.216,0.162,1950,500.596,1499,2893,0.733333333333333
"252",104151,"ARIZONA STATE UNIVERSITY-MAIN CAMPUS",1,0,1996,4001,2117,1884,1028,398,630,0.298,0.257,0.211,2009,555.281,1487,2963,0.740564858785304
"253",104151,"ARIZONA STATE UNIVERSITY-MAIN CAMPUS",1,0,1997,4938,2646,2292,1284,448,836,0.316,0.26,0.195,2058,561.256,1530,3683,0.745848521668692
"254",104151,"ARIZONA STATE UNIVERSITY-MAIN CAMPUS",1,0,1998,4753,2561,2192,1270,480,790,0.308,0.267,0.219,2158,620.425,1569,3471,0.7302756154008
"255",104151,"ARIZONA STATE UNIVERSITY-MAIN CAMPUS",1,0,1999,5625,3096,2529,1505,522,983,0.318,0.268,0.206,2188,645.967,1554,3845,0.683555555555556
"256",104151,"ARIZONA STATE UNIVERSITY-MAIN CAMPUS",1,0,2000,5763,3058,2705,1615,596,1019,0.333,0.28,0.22,2272,672.878,1561,4179,0.725143154606976
"257",104151,"ARIZONA STATE UNIVERSITY-MAIN CAMPUS",1,0,2001,5950,3157,2793,1649,599,1050,0.333,0.277,0.214,2412,725.092,1568,4379,0.735966386554622
"258",104151,"ARIZONA STATE UNIVERSITY-MAIN CAMPUS",1,0,2002,6094,3323,2771,1813,661,1152,0.347,0.298,0.239,2508,724.043,1573,4323,0.709386281588448
"259",104151,"ARIZONA STATE UNIVERSITY-MAIN CAMPUS",1,0,2003,6815,3652,3163,1997,730,1267,0.347,0.293,0.231,3508,754.534,1565,4801,0.704475421863536
"260",104151,"ARIZONA STATE UNIVERSITY AT THE TEMPE CAMPUS",1,0,2004,7293,3998,3295,2324,816,1508,0.377,0.319,0.248,3973,836.313,1637,5111,0.700808994926642
"261",104151,"Arizona State University at the Tempe Campus",1,0,2005,7927,4267,3660,2561,996,1565,0.367,0.323,0.272,4311,941.477,1693,5361,0.676296202851016
"262",104151,"Arizona State University at the Tempe Campus",1,0,2006,8533,4556,3977,2837,1145,1692,0.371,0.332,0.288,4591,1032.345,1660,5722,0.670573069260518
"263",104151,"Arizona State University at the Tempe Campus",1,0,2007,7308,3775,3533,2753,1126,1627,0.431,0.377,0.319,4821,1105.217,1715,4900,0.670498084291188
"264",104151,"Arizona State University",1,0,2008,6743,3320,3423,2886,1224,1662,0.501,0.428,0.358,5409,1467.051,2392,4273,0.633694201394038
"265",104151,"Arizona State University",1,0,2009,6747,3279,3468,3054,1335,1719,0.524,0.453,0.385,5997,1465.566,2371,4270,0.632873869868089
"266",104151,"Arizona State University",1,0,2010,6210,2997,3213,3071,1409,1662,0.555,0.495,0.439,7793,1522.401,2416,3773,0.607568438003221
"267",104179,"UNIVERSITY OF ARIZONA",1,0,1991,3970,2063,1907,786,297,489,0.237,0.198,0.156,1528,653.920638,1537,2959,0.745340050377834
"268",104179,"UNIVERSITY OF ARIZONA",1,0,1992,3803,1926,1877,814,302,512,0.266,0.214,0.161,1528,659.330337,1513,2847,0.748619510912438
"269",104179,"UNIVERSITY OF ARIZONA",1,0,1993,4287,2254,2033,968,317,651,0.289,0.226,0.156,1778,697.957633,1349,3124,0.728714718917658
"270",104179,"UNIVERSITY OF ARIZONA",1,0,1995,4370,2382,1988,1160,405,755,0.317,0.265,0.204,1884,756.377936,1360,3116,0.71304347826087
"271",104179,"UNIVERSITY OF ARIZONA",1,0,1996,4006,2102,1904,1145,441,704,0.335,0.286,0.232,2009,757.527117,1386,2899,0.723664503245132
"272",104179,"UNIVERSITY OF ARIZONA",1,0,1997,4431,2409,2022,1294,463,831,0.345,0.292,0.229,2058,788.321093,1370,3213,0.725118483412322
"273",104179,"UNIVERSITY OF ARIZONA",1,0,1998,5088,2773,2315,1595,590,1005,0.362,0.313,0.255,2158,823.883956,1352,3725,0.732114779874214
"274",104179,"UNIVERSITY OF ARIZONA",1,0,1999,5126,2745,2381,1626,623,1003,0.365,0.317,0.262,0,874.441223,1348,3721,0.72590714007023
"275",104179,"UNIVERSITY OF ARIZONA",1,0,2000,5443,2924,2519,1613,618,995,0.34,0.296,0.245,0,931.689062,1364,3984,0.731949292669484
"276",104179,"UNIVERSITY OF ARIZONA",1,0,2001,5727,3005,2722,1871,717,1154,0.384,0.327,0.263,0,982.115345,1380,4087,0.713637157324952
"277",104179,"UNIVERSITY OF ARIZONA",1,0,2002,5613,3008,2605,1805,703,1102,0.366,0.322,0.27,0,978.144,1375,3946,0.703010867628719
"278",104179,"UNIVERSITY OF ARIZONA",1,0,2003,5780,3154,2626,1870,708,1162,0.368,0.324,0.27,3508,1048.994,1362,3980,0.688581314878893
"279",104179,"UNIVERSITY OF ARIZONA",1,0,2004,5566,3008,2558,1880,723,1157,0.385,0.338,0.283,3998,1133.915,1364,3704,0.665468918433345
"280",104179,"University of Arizona",1,0,2005,5785,3115,2670,2104,820,1284,0.412,0.364,0.307,4394,1190.179,1538,3970,0.686257562662057
"281",104179,"University of Arizona",1,0,2006,5788,3092,2696,2085,813,1272,0.411,0.36,0.302,4594,1262.364,1578,3794,0.655494125777471
"282",104179,"University of Arizona",1,0,2007,6231,3395,2836,2485,976,1509,0.445,0.399,0.344,4824,1323.213,1590,4152,0.666345690900337
"283",104179,"University of Arizona",1,0,2008,6331,3377,2954,2536,1017,1519,0.45,0.401,0.344,5274,1416.181,1593,4133,0.652819459800979
"284",104179,"University of Arizona",1,0,2009,6782,3697,3085,2922,1146,1776,0.48,0.431,0.371,6540,1446.773,1546,4241,0.625331760542613
"285",104179,"University of Arizona",1,0,2010,6797,3629,3168,2847,1137,1710,0.471,0.419,0.359,7614,1466.454,1527,3962,0.582904222451081
"286",105330,"NORTHERN ARIZONA UNIVERSITY",1,0,1991,1881,1064,817,294,97,197,0.185,0.156,0.119,1528,148.950758,623,1470,0.781499202551834
"287",105330,"NORTHERN ARIZONA UNIVERSITY",1,0,1992,2095,1203,892,315,104,211,0.175,0.15,0.117,1528,155.940767,608,1645,0.785202863961814
"288",105330,"NORTHERN ARIZONA UNIVERSITY",1,0,1993,1930,1090,840,306,103,203,0.186,0.159,0.123,1844,162.427337,608,1537,0.796373056994819
"289",105330,"NORTHERN ARIZONA UNIVERSITY",1,0,1995,2015,1120,895,436,133,303,0.27,0.216,0.149,1950,192.500577,673,1612,0.8
"290",105330,"NORTHERN ARIZONA UNIVERSITY",1,0,1996,2267,1288,979,538,170,368,0.286,0.237,0.174,2009,205.629327,637,1867,0.823555359505955
"291",105330,"NORTHERN ARIZONA UNIVERSITY",1,0,1997,1983,1169,814,530,154,376,0.322,0.267,0.189,2058,219.898838,650,1676,0.845184064548664
"292",105330,"NORTHERN ARIZONA UNIVERSITY",1,0,1998,2073,1188,885,554,176,378,0.318,0.267,0.199,2160,234.6708,654,1695,0.817655571635311
"293",105330,"NORTHERN ARIZONA UNIVERSITY",1,0,1999,2162,1278,884,562,166,396,0.31,0.26,0.188,2188,240.092866,661,1772,0.819611470860314
"294",105330,"NORTHERN ARIZONA UNIVERSITY",1,0,2000,2273,1384,889,613,174,439,0.317,0.27,0.196,2272,248.33077,684.5,1870,0.822701275846898
"295",105330,"NORTHERN ARIZONA UNIVERSITY",1,0,2001,2146,1299,847,609,169,440,0.339,0.284,0.2,2412,260.664243,708,1769,0.824324324324324
"296",105330,"NORTHERN ARIZONA UNIVERSITY",1,0,2002,2153,1327,826,681,173,508,0.383,0.316,0.209,2507,267.07699,698,1718,0.797956339990711
"297",105330,"NORTHERN ARIZONA UNIVERSITY",1,0,2003,2114,1249,865,644,196,448,0.359,0.305,0.227,3508,269.094817,711,1670,0.789971617786187
"298",105330,"NORTHERN ARIZONA UNIVERSITY",1,0,2004,2274,1309,965,652,190,462,0.353,0.287,0.197,3983,279.23603,710,1769,0.77792436235708
"299",105330,"Northern Arizona University",1,0,2005,2101,1268,833,645,174,471,0.372,0.307,0.209,4223,287.261627,723,1622,0.772013326987149
"300",105330,"Northern Arizona University",1,0,2006,2527,1488,1039,756,224,532,0.358,0.299,0.216,4376,321.198515,751,1931,0.76414721013059
"301",105330,"Northern Arizona University",1,0,2007,2880,1676,1204,868,261,607,0.362,0.301,0.217,4594,341.17368,767,2166,0.752083333333333
"302",105330,"Northern Arizona University",1,0,2008,3248,1899,1349,1078,316,762,0.401,0.332,0.234,5144,369.979882,802,2437,0.750307881773399
"303",105330,"Northern Arizona University",1,0,2009,3377,1951,1426,1122,354,768,0.394,0.332,0.248,6092,368.342789,804,2390,0.707728753331359
"304",105330,"Northern Arizona University",1,0,2010,3739,2209,1530,1354,442,912,0.413,0.362,0.289,5431,369.372061,825,2486,0.664883658732281
"305",106245,"UNIVERSITY OF ARKANSAS AT LITTLE ROCK",1,0,1991,941,536,405,45,14,31,0.058,0.048,0.035,1806,66.930952,413,729,0.77470775770457
"306",106245,"UNIVERSITY OF ARKANSAS AT LITTLE ROCK",1,0,1992,1092,600,492,61,23,38,0.063,0.056,0.047,1902,74.966885,387,781,0.715201465201465
"307",106245,"UNIVERSITY OF ARKANSAS AT LITTLE ROCK",1,0,1993,966,565,401,59,12,47,0.083,0.061,0.03,2098,85.383784,398,613,0.634575569358178
"308",106245,"UNIVERSITY OF ARKANSAS AT LITTLE ROCK",1,0,1995,675,390,285,103,37,66,0.169,0.153,0.13,2368,91.48445,367,456,0.675555555555556
"309",106245,"UNIVERSITY OF ARKANSAS AT LITTLE ROCK",1,0,1996,691,429,262,65,18,47,0.11,0.094,0.069,2538,94.81335,351,437,0.632416787264834
"310",106245,"UNIVERSITY OF ARKANSAS AT LITTLE ROCK",1,0,1997,841,503,338,46,13,33,0.066,0.055,0.038,2538,99.547218,362,503,0.598097502972652
"311",106245,"UNIVERSITY OF ARKANSAS AT LITTLE ROCK",1,0,1998,865,539,326,93,22,71,0.132,0.108,0.067,2616,100.785364,369,506,0.584971098265896
"312",106245,"UNIVERSITY OF ARKANSAS AT LITTLE ROCK",1,0,1999,826,518,308,51,12,39,0.075,0.062,0.039,2424,104.557569,371,466,0.564164648910412
"313",106245,"UNIVERSITY OF ARKANSAS AT LITTLE ROCK",1,0,2000,836,484,352,73,28,45,0.093,0.087,0.08,2544,111.990298,407.5,424,0.507177033492823
"314",106245,"UNIVERSITY OF ARKANSAS AT LITTLE ROCK",1,0,2001,703,410,293,57,19,38,0.093,0.081,0.065,2664,118.712945,444,392,0.557610241820768
"315",106245,"UNIVERSITY OF ARKANSAS AT LITTLE ROCK",1,0,2002,739,456,283,72,19,53,0.116,0.097,0.067,2850,135.560539,449,419,0.566982408660352
"316",106245,"UNIVERSITY OF ARKANSAS AT LITTLE ROCK",1,0,2003,691,405,286,29,9,20,0.049,0.042,0.031,3024,125.262422,488,373,0.539797395079595
"317",106245,"UNIVERSITY OF ARKANSAS AT LITTLE ROCK",1,0,2004,759,452,307,54,18,36,0.08,0.071,0.059,3216,129.817233,496,410,0.540184453227932
"318",106245,"University of Arkansas at Little Rock",1,0,2005,762,445,317,64,24,40,0.09,0.084,0.076,3384,137.975421,513,403,0.528871391076115
"319",106245,"University of Arkansas at Little Rock",1,0,2006,603,317,286,40,19,21,0.066,0.066,0.066,3552,147.070389,505,334,0.553897180762852
"320",106245,"University of Arkansas at Little Rock",1,0,2007,812,471,341,57,28,29,0.062,0.07,0.082,4612,162.940924,474,449,0.552955665024631
"321",106245,"University of Arkansas at Little Rock",1,0,2008,618,375,243,50,23,27,0.072,0.081,0.095,4890,165.415216,513,345,0.558252427184466
"322",106245,"University of Arkansas at Little Rock",1,0,2009,674,387,287,74,27,47,0.121,0.11,0.094,5040,172.642915,542,367,0.544510385756677
"323",106245,"University of Arkansas at Little Rock",1,0,2010,683,376,307,80,40,40,0.106,0.117,0.13,5228,183.646086,507,370,0.541727672035139
"324",106342,"ARKANSAS COLLEGE",1,0,1991,121,79,42,48,17,31,0.392,0.397,0.405,7040,11.115733,47,109,0.900826446280992
"325",106342,"ARKANSAS COLLEGE",1,0,1992,138,80,58,51,21,30,0.375,0.37,0.362,7603,11.154947,43,118,0.855072463768116
"326",106342,"ARKANSAS COLLEGE",1,0,1993,166,84,82,65,29,36,0.429,0.392,0.354,8060,12.06755,42,159,0.957831325301205
"327",106342,"LYON COLLEGE",1,0,1995,168,90,78,82,32,50,0.556,0.488,0.41,8990,14.551215,45,152,0.904761904761905
"328",106342,"LYON COLLEGE",1,0,1996,129,69,60,60,22,38,0.551,0.465,0.367,9490,15.341143,41,113,0.875968992248062
"329",106342,"LYON COLLEGE",1,0,1997,125,63,62,54,19,35,0.556,0.432,0.306,10100,15.219613,42,110,0.88
"330",106342,"LYON COLLEGE",1,0,1998,107,65,42,56,21,35,0.538,0.523,0.5,10526,12.912261,44,96,0.897196261682243
"331",106342,"LYON COLLEGE",1,0,1999,141,79,62,82,33,49,0.62,0.582,0.532,10272,11.973992,42,119,0.843971631205674
"332",106342,"LYON COLLEGE",1,0,2000,127,71,56,74,30,44,0.62,0.583,0.536,10580,12.620318,41.5,113,0.889763779527559
"333",106342,"LYON COLLEGE",1,0,2001,129,80,49,68,20,48,0.6,0.527,0.408,11000,13.249037,41,116,0.89922480620155
"334",106342,"LYON COLLEGE",1,0,2002,113,47,66,62,33,29,0.617,0.549,0.5,11540,14.038655,42,100,0.884955752212389
"335",106342,"LYON COLLEGE",1,0,2003,120,67,53,53,23,30,0.448,0.442,0.434,11990,14.475051,44,102,0.85
"336",106342,"LYON COLLEGE",1,0,2004,141,66,75,62,37,25,0.379,0.44,0.493,12710,15.217678,44,114,0.808510638297872
"337",106342,"Lyon College",1,0,2005,111,61,50,45,20,25,0.41,0.405,0.4,13475,15.596827,44,100,0.900900900900901
"338",106342,"Lyon College",1,0,2006,128,61,67,56,27,29,0.475,0.438,0.403,14420,16.768221,43,106,0.828125
"339",106342,"Lyon College",1,0,2007,143,84,59,62,19,43,0.512,0.434,0.322,15466,16.838872,44,117,0.818181818181818
"340",106342,"Lyon College",1,0,2008,102,52,50,50,25,25,0.481,0.49,0.5,18500,17.219269,44,83,0.813725490196078
"341",106342,"Lyon College",1,0,2009,216,114,102,75,39,36,0.316,0.347,0.382,19424,17.198309,41,181,0.837962962962963
"342",106342,"Lyon College",1,0,2010,198,107,91,70,29,41,0.383,0.354,0.319,21100,16.384601,43,154,0.777777777777778
"343",106397,"UNIVERSITY OF ARKANSAS-FAYETTEVILLE",1,0,1991,2327,1080,1247,381,170,211,0.195,0.164,0.136,1732,223.112331,771,1989,0.854748603351955
"344",106397,"UNIVERSITY OF ARKANSAS-FAYETTEVILLE",1,0,1992,2327,1066,1261,394,165,229,0.215,0.169,0.131,1838,235.65706,790,2047,0.879673399226472
"345",106397,"UNIVERSITY OF ARKANSAS AT FAYETTEVILLE",1,0,1993,2015,964,1051,401,158,243,0.252,0.199,0.15,1946,258.492229,806,1753,0.869975186104218
"346",106397,"UNIVERSITY OF ARKANSAS AT FAYETTEVILLE",1,0,1995,2249,1148,1101,425,155,270,0.235,0.189,0.141,2130,262.437478,808,1863,0.828368163628279
"347",106397,"UNIVERSITY OF ARKANSAS AT FAYETTEVILLE",1,0,1996,2174,1105,1069,490,184,306,0.277,0.225,0.172,2639,273.752564,770,1784,0.820607175712971
"348",106397,"UNIVERSITY OF ARKANSAS AT FAYETTEVILLE",1,0,1997,2125,1077,1048,515,191,324,0.301,0.242,0.182,2896,295.246981,828,1770,0.832941176470588
"349",106397,"UNIVERSITY OF ARKANSAS AT FAYETTEVILLE",1,0,1998,2456,1245,1211,665,246,419,0.336,0.271,0.203,3119,304.079692,810,2085,0.848941368078176
"350",106397,"UNIVERSITY OF ARKANSAS AT FAYETTEVILLE",1,0,1999,2189,1123,1066,666,235,431,0.384,0.304,0.22,2800,328.070118,796,1791,0.818181818181818
"351",106397,"UNIVERSITY OF ARKANSAS MAIN CAMPUS",1,0,2000,2179,1092,1087,645,246,399,0.365,0.296,0.226,2968,358.103265,796.5,1848,0.848095456631482
"352",106397,"UNIVERSITY OF ARKANSAS MAIN CAMPUS",1,0,2001,2190,1126,1064,718,290,428,0.38,0.328,0.273,3116,405.021129,797,1877,0.857077625570776
"353",106397,"UNIVERSITY OF ARKANSAS MAIN CAMPUS",1,0,2002,2137,1106,1031,707,284,423,0.382,0.331,0.275,3573,418.897605,791,1792,0.838558727187646
"354",106397,"UNIVERSITY OF ARKANSAS MAIN CAMPUS",1,0,2003,2260,1175,1085,775,318,457,0.389,0.343,0.293,3810,452.004811,792,1942,0.85929203539823
"355",106397,"UNIVERSITY OF ARKANSAS MAIN CAMPUS",1,0,2004,2420,1222,1198,835,329,506,0.414,0.345,0.275,4115,447.253852,797,2053,0.848347107438017
"356",106397,"University of Arkansas Main Campus",1,0,2005,2662,1324,1338,913,375,538,0.406,0.343,0.28,4361,474.902451,905,2224,0.835462058602555
"357",106397,"University of Arkansas Main Campus",1,0,2006,2719,1346,1373,945,398,547,0.406,0.348,0.29,4590,522.232149,922,2318,0.852519308569327
"358",106397,"University of Arkansas Main Campus",1,0,2007,2877,1425,1452,1055,456,599,0.42,0.367,0.314,4772,538.384622,874,2421,0.841501564129301
"359",106397,"University of Arkansas Main Campus",1,0,2008,2977,1488,1489,1108,475,633,0.425,0.372,0.319,5010,586.75709,908,2487,0.835404769902586
"360",106397,"University of Arkansas",1,0,2009,2890,1448,1442,1129,466,663,0.458,0.391,0.323,5010,613.97157,908,2409,0.83356401384083
"361",106397,"University of Arkansas",1,0,2010,3774,1929,1845,1596,634,962,0.499,0.423,0.344,5211,634.57647,952,3079,0.815845257021728
"362",106412,"UNIVERSITY OF ARKANSAS-PINE BLUFF",1,0,1991,650,393,257,55,15,40,0.102,0.085,0.058,1451,34.656117,165,67,0.103076923076923
"363",106412,"UNIVERSITY OF ARKANSAS-PINE BLUFF",1,0,1992,592,341,251,27,9,18,0.053,0.046,0.036,1451,30.591311,167,57,0.0962837837837838
"364",106412,"UNIVERSITY OF ARKANSAS AT PINE BLUFF",1,0,1993,735,379,356,52,15,37,0.098,0.071,0.042,1584,33.71504,192,40,0.054421768707483
"365",106412,"UNIVERSITY OF ARKANSAS AT PINE BLUFF",1,0,1995,565,302,263,39,11,28,0.093,0.069,0.042,1788,38.780538,185,15,0.0265486725663717
"366",106412,"UNIVERSITY OF ARKANSAS AT PINE BLUFF",1,0,1996,575,302,273,47,12,35,0.116,0.082,0.044,1860,40.701007,183,7,0.0121739130434783
"367",106412,"UNIVERSITY OF ARKANSAS AT PINE BLUFF",1,0,1997,608,297,311,51,12,39,0.131,0.084,0.039,2046,41.22223,176,12,0.0197368421052632
"368",106412,"UNIVERSITY OF ARKANSAS AT PINE BLUFF",1,0,1998,721,372,349,70,22,48,0.129,0.097,0.063,2082,43.528471,175,13,0.0180305131761442
"369",106412,"UNIVERSITY OF ARKANSAS AT PINE BLUFF",1,0,1999,656,341,315,76,20,56,0.164,0.116,0.063,2058,47.659621,173,8,0.0121951219512195
"370",106412,"UNIVERSITY OF ARKANSAS AT PINE BLUFF",1,0,2000,629,330,299,43,13,30,0.091,0.068,0.043,2400,51.173248,172,11,0.0174880763116057
"371",106412,"UNIVERSITY OF ARKANSAS AT PINE BLUFF",1,0,2001,700,371,329,97,21,76,0.205,0.139,0.064,2490,62.741754,171,7,0.01
"372",106412,"UNIVERSITY OF ARKANSAS AT PINE BLUFF",1,0,2002,712,358,354,63,16,47,0.131,0.088,0.045,2664,56.905131,168,10,0.0140449438202247
"373",106412,"UNIVERSITY OF ARKANSAS AT PINE BLUFF",1,0,2003,731,333,398,47,12,35,0.105,0.064,0.03,2820,58.111077,167,11,0.0150478796169631
"374",106412,"UNIVERSITY OF ARKANSAS AT PINE BLUFF",1,0,2004,690,365,325,47,14,33,0.09,0.068,0.043,3000,60.114488,168,10,0.0144927536231884
"375",106412,"University of Arkansas at Pine Bluff",1,0,2005,714,349,365,74,24,50,0.143,0.104,0.066,3150,63.387112,164,13,0.0182072829131653
"376",106412,"University of Arkansas at Pine Bluff",1,0,2006,688,340,348,55,18,37,0.109,0.08,0.052,3300,69.434213,160,7,0.0101744186046512
"377",106412,"University of Arkansas at Pine Bluff",1,0,2007,786,411,375,44,10,34,0.083,0.056,0.027,3300,66.401932,164,8,0.0101781170483461
"378",106412,"University of Arkansas at Pine Bluff",1,0,2008,952,504,448,93,21,72,0.143,0.098,0.047,3450,68.436091,167,11,0.0115546218487395
"379",106412,"University of Arkansas at Pine Bluff",1,0,2009,959,523,436,67,16,51,0.098,0.07,0.037,3540,71.718237,173,14,0.0145985401459854
"380",106412,"University of Arkansas at Pine Bluff",1,0,2010,780,393,387,51,13,38,0.097,0.065,0.034,3750,73.752906,171,9,0.0115384615384615
"381",106458,"ARKANSAS STATE UNIVERSITY MAIN CAMPUS",1,0,1991,1521,833,688,147,44,103,0.124,0.097,0.064,1420,68.184205,403,1225,0.805391190006575
"382",106458,"ARKANSAS STATE UNIVERSITY MAIN CAMPUS",1,0,1992,1607,855,752,164,48,116,0.136,0.102,0.064,1610,75.067613,410,1259,0.783447417548227
"383",106458,"ARKANSAS STATE UNIVERSITY-MAIN CAMPUS",1,0,1993,1487,812,675,190,66,124,0.153,0.128,0.098,1810,83.087326,393,1272,0.855413584398117
"384",106458,"ARKANSAS STATE UNIVERSITY-MAIN CAMPUS",1,0,1995,1448,803,645,218,65,153,0.19,0.151,0.101,1950,81.921797,404,1213,0.837707182320442
"385",106458,"ARKANSAS STATE UNIVERSITY-MAIN CAMPUS",1,0,1996,1592,893,699,216,64,152,0.17,0.136,0.092,1970,87.108046,405,1320,0.829145728643216
"386",106458,"ARKANSAS STATE UNIVERSITY-MAIN CAMPUS",1,0,1997,1687,922,765,249,89,160,0.174,0.148,0.116,2280,93.326043,435,1399,0.829282750444576
"387",106458,"ARKANSAS STATE UNIVERSITY-MAIN CAMPUS",1,0,1998,1705,928,777,270,68,202,0.218,0.158,0.088,2804,99.212246,422,1393,0.817008797653959
"388",106458,"ARKANSAS STATE UNIVERSITY-MAIN CAMPUS",1,0,1999,1654,937,717,303,92,211,0.225,0.183,0.128,2352,108.026388,422,1347,0.814389359129383
"389",106458,"ARKANSAS STATE UNIVERSITY-MAIN CAMPUS",1,0,2000,1591,893,698,307,97,210,0.235,0.193,0.139,2520,118.268552,425.5,1301,0.817724701445632
"390",106458,"ARKANSAS STATE UNIVERSITY-MAIN CAMPUS",1,0,2001,1594,921,673,309,86,223,0.242,0.194,0.128,3360,125.768133,429,1325,0.831242158092848
"391",106458,"ARKANSAS STATE UNIVERSITY-MAIN CAMPUS",1,0,2002,1539,813,726,291,109,182,0.224,0.189,0.15,3570,131.818689,432,1254,0.814814814814815
"392",106458,"ARKANSAS STATE UNIVERSITY-MAIN CAMPUS",1,0,2003,1426,798,628,233,70,163,0.204,0.163,0.111,3750,127.872344,446,1111,0.779102384291725
"393",106458,"ARKANSAS STATE UNIVERSITY-MAIN CAMPUS",1,0,2004,1296,749,547,212,71,141,0.188,0.164,0.13,4035,134.879325,454,907,0.699845679012346
"394",106458,"Arkansas State University-Main Campus",1,0,2005,1483,826,657,288,108,180,0.218,0.194,0.164,4260,141.965861,447,1068,0.720161834120027
"395",106458,"Arkansas State University-Main Campus",1,0,2006,1659,946,713,345,124,221,0.234,0.208,0.174,4470,145.991553,485,1232,0.742616033755274
"396",106458,"Arkansas State University-Main Campus",1,0,2007,1655,962,693,309,102,207,0.215,0.187,0.147,4620,154.934121,490,1203,0.726888217522659
"397",106458,"Arkansas State University-Main Campus",1,0,2008,1743,981,762,352,129,223,0.227,0.202,0.169,4890,163.827062,461,1037,0.59495123350545
"398",106458,"Arkansas State University-Main Campus",1,0,2009,1645,874,771,349,154,195,0.223,0.212,0.2,4890,178.265954,482,987,0.6
"399",106458,"Arkansas State University-Main Campus",1,0,2010,1659,897,762,438,167,271,0.302,0.264,0.219,5100,182.021874,482,1152,0.694394213381555
"400",106467,"ARKANSAS TECH UNIVERSITY",1,0,1991,761,403,358,103,32,71,0.176,0.135,0.089,1460,26.002508,176,728,0.956636005256242
"401",106467,"ARKANSAS TECH UNIVERSITY",1,0,1992,812,438,374,112,33,79,0.18,0.138,0.088,1560,28.869859,180,773,0.951970443349754
"402",106467,"ARKANSAS TECH UNIVERSITY",1,0,1993,847,404,443,117,43,74,0.183,0.138,0.097,1710,31.658172,180,800,0.944510035419126
"403",106467,"ARKANSAS TECH UNIVERSITY",1,0,1995,756,386,370,133,46,87,0.225,0.176,0.124,1910,34.490892,181,705,0.932539682539683
"404",106467,"ARKANSAS TECH UNIVERSITY",1,0,1996,668,339,329,94,40,54,0.159,0.141,0.122,1992,35.463554,185,619,0.926646706586826
"405",106467,"ARKANSAS TECH UNIVERSITY",1,0,1997,725,376,349,83,32,51,0.136,0.114,0.092,2126,35.226185,187,664,0.915862068965517
"406",106467,"ARKANSAS TECH UNIVERSITY",1,0,1998,821,401,420,105,41,64,0.16,0.128,0.098,2288,37.112382,186,754,0.918392204628502
"407",106467,"ARKANSAS TECH UNIVERSITY",1,0,1999,1055,508,547,146,55,91,0.179,0.138,0.101,2352,40.266475,192,966,0.91563981042654
"408",106467,"ARKANSAS TECH UNIVERSITY",1,0,2000,1124,593,531,205,70,135,0.228,0.182,0.132,2588,47.436534,201,1030,0.916370106761566
"409",106467,"ARKANSAS TECH UNIVERSITY",1,0,2001,1202,564,638,235,108,127,0.225,0.196,0.169,2796,50.957369,210,1086,0.903494176372712
"410",106467,"ARKANSAS TECH UNIVERSITY",1,0,2002,1169,624,545,207,80,127,0.204,0.177,0.147,3076,51.870418,209,1058,0.905047048759624
"411",106467,"ARKANSAS TECH UNIVERSITY",1,0,2003,1445,723,722,248,96,152,0.21,0.172,0.133,3312,52.922678,229,1312,0.907958477508651
"412",106467,"ARKANSAS TECH UNIVERSITY",1,0,2004,1398,728,670,199,72,127,0.174,0.142,0.107,3696,60.56906,240,1226,0.876967095851216
"413",106467,"Arkansas Tech University",1,0,2005,1457,714,743,253,104,149,0.209,0.174,0.14,3432,64.422441,252,1265,0.868222374742622
"414",106467,"Arkansas Tech University",1,0,2006,1426,711,715,234,83,151,0.212,0.164,0.116,3576,74.719344,265,1209,0.847826086956522
"415",106467,"Arkansas Tech University",1,0,2007,1548,762,786,278,131,147,0.193,0.18,0.167,3672,79.441581,277,1300,0.839793281653747
"416",106467,"Arkansas Tech University",1,0,2008,1450,763,687,305,115,190,0.249,0.21,0.167,3864,87.14127,290,1272,0.877241379310345
"417",106467,"Arkansas Tech University",1,0,2009,1744,882,862,375,139,236,0.268,0.215,0.161,4008,88.982771,294,1517,0.869839449541284
"418",106467,"Arkansas Tech University",1,0,2010,1681,823,858,259,105,154,0.187,0.154,0.122,4080,97.262093,290,1383,0.822724568709102
"419",106485,"UNIVERSITY OF ARKANSAS-MONTICELLO",1,0,1991,478,256,222,33,13,20,0.078,0.069,0.059,1500,15.865681,107,387,0.809623430962343
"420",106485,"UNIVERSITY OF ARKANSAS-MONTICELLO",1,0,1992,581,302,279,53,15,38,0.126,0.091,0.054,1500,18.33616,116,459,0.790017211703959
"421",106485,"UNIVERSITY OF ARKANSAS AT MONTICELLO",1,0,1993,508,249,259,31,12,19,0.076,0.061,0.046,1500,18.597513,117,399,0.785433070866142
"422",106485,"UNIVERSITY OF ARKANSAS AT MONTICELLO",1,0,1995,489,254,235,46,14,32,0.126,0.094,0.06,1786,19.243061,118,387,0.791411042944785
"423",106485,"UNIVERSITY OF ARKANSAS AT MONTICELLO",1,0,1996,453,240,213,44,19,25,0.104,0.097,0.089,1906,20.398269,112,373,0.823399558498896
"424",106485,"UNIVERSITY OF ARKANSAS AT MONTICELLO",1,0,1997,620,342,278,47,8,39,0.114,0.076,0.029,2145,19.714496,107,486,0.783870967741935
"425",106485,"UNIVERSITY OF ARKANSAS AT MONTICELLO",1,0,1998,558,292,266,52,18,34,0.116,0.093,0.068,2330,21.190306,114,423,0.758064516129032
"426",106485,"UNIVERSITY OF ARKANSAS AT MONTICELLO",1,0,1999,685,370,315,53,15,38,0.103,0.077,0.048,2100,22.692496,113,465,0.678832116788321
"427",106485,"UNIVERSITY OF ARKANSAS AT MONTICELLO",1,0,2000,628,346,282,51,17,34,0.098,0.081,0.06,2250,24.545274,113.5,447,0.711783439490446
"428",106485,"UNIVERSITY OF ARKANSAS AT MONTICELLO",1,0,2001,654,382,272,51,15,36,0.094,0.078,0.055,2370,26.598513,114,465,0.711009174311927
"429",106485,"UNIVERSITY OF ARKANSAS AT MONTICELLO",1,0,2002,645,368,277,46,14,32,0.087,0.071,0.051,2490,24.949695,119,440,0.682170542635659
"430",106485,"UNIVERSITY OF ARKANSAS AT MONTICELLO",1,0,2003,674,371,303,57,25,32,0.086,0.085,0.083,2700,24.309914,152,432,0.640949554896142
"431",106485,"UNIVERSITY OF ARKANSAS AT MONTICELLO",1,0,2004,629,327,302,60,25,35,0.107,0.095,0.083,2850,31.026802,134,394,0.626391096979332
"432",106485,"University of Arkansas at Monticello",1,0,2005,625,337,288,55,20,35,0.104,0.088,0.069,3000,32.133887,145,373,0.5968
"433",106485,"University of Arkansas at Monticello",1,0,2006,630,335,295,71,28,43,0.128,0.113,0.095,3150,33.968869,150,407,0.646031746031746
"434",106485,"University of Arkansas at Monticello",1,0,2007,617,303,314,52,19,33,0.109,0.084,0.061,3240,35.284984,149,413,0.66936790923825
"435",106485,"University of Arkansas at Monticello",1,0,2008,661,361,300,89,33,56,0.155,0.135,0.11,3420,38.199157,146,457,0.691376701966717
"436",106485,"University of Arkansas at Monticello",1,0,2009,740,373,367,63,16,47,0.126,0.085,0.044,3510,38.751492,148,440,0.594594594594595
"437",106485,"University of Arkansas at Monticello",1,0,2010,689,338,351,69,30,39,0.115,0.1,0.085,3600,40.527455,151,374,0.542815674891147
"438",106704,"UNIVERSITY OF CENTRAL ARKANSAS",1,0,1991,1961,1129,832,171,46,125,0.111,0.087,0.055,1370,50.883237,325,1538,0.784293727689954
"439",106704,"UNIVERSITY OF CENTRAL ARKANSAS",1,0,1992,1948,1150,798,352,116,236,0.205,0.181,0.145,1546,58.901275,337,1535,0.787987679671458
"440",106704,"UNIVERSITY OF CENTRAL ARKANSAS",1,0,1993,1792,1098,694,283,94,189,0.172,0.158,0.135,1730,65.239982,340,1388,0.774553571428571
"441",106704,"UNIVERSITY OF CENTRAL ARKANSAS",1,0,1995,1469,920,549,207,46,161,0.175,0.141,0.084,2010,76.476851,356,1218,0.829135466303608
"442",106704,"UNIVERSITY OF CENTRAL ARKANSAS",1,0,1996,1478,928,550,239,69,170,0.183,0.162,0.125,2392,84.725464,367,1211,0.819350473612991
"443",106704,"UNIVERSITY OF CENTRAL ARKANSAS",1,0,1997,1598,1031,567,284,55,229,0.222,0.178,0.097,2692,76.121168,377,1335,0.835419274092616
"444",106704,"UNIVERSITY OF CENTRAL ARKANSAS",1,0,1998,1575,944,631,249,58,191,0.202,0.158,0.092,3038,80.447014,370,1302,0.826666666666667
"445",106704,"UNIVERSITY OF CENTRAL ARKANSAS",1,0,1999,1729,1030,699,272,86,186,0.181,0.157,0.123,2758,84.305052,376,1413,0.817235396182765
"446",106704,"UNIVERSITY OF CENTRAL ARKANSAS",1,0,2000,1627,982,645,325,80,245,0.25,0.2,0.124,2856,94.728092,391.5,1286,0.790411800860479
"447",106704,"UNIVERSITY OF CENTRAL ARKANSAS",1,0,2001,1668,1028,640,367,102,265,0.258,0.22,0.159,3060,95.47688,407,1229,0.736810551558753
"448",106704,"UNIVERSITY OF CENTRAL ARKANSAS",1,0,2002,1766,1062,704,389,108,281,0.265,0.22,0.153,3312,105.550564,413,1331,0.753680634201585
"449",106704,"UNIVERSITY OF CENTRAL ARKANSAS",1,0,2003,2414,1450,964,527,165,362,0.25,0.218,0.171,3770,98.957126,462,1741,0.721209610604805
"450",106704,"UNIVERSITY OF CENTRAL ARKANSAS",1,0,2004,2216,1313,903,468,131,337,0.257,0.211,0.145,4060,112.207654,450,1656,0.747292418772563
"451",106704,"University of Central Arkansas",1,0,2005,2429,1376,1053,467,136,331,0.241,0.192,0.129,4500,120.911805,478,1641,0.675586661177439
"452",106704,"University of Central Arkansas",1,0,2006,2352,1340,1012,538,187,351,0.262,0.229,0.185,4695,143.10546,514,1532,0.651360544217687
"453",106704,"University of Central Arkansas",1,0,2007,1763,1054,709,362,118,244,0.231,0.205,0.166,4830,160.872799,510,1247,0.707317073170732
"454",106704,"University of Central Arkansas",1,0,2008,2075,1165,910,444,157,287,0.246,0.214,0.173,5100,166.471572,510,1435,0.691566265060241
"455",106704,"University of Central Arkansas",1,0,2009,1753,1023,730,403,136,267,0.261,0.23,0.186,5205,173.776445,512,1221,0.696520250998289
"456",106704,"University of Central Arkansas",1,0,2010,1828,1070,758,445,155,290,0.271,0.243,0.204,5235,174.94657,515,1194,0.653172866520788
"457",107044,"HARDING UNIVERSITY",1,0,1991,673,383,290,192,65,127,0.332,0.285,0.224,5205,38.827179,163,600,0.891530460624071
"458",107044,"HARDING UNIVERSITY",1,0,1992,818,434,384,238,91,147,0.339,0.291,0.237,5460,41.713286,167,688,0.841075794621027
"459",107044,"HARDING UNIVERSITY",1,0,1993,793,437,356,244,101,143,0.327,0.308,0.284,5790,42.659551,179,696,0.877679697351828
"460",107044,"HARDING UNIVERSITY",1,0,1995,779,437,342,250,92,158,0.362,0.321,0.269,6420,49.509745,173,696,0.893453145057766
"461",107044,"HARDING UNIVERSITY",1,0,1996,846,497,349,266,85,181,0.364,0.314,0.244,6825,53.119249,178,753,0.890070921985816
"462",107044,"HARDING UNIVERSITY",1,0,1997,863,495,368,271,85,186,0.376,0.314,0.231,7230,47.98777,179,707,0.819235225955968
"463",107044,"HARDING UNIVERSITY",1,0,1998,908,535,373,285,101,184,0.344,0.314,0.271,7530,51.145275,182,793,0.873348017621145
"464",107044,"HARDING UNIVERSITY",1,0,1999,941,488,453,313,130,183,0.375,0.333,0.287,7755,54.658782,178,814,0.865037194473964
"465",107044,"HARDING UNIVERSITY",1,0,2000,975,557,418,365,137,228,0.409,0.374,0.328,8175,57.356775,185.5,849,0.870769230769231
"466",107044,"HARDING UNIVERSITY",1,0,2001,979,547,432,365,145,220,0.402,0.373,0.336,8730,62.964882,193,851,0.869254341164454
"467",107044,"HARDING UNIVERSITY",1,0,2002,1011,580,431,383,138,245,0.422,0.379,0.32,9180,67.377905,194,879,0.869436201780415
"468",107044,"HARDING UNIVERSITY",1,0,2003,966,543,423,369,132,237,0.436,0.382,0.312,9720,67.34355,200,859,0.889233954451346
"469",107044,"HARDING UNIVERSITY",1,0,2004,961,516,445,387,161,226,0.438,0.403,0.362,10380,70.412241,211,855,0.889698231009365
"470",107044,"Harding University",1,0,2005,955,527,428,396,132,264,0.501,0.415,0.308,10800,74.934183,223,837,0.876439790575916
"471",107044,"Harding University",1,0,2006,901,477,424,365,134,231,0.484,0.405,0.316,11250,80.146444,231,783,0.869034406215316
"472",107044,"Harding University",1,0,2007,960,549,411,388,124,264,0.481,0.404,0.302,11940,86.633805,249,833,0.867708333333333
"473",107044,"Harding University",1,0,2008,980,537,443,425,158,267,0.497,0.434,0.357,12690,92.142217,251,870,0.887755102040816
"474",107044,"Harding University",1,0,2009,950,530,420,430,143,287,0.541,0.453,0.34,13140,96.701838,259,788,0.829473684210526
"475",107044,"Harding University",1,0,2010,988,506,482,426,177,249,0.492,0.431,0.367,13590,97.901264,263,848,0.8582995951417
"476",107080,"HENDRIX COLLEGE",0,1,1991,281,146,135,141,67,74,0.507,0.502,0.496,7150,15.117439,65,257,0.914590747330961
"477",107080,"HENDRIX COLLEGE",0,1,1992,335,183,152,174,76,98,0.535,0.519,0.5,7710,15.503843,66,299,0.892537313432836
"478",107080,"HENDRIX COLLEGE",0,1,1993,273,165,108,152,58,94,0.57,0.557,0.537,8410,16.539889,65,242,0.886446886446886
"479",107080,"HENDRIX COLLEGE",0,1,1995,273,166,107,148,58,90,0.542,0.542,0.542,9325,18.132539,68,248,0.908424908424908
"480",107080,"HENDRIX COLLEGE",0,1,1996,306,185,121,188,78,110,0.595,0.614,0.645,9750,18.083714,69,264,0.862745098039216
"481",107080,"HENDRIX COLLEGE",0,1,1997,329,193,136,184,76,108,0.56,0.559,0.559,10280,19.583776,71,275,0.835866261398176
"482",107080,"HENDRIX COLLEGE",0,1,1998,320,166,154,196,89,107,0.645,0.613,0.578,10835,20.937404,67,239,0.746875
"483",107080,"HENDRIX COLLEGE",0,1,1999,330,181,149,183,74,109,0.602,0.555,0.497,11440,22.881544,71,271,0.821212121212121
"484",107080,"HENDRIX COLLEGE",0,1,2000,326,173,153,194,85,109,0.63,0.595,0.556,12340,24.405298,75,254,0.779141104294479
"485",107080,"HENDRIX COLLEGE",0,1,2001,279,164,115,157,49,108,0.658,0.563,0.426,13071,27.433984,79,191,0.684587813620072
"486",107080,"HENDRIX COLLEGE",1,0,2002,317,184,133,199,73,126,0.685,0.628,0.549,14900,27.832964,81,216,0.681388012618297
"487",107080,"HENDRIX COLLEGE",1,0,2003,267,155,112,157,63,94,0.607,0.588,0.562,15630,30.038278,81,183,0.685393258426966
"488",107080,"HENDRIX COLLEGE",1,0,2004,295,165,130,159,69,90,0.545,0.539,0.531,16510,29.460726,83,223,0.75593220338983
"489",107080,"Hendrix College",1,0,2005,280,156,124,179,73,106,0.679,0.639,0.589,19508,31.918819,85,236,0.842857142857143
"490",107080,"Hendrix College",1,0,2006,396,222,174,251,99,152,0.685,0.634,0.569,20679,33.178005,90,324,0.818181818181818
"491",107080,"Hendrix College",1,0,2007,365,194,171,231,99,132,0.68,0.633,0.579,22125,31.955102,90,305,0.835616438356164
"492",107080,"Hendrix College",1,0,2008,430,238,192,284,122,162,0.681,0.66,0.635,23570,40.989538,103,351,0.816279069767442
"493",107080,"Hendrix College",1,0,2009,412,245,167,265,107,158,0.645,0.643,0.641,28713,44.122677,109,315,0.764563106796116
"494",107080,"Hendrix College",1,0,2010,403,237,166,259,96,163,0.688,0.643,0.578,30410,42.486189,109,283,0.702233250620347
"495",107141,"JOHN BROWN UNIVERSITY",1,0,1991,219,123,96,65,29,36,0.293,0.297,0.302,5390,12.047702,57,180,0.821917808219178
"496",107141,"JOHN BROWN UNIVERSITY",1,0,1992,196,109,87,70,31,39,0.358,0.357,0.356,5930,13.878844,58,154,0.785714285714286
"497",107141,"JOHN BROWN UNIVERSITY",1,0,1993,245,139,106,76,29,47,0.338,0.31,0.274,6390,13.999154,60,213,0.869387755102041
"498",107141,"JOHN BROWN UNIVERSITY",1,0,1995,224,115,109,71,28,43,0.374,0.317,0.257,7650,17.889197,64,210,0.9375
"499",107141,"JOHN BROWN UNIVERSITY",1,0,1996,266,148,118,101,37,64,0.432,0.38,0.314,8308,18.469611,62,240,0.902255639097744
"500",107141,"JOHN BROWN UNIVERSITY",1,0,1997,225,121,104,83,37,46,0.38,0.369,0.356,9120,16.115941,62,199,0.884444444444444
"501",107141,"JOHN BROWN UNIVERSITY",1,0,1998,250,138,112,112,44,68,0.493,0.448,0.393,9802,17.488617,65,209,0.836
"502",107141,"JOHN BROWN UNIVERSITY",1,0,1999,267,149,118,113,39,74,0.497,0.423,0.331,10232,18.989043,71,225,0.842696629213483
"503",107141,"JOHN BROWN UNIVERSITY",1,0,2000,276,164,112,140,51,89,0.543,0.507,0.455,11022,20.069122,73,229,0.829710144927536
"504",107141,"JOHN BROWN UNIVERSITY",1,0,2001,241,149,92,132,50,82,0.55,0.548,0.543,11892,22.018359,75,202,0.838174273858921
"505",107141,"JOHN BROWN UNIVERSITY",1,0,2002,303,186,117,176,64,112,0.602,0.581,0.547,12464,24.902737,73,251,0.828382838283828
"506",107141,"JOHN BROWN UNIVERSITY",1,0,2003,274,140,134,145,68,77,0.55,0.529,0.507,13076,27.35797,80,227,0.828467153284672
"507",107141,"JOHN BROWN UNIVERSITY",1,0,2004,296,156,140,155,67,88,0.564,0.524,0.479,13724,29.419045,80,240,0.810810810810811
"508",107141,"John Brown University",1,0,2005,262,132,130,143,71,72,0.545,0.546,0.546,14544,31.711621,83,227,0.866412213740458
"509",107141,"John Brown University",1,0,2006,326,168,158,190,78,112,0.667,0.583,0.494,15412,32.983269,80,279,0.855828220858896
"510",107141,"John Brown University",1,0,2007,361,206,155,200,81,119,0.578,0.554,0.523,16396,36.135983,79,303,0.839335180055402
"511",107141,"John Brown University",1,0,2008,307,165,142,160,72,88,0.533,0.521,0.507,17256,37.587322,81,250,0.814332247557003
"512",107141,"John Brown University",1,0,2009,305,170,135,167,62,105,0.618,0.548,0.459,18032,37.566662,82,250,0.819672131147541
"513",107141,"John Brown University",1,0,2010,322,175,147,180,82,98,0.56,0.559,0.558,18844,39.776978,83,265,0.822981366459627
"514",107512,"OUACHITA BAPTIST UNIVERSITY",1,0,1991,338,182,156,115,44,71,0.39,0.34,0.282,5370,13.334562,86,312,0.923076923076923
"515",107512,"OUACHITA BAPTIST UNIVERSITY",1,0,1992,296,148,148,121,36,85,0.574,0.409,0.243,5800,13.992869,91,264,0.891891891891892
"516",107512,"OUACHITA BAPTIST UNIVERSITY",1,0,1993,443,217,226,174,86,88,0.405,0.393,0.381,6230,14.621967,97,404,0.91196388261851
"517",107512,"OUACHITA BAPTIST UNIVERSITY",1,0,1995,380,206,174,173,75,98,0.476,0.455,0.431,7070,18.053772,104,351,0.923684210526316
"518",107512,"OUACHITA BAPTIST UNIVERSITY",1,0,1996,451,237,214,184,69,115,0.485,0.408,0.322,7650,18.145047,98,433,0.960088691796009
"519",107512,"OUACHITA BAPTIST UNIVERSITY",1,0,1997,404,230,174,164,59,105,0.456,0.406,0.339,8090,25.034847,108,359,0.888613861386139
"520",107512,"OUACHITA BAPTIST UNIVERSITY",1,0,1998,362,220,142,120,36,84,0.382,0.331,0.254,8550,26.238005,108,336,0.92817679558011
"521",107512,"OUACHITA BAPTIST UNIVERSITY",1,0,1999,443,256,187,197,72,125,0.488,0.445,0.385,8850,21.286941,103,405,0.914221218961625
"522",107512,"OUACHITA BAPTIST UNIVERSITY",1,0,2000,440,247,193,187,69,118,0.478,0.425,0.358,9800,29.73249,106,404,0.918181818181818
"523",107512,"OUACHITA BAPTIST UNIVERSITY",1,0,2001,400,214,186,183,73,110,0.514,0.458,0.392,11800,33.132684,109,371,0.9275
"524",107512,"OUACHITA BAPTIST UNIVERSITY",1,0,2002,396,229,167,166,64,102,0.445,0.419,0.383,11800,36.323264,117,360,0.909090909090909
"525",107512,"OUACHITA BAPTIST UNIVERSITY",1,0,2003,343,195,148,140,52,88,0.451,0.408,0.351,12013,28.826104,113,308,0.897959183673469
"526",107512,"OUACHITA BAPTIST UNIVERSITY",1,0,2004,380,223,157,170,49,121,0.543,0.447,0.312,13023,29.330298,108,338,0.889473684210526
"527",107512,"Ouachita Baptist University",1,0,2005,365,213,152,181,66,115,0.54,0.496,0.434,14218,31.257335,114,327,0.895890410958904
"528",107512,"Ouachita Baptist University",1,0,2006,367,190,177,185,73,112,0.59,0.504,0.412,15235,31.958901,119,322,0.877384196185286
"529",107512,"Ouachita Baptist University",1,0,2007,372,202,170,179,60,119,0.589,0.481,0.353,16158,34.314378,115,334,0.897849462365591
"530",107512,"Ouachita Baptist University",1,0,2008,404,220,184,205,80,125,0.568,0.507,0.435,17058,34.896305,112,347,0.858910891089109
"531",107512,"Ouachita Baptist University",1,0,2009,389,198,191,208,84,124,0.626,0.535,0.44,18038,34.967832,113,326,0.838046272493573
"532",107512,"Ouachita Baptist University",1,0,2010,450,243,207,264,102,162,0.667,0.587,0.493,18805,36.177753,107,401,0.891111111111111
"533",107558,"UNIVERSITY OF THE OZARKS",1,0,1991,90,52,38,9,4,5,0.096,0.1,0.105,3520,8.035326,40,83,0.922222222222222
"534",107558,"UNIVERSITY OF THE OZARKS",1,0,1992,120,53,67,11,7,4,0.076,0.092,0.104,4220,8.382669,40,109,0.908333333333333
"535",107558,"UNIVERSITY OF THE OZARKS",1,0,1993,162,96,66,37,15,22,0.229,0.228,0.227,4920,8.701771,43,144,0.888888888888889
"536",107558,"UNIVERSITY OF THE OZARKS",1,0,1995,133,66,67,29,14,15,0.227,0.218,0.209,6540,10.464866,36,110,0.827067669172932
"537",107558,"UNIVERSITY OF THE OZARKS",1,0,1996,110,52,58,37,14,23,0.442,0.336,0.241,7140,10.219187,33,93,0.845454545454545
"538",107558,"UNIVERSITY OF THE OZARKS",1,0,1997,155,66,89,44,21,23,0.349,0.284,0.236,7390,7.951383,31,136,0.87741935483871
"539",107558,"UNIVERSITY OF THE OZARKS",1,0,1998,137,69,68,43,18,25,0.362,0.314,0.265,7990,8.773542,31,102,0.744525547445255
"540",107558,"UNIVERSITY OF THE OZARKS",1,0,1999,164,93,71,53,17,36,0.387,0.323,0.239,8290,9.278387,33,119,0.725609756097561
"541",107558,"UNIVERSITY OF THE OZARKS",1,0,2000,166,100,66,52,17,35,0.35,0.313,0.258,8830,10.953803,37,141,0.849397590361446
"542",107558,"UNIVERSITY OF THE OZARKS",1,0,2001,190,116,74,61,22,39,0.336,0.321,0.297,9348,12.395282,41,151,0.794736842105263
"543",107558,"UNIVERSITY OF THE OZARKS",1,0,2002,200,97,103,60,28,32,0.33,0.3,0.272,10282,13.65656,43,156,0.78
"544",107558,"UNIVERSITY OF THE OZARKS",1,0,2003,206,113,93,63,20,43,0.38,0.306,0.215,11520,15.439096,44,145,0.703883495145631
"545",107558,"UNIVERSITY OF THE OZARKS",1,0,2004,134,74,60,44,18,26,0.351,0.328,0.3,12902,15.543027,43,106,0.791044776119403
"546",107558,"University of the Ozarks",1,0,2005,168,89,79,48,19,29,0.326,0.286,0.241,13740,14.650277,44,117,0.696428571428571
"547",107558,"University of the Ozarks",1,0,2006,164,80,84,59,29,30,0.375,0.36,0.345,14470,15.402567,44,109,0.664634146341463
"548",107558,"University of the Ozarks",1,0,2007,178,102,76,61,17,44,0.431,0.343,0.224,15630,16.775397,46,132,0.741573033707865
"549",107558,"University of the Ozarks",1,0,2008,195,113,82,72,27,45,0.398,0.369,0.329,16730,17.693073,48,152,0.779487179487179
"550",107558,"University of the Ozarks",1,0,2009,152,72,80,39,12,27,0.375,0.257,0.15,18300,17.749169,47,110,0.723684210526316
"551",107558,"University of the Ozarks",1,0,2010,204,114,90,61,28,33,0.29,0.299,0.311,19930,18.253058,49,152,0.745098039215686
"552",110097,"BIOLA UNIVERSITY",1,0,1991,391,256,135,155,45,110,0.43,0.396,0.333,9902,36.259489,121,296,0.757033248081841
"553",110097,"BIOLA UNIVERSITY",1,0,1992,464,290,174,176,64,112,0.386,0.379,0.368,10756,37.52584,131,331,0.713362068965517
"554",110097,"BIOLA UNIVERSITY",1,0,1993,444,286,158,157,48,109,0.381,0.354,0.304,11388,42.433418,126,301,0.677927927927928
"555",110097,"BIOLA UNIVERSITY",1,0,1995,407,278,129,168,45,123,0.442,0.413,0.349,12652,44.926465,121,299,0.734643734643735
"556",110097,"BIOLA UNIVERSITY",1,0,1996,407,268,139,184,62,122,0.455,0.452,0.446,13408,47.317141,125,309,0.759213759213759
"557",110097,"BIOLA UNIVERSITY",1,0,1997,437,296,141,204,60,144,0.486,0.467,0.426,14286,41.069309,133,338,0.773455377574371
"558",110097,"BIOLA UNIVERSITY",1,0,1998,469,313,156,227,75,152,0.486,0.484,0.481,15214,45.300252,130,368,0.784648187633262
"559",110097,"BIOLA UNIVERSITY",1,0,1999,563,373,190,370,123,247,0.662,0.657,0.647,15914,49.784999,143,426,0.756660746003552
"560",110097,"BIOLA UNIVERSITY",1,0,2000,608,409,199,326,88,238,0.582,0.536,0.442,16630,51.972,149,498,0.819078947368421
"561",110097,"BIOLA UNIVERSITY",1,0,2001,649,426,223,360,113,247,0.58,0.555,0.507,17410,55.949,155,514,0.791987673343606
"562",110097,"BIOLA UNIVERSITY",1,0,2002,656,414,242,345,108,237,0.573,0.526,0.446,18456,64.383,162,525,0.80030487804878
"563",110097,"BIOLA UNIVERSITY",1,0,2003,685,459,226,348,104,244,0.532,0.508,0.46,19564,74.176,174,553,0.807299270072993
"564",110097,"BIOLA UNIVERSITY",1,0,2004,691,443,248,346,120,226,0.51,0.501,0.484,20932,80.698,175,494,0.714905933429812
"565",110097,"Biola University",1,0,2005,670,416,254,337,111,226,0.543,0.503,0.437,22602,89.381,184,467,0.697014925373134
"566",110097,"Biola University",1,0,2006,799,521,278,364,102,262,0.503,0.456,0.367,23782,98.206,198,553,0.692115143929912
"567",110097,"Biola University",1,0,2007,789,514,275,385,118,267,0.52,0.488,0.429,24998,106.129,205,536,0.679340937896071
"568",110097,"Biola University",1,0,2008,846,530,316,430,157,273,0.515,0.508,0.497,26424,117.397,212,563,0.66548463356974
"569",110097,"Biola University",1,0,2009,775,508,267,402,131,271,0.533,0.519,0.491,27744,119.695887,218,489,0.630967741935484
"570",110097,"Biola University",1,0,2010,877,560,317,471,159,312,0.557,0.537,0.502,28852,120.345,226,498,0.567844925883694
"571",110404,"CALIFORNIA INSTITUTE OF TECHNOLOGY",0,1,1991,225,73,152,146,99,47,0.644,0.649,0.651,14230,1334.416785,253,126,0.56
"572",110404,"CALIFORNIA INSTITUTE OF TECHNOLOGY",0,1,1992,233,60,173,165,119,46,0.767,0.708,0.688,15080,1357.618,247,132,0.566523605150215
"573",110404,"CALIFORNIA INSTITUTE OF TECHNOLOGY",0,1,1993,209,63,146,151,109,42,0.667,0.722,0.747,16030,1325.141,257,117,0.559808612440191
"574",110404,"CALIFORNIA INSTITUTE OF TECHNOLOGY",0,1,1995,218,52,166,156,108,48,0.923,0.716,0.651,17370,1311.932,260,145,0.665137614678899
"575",110404,"CALIFORNIA INSTITUTE OF TECHNOLOGY",0,1,1996,216,64,152,156,112,44,0.688,0.722,0.737,18000,1322.808,266,140,0.648148148148148
"576",110404,"CALIFORNIA INSTITUTE OF TECHNOLOGY",0,1,1997,217,64,153,169,119,50,0.781,0.779,0.778,18736,1663.872,258,127,0.585253456221198
"577",110404,"CALIFORNIA INSTITUTE OF TECHNOLOGY",0,1,1998,254,79,175,195,136,59,0.747,0.768,0.777,19166,345.672,256,153,0.602362204724409
"578",110404,"CALIFORNIA INSTITUTE OF TECHNOLOGY",0,1,1999,234,83,151,195,126,69,0.831,0.833,0.834,19260,1720.378,252,150,0.641025641025641
"579",110404,"CALIFORNIA INSTITUTE OF TECHNOLOGY",0,1,2000,205,74,131,166,107,59,0.797,0.81,0.817,19743,1671.464,280,110,0.536585365853659
"580",110404,"CALIFORNIA INSTITUTE OF TECHNOLOGY",0,1,2001,214,78,136,175,110,65,0.833,0.818,0.809,20904,1817.907,308,109,0.509345794392523
"581",110404,"CALIFORNIA INSTITUTE OF TECHNOLOGY",0,1,2002,252,73,179,203,138,65,0.89,0.806,0.771,21903,1898.092,301,148,0.587301587301587
"582",110404,"CALIFORNIA INSTITUTE OF TECHNOLOGY",0,1,2003,190,64,126,138,90,48,0.75,0.726,0.714,23901,1899.253,310,89,0.468421052631579
"583",110404,"CALIFORNIA INSTITUTE OF TECHNOLOGY",0,1,2004,207,59,148,167,117,50,0.848,0.807,0.791,25335,2098.634,309,115,0.555555555555556
"584",110404,"California Institute of Technology",0,1,2005,233,69,164,178,127,51,0.739,0.764,0.774,27309,2135.498,311,105,0.450643776824034
"585",110404,"California Institute of Technology",0,1,2006,210,60,150,166,113,53,0.883,0.79,0.753,28515,2094.58,324,79,0.376190476190476
"586",110404,"California Institute of Technology",0,1,2007,231,86,145,190,117,73,0.849,0.823,0.807,29940,2287.291,320,97,0.41991341991342
"587",110404,"California Institute of Technology",0,1,2008,236,97,139,200,112,88,0.907,0.847,0.806,31437,2349.364,322,93,0.394067796610169
"588",110404,"California Institute of Technology",0,1,2009,251,106,145,212,122,90,0.849,0.845,0.841,33324,2470.986,312,92,0.366533864541833
"589",110404,"California Institute of Technology",0,1,2010,220,87,133,179,105,74,0.851,0.814,0.789,34989,2299.31,316,78,0.354545454545455
"590",110422,"CALIFORNIA POLYTECHNIC STATE UNIV-SAN LUIS OBISPO",0,1,1991,1526,717,809,121,36,85,0.118,0.079,0.044,936,156.565365,760,868,0.568807339449541
"591",110422,"CALIFORNIA POLYTECHNIC STATE UNIV-SAN LUIS OBISPO",0,1,1992,1295,566,729,136,37,99,0.175,0.105,0.051,1616,162.440413,681,713,0.550579150579151
"592",110422,"CALIFORNIA POLYTECHNIC STATE UNIV-SAN LUIS OBISPO",0,1,1993,1600,722,878,155,36,119,0.165,0.097,0.041,1674,157.148081,670,948,0.5925
"593",110422,"CALIFORNIA POLYTECHNIC STATE UNIV-SAN LUIS OBISPO",0,1,1995,2418,1092,1326,356,114,242,0.222,0.147,0.086,1891,161.389088,676,1492,0.617038875103391
"594",110422,"CALIFORNIA POLYTECHNIC STATE UNIV-SAN LUIS OBISPO",0,1,1996,2757,1202,1555,448,132,316,0.263,0.162,0.085,1935,165.611159,676,1769,0.641639463184621
"595",110422,"CALIFORNIA POLYTECHNIC STATE UNIV-SAN LUIS OBISPO",0,1,1997,2114,951,1163,318,108,210,0.221,0.15,0.093,2228,176.103823,691,1243,0.5879848628193
"596",110422,"CALIFORNIA POLYTECHNIC STATE UNIV-SAN LUIS OBISPO",0,1,1998,2260,945,1315,367,136,231,0.244,0.162,0.103,2204,180.395603,683,1505,0.665929203539823
"597",110422,"CALIFORNIA POLYTECHNIC STATE UNIV-SAN LUIS OBISPO",0,1,1999,2673,1277,1396,557,167,390,0.305,0.208,0.12,0,189.779583,695,1169,0.437336326225215
"598",110422,"CALIFORNIA POLYTECHNIC STATE UNIV-SAN LUIS OBISPO",0,1,2000,3053,1332,1721,607,212,395,0.296,0.199,0.123,0,267.056525,692.5,1973,0.646249590566656
"599",110422,"CALIFORNIA POLYTECHNIC STATE UNIV-SAN LUIS OBISPO",0,1,2001,2957,1374,1583,629,220,409,0.298,0.213,0.139,0,281.470391,690,2041,0.690226580994251
"600",110422,"CALIFORNIA POLYTECHNIC STATE UNIV-SAN LUIS OBISPO",0,1,2002,2565,1158,1407,587,209,378,0.326,0.229,0.149,0,225.242113,719,1748,0.681481481481481
"601",110422,"CALIFORNIA POLYTECHNIC STATE UNIV-SAN LUIS OBISPO",0,1,2003,2798,1239,1559,673,264,409,0.33,0.241,0.169,0,235.995505,698,1920,0.686204431736955
"602",110422,"CALIFORNIA POLYTECHNIC STATE UNIVERSITY-SAN LUIS OBISPO",0,1,2004,2900,1169,1731,767,304,463,0.396,0.264,0.176,0,236.59035,653,1962,0.676551724137931
"603",110422,"California Polytechnic State University-San Luis Obispo",0,1,2005,3318,1599,1719,1021,345,676,0.423,0.308,0.201,0,232.341249,678,2270,0.68414707655214
"604",110422,"California Polytechnic State University-San Luis Obispo",0,1,2006,3761,1648,2113,1044,362,682,0.414,0.278,0.171,0,272.325785,704,2457,0.653283701143313
"605",110422,"California Polytechnic State University-San Luis Obispo",0,1,2007,4419,1885,2534,1282,460,822,0.436,0.29,0.182,0,276.305375,735,2860,0.647205250056574
"606",110422,"California Polytechnic State University-San Luis Obispo",0,1,2008,3448,1553,1895,1246,458,788,0.507,0.361,0.242,0,305.112556,761,2298,0.666473317865429
"607",110422,"California Polytechnic State University-San Luis Obispo",0,1,2009,3877,1803,2074,1557,593,964,0.535,0.402,0.286,0,314.89392,775,2461,0.634769151405726
"608",110422,"California Polytechnic State University-San Luis Obispo",0,1,2010,3459,1642,1817,1634,636,998,0.608,0.472,0.35,0,318.335175,726,2245,0.649031511997687
"609",110486,"CALIFORNIA STATE COLLEGE-BAKERSFIELD",0,1,1991,363,200,163,26,16,10,0.05,0.072,0.098,936,42.638242,218,143,0.393939393939394
"610",110486,"CALIFORNIA STATE BAKERSFIELD UNIVERSITY",0,1,1992,323,181,142,32,11,21,0.116,0.099,0.077,1444,44.540643,202,117,0.362229102167183
"611",110486,"CALIFORNIA STATE UNIVERSITY-BAKERSFIELD",0,1,1993,317,200,117,38,12,26,0.13,0.12,0.103,1674,44.328884,206,99,0.312302839116719
"612",110486,"CALIFORNIA STATE UNIVERSITY-BAKERSFIELD",0,1,1995,397,236,161,43,11,32,0.136,0.108,0.068,1891,49.022654,209,132,0.332493702770781
"613",110486,"CALIFORNIA STATE UNIVERSITY-BAKERSFIELD",0,1,1996,418,253,165,56,14,42,0.166,0.134,0.085,1935,50.577676,212,150,0.358851674641148
"614",110486,"CALIFORNIA STATE UNIVERSITY-BAKERSFIELD",0,1,1997,467,288,179,49,15,34,0.118,0.105,0.084,1951,53.463466,203,169,0.361884368308351
"615",110486,"CALIFORNIA STATE UNIVERSITY-BAKERSFIELD",0,1,1998,471,298,173,54,9,45,0.151,0.115,0.052,1873,56.989716,219,168,0.356687898089172
"616",110486,"CALIFORNIA STATE UNIVERSITY-BAKERSFIELD",0,1,1999,517,319,198,69,14,55,0.172,0.133,0.071,0,63.929951,223,191,0.369439071566731
"617",110486,"CALIFORNIA STATE UNIVERSITY-BAKERSFIELD",0,1,2000,545,349,196,77,22,55,0.158,0.141,0.112,0,77.612216,243.5,212,0.388990825688073
"618",110486,"CALIFORNIA STATE UNIVERSITY-BAKERSFIELD",0,1,2001,610,393,217,86,20,66,0.168,0.141,0.092,0,90.898211,264,210,0.344262295081967
"619",110486,"CALIFORNIA STATE UNIVERSITY-BAKERSFIELD",0,1,2002,679,408,271,99,28,71,0.174,0.146,0.103,0,79.906701,283,220,0.3240058910162
"620",110486,"CALIFORNIA STATE UNIVERSITY-BAKERSFIELD",0,1,2003,714,476,238,92,23,69,0.145,0.129,0.097,0,86.752909,307,237,0.331932773109244
"621",110486,"CALIFORNIA STATE UNIVERSITY-BAKERSFIELD",0,1,2004,745,483,262,128,32,96,0.199,0.172,0.122,0,88.302056,301,251,0.336912751677852
"622",110486,"California State University-Bakersfield",0,1,2005,766,503,263,114,21,93,0.185,0.149,0.08,0,90.906317,303,209,0.272845953002611
"623",110486,"California State University-Bakersfield",0,1,2006,854,553,301,120,29,91,0.165,0.141,0.096,0,96.185612,301,216,0.252927400468384
"624",110486,"California State University-Bakersfield",0,1,2007,859,578,281,129,25,104,0.18,0.15,0.089,0,105.440458,293,208,0.242142025611176
"625",110486,"California State University-Bakersfield",0,1,2008,901,592,309,144,45,99,0.167,0.16,0.146,0,114.649172,268,142,0.157602663706992
"626",110486,"California State University-Bakersfield",0,1,2009,1061,652,409,139,39,100,0.153,0.131,0.095,0,112.988415,253,158,0.148916116870877
"627",110486,"California State University-Bakersfield",0,1,2010,1013,613,400,148,50,98,0.16,0.146,0.125,0,109.353736,241,158,0.155972359328727
"628",110495,"CALIFORNIA STATE UNIVERSITY-STANISLAUS",1,0,1991,273,164,109,39,8,31,0.189,0.143,0.073,936,43.937304,201,130,0.476190476190476
"629",110495,"CALIFORNIA STATE UNIVERSITY-STANISLAUS",1,0,1992,307,191,116,33,11,22,0.115,0.107,0.095,1434,43.246738,189,133,0.433224755700326
"630",110495,"CALIFORNIA STATE UNIVERSITY-STANISLAUS",1,0,1993,387,232,155,60,22,38,0.164,0.155,0.142,1674,45.79445,215,194,0.501291989664083
"631",110495,"CALIFORNIA STATE UNIVERSITY-STANISLAUS",1,0,1995,353,242,111,75,12,63,0.26,0.212,0.108,1891,54.421864,235,167,0.473087818696884
"632",110495,"CALIFORNIA STATE UNIVERSITY-STANISLAUS",1,0,1996,381,244,137,85,22,63,0.258,0.223,0.161,1935,55.252559,239,172,0.451443569553806
"633",110495,"CALIFORNIA STATE UNIVERSITY-STANISLAUS",1,0,1997,409,270,139,84,19,65,0.241,0.205,0.137,1915,58.703827,238,191,0.466992665036675
"634",110495,"CALIFORNIA STATE UNIVERSITY-STANISLAUS",1,0,1998,444,297,147,84,16,68,0.229,0.189,0.109,1830,61.551113,237,211,0.475225225225225
"635",110495,"CALIFORNIA STATE UNIVERSITY-STANISLAUS",1,0,1999,470,310,160,101,16,85,0.274,0.215,0.1,0,68.733992,245,222,0.472340425531915
"636",110495,"CALIFORNIA STATE UNIVERSITY-STANISLAUS",1,0,2000,565,362,203,113,27,86,0.238,0.2,0.133,0,76.845523,253.5,223,0.394690265486726
"637",110495,"CALIFORNIA STATE UNIVERSITY-STANISLAUS",1,0,2001,516,352,164,96,24,72,0.204,0.186,0.146,0,92.487631,262,225,0.436046511627907
"638",110495,"CALIFORNIA STATE UNIVERSITY-STANISLAUS",1,0,2002,550,360,190,116,20,96,0.267,0.211,0.105,0,82.086047,273,232,0.421818181818182
"639",110495,"CALIFORNIA STATE UNIVERSITY-STANISLAUS",1,0,2003,551,365,186,119,37,82,0.225,0.216,0.199,0,91.247534,282,232,0.421052631578947
"640",110495,"CALIFORNIA STATE UNIVERSITY-STANISLAUS",1,0,2004,653,456,197,153,41,112,0.246,0.234,0.208,0,91.452441,264,288,0.44104134762634
"641",110495,"California State University-Stanislaus",1,0,2005,741,511,230,151,31,120,0.235,0.204,0.135,0,89.326678,284,288,0.388663967611336
"642",110495,"California State University-Stanislaus",1,0,2006,846,570,276,148,37,111,0.195,0.175,0.134,0,98.077188,291,324,0.382978723404255
"643",110495,"California State University-Stanislaus",1,0,2007,910,592,318,166,34,132,0.223,0.182,0.107,0,101.595211,309,347,0.381318681318681
"644",110495,"California State University-Stanislaus",1,0,2008,899,576,323,133,33,100,0.174,0.148,0.102,0,123.578053,311,338,0.375973303670745
"645",110495,"California State University-Stanislaus",1,0,2009,798,555,243,124,37,87,0.157,0.155,0.152,0,125.288591,289,258,0.323308270676692
"646",110495,"California State University-Stanislaus",1,0,2010,998,670,328,156,41,115,0.172,0.156,0.125,0,115.219024,265,265,0.265531062124248
"647",110510,"CALIFORNIA STATE UNIVERSITY-SAN BERNARDINO",0,1,1991,815,505,310,58,17,41,0.081,0.071,0.055,936,70.793583,415,387,0.474846625766871
"648",110510,"CALIFORNIA STATE UNIVERSITY-SAN BERNARDINO",0,1,1992,737,449,288,59,23,36,0.08,0.08,0.08,1443,77.999888,399,321,0.435549525101764
"649",110510,"CALIFORNIA STATE UNIVERSITY-SAN BERNARDINO",0,1,1993,692,433,259,37,9,28,0.065,0.053,0.035,1674,82.994653,397,277,0.40028901734104
"650",110510,"CALIFORNIA STATE UNIVERSITY-SAN BERNARDINO",0,1,1995,799,505,294,58,16,42,0.083,0.073,0.054,1891,93.455513,406,280,0.350438047559449
"651",110510,"CALIFORNIA STATE UNIVERSITY-SAN BERNARDINO",0,1,1996,882,554,328,78,18,60,0.108,0.088,0.055,1935,92.759982,416,324,0.36734693877551
"652",110510,"CALIFORNIA STATE UNIVERSITY-SAN BERNARDINO",0,1,1997,890,559,331,83,26,57,0.102,0.093,0.079,1889,96.917633,416,315,0.353932584269663
"653",110510,"CALIFORNIA STATE UNIVERSITY-SAN BERNARDINO",0,1,1998,1068,680,388,124,39,85,0.125,0.116,0.101,1779,110.499936,421,390,0.365168539325843
"654",110510,"CALIFORNIA STATE UNIVERSITY-SAN BERNARDINO",0,1,1999,1049,679,370,105,30,75,0.111,0.1,0.081,0,150.512913,440,342,0.32602478551001
"655",110510,"CALIFORNIA STATE UNIVERSITY-SAN BERNARDINO",0,1,2000,1146,750,396,142,33,109,0.145,0.124,0.083,0,141.19961,451.5,373,0.325479930191972
"656",110510,"CALIFORNIA STATE UNIVERSITY-SAN BERNARDINO",0,1,2001,1273,774,499,127,36,91,0.118,0.1,0.072,0,168.344611,463,387,0.304006284367635
"657",110510,"CALIFORNIA STATE UNIVERSITY-SAN BERNARDINO",0,1,2002,1161,751,410,142,32,110,0.147,0.122,0.078,0,149.034502,488,323,0.278208440999139
"658",110510,"CALIFORNIA STATE UNIVERSITY-SAN BERNARDINO",0,1,2003,1335,918,417,178,45,133,0.145,0.133,0.108,0,167.08279,479,386,0.289138576779026
"659",110510,"CALIFORNIA STATE UNIVERSITY-SAN BERNARDINO",0,1,2004,1587,1099,488,208,53,155,0.141,0.131,0.109,0,170.358516,447,351,0.22117202268431
"660",110510,"California State University-San Bernardino",0,1,2005,1645,1092,553,212,75,137,0.126,0.129,0.136,0,158.937781,444,393,0.238905775075988
"661",110510,"California State University-San Bernardino",0,1,2006,1774,1157,617,201,55,146,0.126,0.113,0.089,0,179.806969,462,405,0.228297632468997
"662",110510,"California State University-San Bernardino",0,1,2007,1656,1098,558,156,43,113,0.103,0.094,0.077,0,196.272226,468,334,0.201690821256039
"663",110510,"California State University-San Bernardino",0,1,2008,1916,1213,703,241,77,164,0.135,0.126,0.11,0,218.074591,470,390,0.203549060542798
"664",110510,"California State University-San Bernardino",0,1,2009,1968,1275,693,265,75,190,0.149,0.135,0.108,0,231.239052,452,304,0.154471544715447
"665",110510,"California State University-San Bernardino",0,1,2010,1747,1114,633,251,73,178,0.16,0.144,0.115,0,223.941975,433,263,0.150543789353177
"666",110529,"CALIFORNIA STATE POLYTECHNIC UNIVERSITY POMONA",0,1,1991,1583,650,933,96,28,68,0.105,0.061,0.03,936,131.522942,662,470,0.296904611497157
"667",110529,"CALIFORNIA STATE POLYTECHNIC UNIVERSITY POMONA",0,1,1992,1358,551,807,84,34,50,0.091,0.062,0.042,1384,134.477258,629,373,0.274668630338733
"668",110529,"CALIFORNIA STATE POLYTECHNIC UNIVERSITY-POMONA",0,1,1993,1309,536,773,105,42,63,0.118,0.08,0.054,1674,133.317412,610,383,0.292589763177998
"669",110529,"CALIFORNIA STATE POLYTECHNIC UNIVERSITY-POMONA",0,1,1995,1422,621,801,96,37,59,0.095,0.068,0.046,1891,147.28268,612,374,0.263009845288326
"670",110529,"CALIFORNIA STATE POLYTECHNIC UNIVERSITY-POMONA",0,1,1996,1497,647,850,128,56,72,0.111,0.086,0.066,1935,147.829531,595,393,0.2625250501002
"671",110529,"CALIFORNIA STATE POLYTECHNIC UNIVERSITY-POMONA",0,1,1997,1856,810,1046,157,56,101,0.125,0.085,0.054,1903,159.547643,581,466,0.251077586206897
"672",110529,"CALIFORNIA STATE POLYTECHNIC UNIVERSITY-POMONA",0,1,1998,2033,855,1178,191,80,111,0.13,0.094,0.068,1855,167.6049,571,516,0.253812100344319
"673",110529,"CALIFORNIA STATE POLYTECHNIC UNIVERSITY-POMONA",0,1,1999,2489,1008,1481,226,90,136,0.135,0.091,0.061,0,159.288942,585,599,0.240658899156288
"674",110529,"CALIFORNIA STATE POLYTECHNIC UNIVERSITY-POMONA",0,1,2000,2600,1121,1479,265,113,152,0.136,0.102,0.076,0,222.984408,595.5,578,0.222307692307692
"675",110529,"CALIFORNIA STATE POLYTECHNIC UNIVERSITY-POMONA",0,1,2001,2412,961,1451,229,91,138,0.144,0.095,0.063,0,252.112049,606,535,0.221807628524046
"676",110529,"CALIFORNIA STATE POLYTECHNIC UNIVERSITY-POMONA",0,1,2002,2674,1080,1594,345,161,184,0.17,0.129,0.101,0,221.714857,609,651,0.243455497382199
"677",110529,"CALIFORNIA STATE POLYTECHNIC UNIVERSITY-POMONA",0,1,2003,2558,1107,1451,384,172,212,0.192,0.15,0.119,0,216.002922,596,693,0.270914777169664
"678",110529,"CALIFORNIA STATE POLYTECHNIC UNIVERSITY-POMONA",0,1,2004,2115,921,1194,412,188,224,0.243,0.195,0.157,0,270.12667,549,588,0.278014184397163
"679",110529,"California State Polytechnic University-Pomona",0,1,2005,3089,1296,1793,380,157,223,0.172,0.123,0.088,0,229.765884,559,773,0.25024279702169
"680",110529,"California State Polytechnic University-Pomona",0,1,2006,3138,1357,1781,341,128,213,0.157,0.109,0.072,0,250.600751,563,769,0.245060548119822
"681",110529,"California State Polytechnic University-Pomona",0,1,2007,3414,1459,1955,343,118,225,0.154,0.1,0.06,0,249.001386,594,770,0.225541886350322
"682",110529,"California State Polytechnic University-Pomona",0,1,2008,2538,1068,1470,299,135,164,0.154,0.118,0.092,0,275.571289,570,680,0.267927501970055
"683",110529,"California State Polytechnic University-Pomona",0,1,2009,2728,1192,1536,401,134,267,0.224,0.147,0.087,0,287.158907,562,714,0.261730205278592
"684",110529,"California State Polytechnic University-Pomona",0,1,2010,1923,835,1088,352,150,202,0.242,0.183,0.138,0,268.825642,504,458,0.238169526781071
"685",110538,"CALIFORNIA STATE UNIVERSITY-CHICO",1,0,1991,1284,731,553,171,35,136,0.186,0.133,0.063,936,126.620513,639,1009,0.78582554517134
"686",110538,"CALIFORNIA STATE UNIVERSITY-CHICO",1,0,1992,1325,758,567,148,34,114,0.15,0.112,0.06,1452,126.000536,587,1018,0.768301886792453
"687",110538,"CALIFORNIA STATE UNIVERSITY-CHICO",1,0,1993,1244,754,490,169,27,142,0.188,0.136,0.055,1674,128.004272,574,899,0.722668810289389
"688",110538,"CALIFORNIA STATE UNIVERSITY-CHICO",1,0,1995,1401,832,569,161,22,139,0.167,0.115,0.039,1891,131.046633,545,940,0.670949321912919
"689",110538,"CALIFORNIA STATE UNIVERSITY-CHICO",1,0,1996,1524,874,650,173,35,138,0.158,0.114,0.054,1935,129.048657,541,1018,0.667979002624672
"690",110538,"CALIFORNIA STATE UNIVERSITY-CHICO",1,0,1997,1618,948,670,246,45,201,0.212,0.152,0.067,2076,136.930637,536,1125,0.695302843016069
"691",110538,"CALIFORNIA STATE UNIVERSITY-CHICO",1,0,1998,1850,1069,781,299,65,234,0.219,0.162,0.083,2026,143.103414,552,1263,0.682702702702703
"692",110538,"CALIFORNIA STATE UNIVERSITY-CHICO",1,0,1999,2007,1139,868,304,67,237,0.208,0.151,0.077,0,150.740839,571,1398,0.696562032884903
"693",110538,"CALIFORNIA STATE UNIVERSITY-CHICO",1,0,2000,1931,1079,852,336,79,257,0.238,0.174,0.093,0,203.91839,579,1336,0.691869497669601
"694",110538,"CALIFORNIA STATE UNIVERSITY-CHICO",1,0,2001,2092,1175,917,314,64,250,0.213,0.15,0.07,0,230.327557,587,1444,0.690248565965583
"695",110538,"CALIFORNIA STATE UNIVERSITY-CHICO",1,0,2002,1995,1125,870,372,95,277,0.246,0.186,0.109,0,173.850884,572,1353,0.678195488721804
"696",110538,"CALIFORNIA STATE UNIVERSITY-CHICO",1,0,2003,1970,1140,830,322,71,251,0.22,0.163,0.086,0,179.096729,525,1385,0.703045685279188
"697",110538,"CALIFORNIA STATE UNIVERSITY-CHICO",1,0,2004,2198,1266,932,436,102,334,0.264,0.198,0.109,0,179.076262,498,1485,0.675614194722475
"698",110538,"California State University-Chico",1,0,2005,2300,1237,1063,439,118,321,0.26,0.191,0.111,0,182.717671,506,1452,0.631304347826087
"699",110538,"California State University-Chico",1,0,2006,2430,1326,1104,420,103,317,0.239,0.173,0.093,0,182.506221,530,1597,0.657201646090535
"700",110538,"California State University-Chico",1,0,2007,2710,1418,1292,458,138,320,0.226,0.169,0.107,0,193.472002,559,1765,0.651291512915129
"701",110538,"California State University-Chico",1,0,2008,2727,1420,1307,537,163,374,0.263,0.197,0.125,0,214.89036,565,1821,0.667766776677668
"702",110538,"California State University-Chico",1,0,2009,2468,1338,1130,561,159,402,0.3,0.227,0.141,0,218.118936,531,1488,0.60291734197731
"703",110538,"California State University-Chico",1,0,2010,1880,1048,832,484,160,324,0.309,0.257,0.192,0,205.678336,500,1015,0.539893617021277
"704",110547,"CALIFORNIA STATE UNIVERSITY-DOMINGUEZ HILLS",1,0,1991,337,227,110,9,2,7,0.031,0.027,0.018,936,68.2213,285,50,0.148367952522255
"705",110547,"CALIFORNIA STATE UNIVERSITY-DOMINGUEZ HILLS",1,0,1992,485,336,149,16,6,10,0.03,0.033,0.04,1399,67.246795,277,53,0.109278350515464
"706",110547,"CALIFORNIA STATE UNIVERSITY-DOMINGUEZ HILLS",1,0,1993,389,252,137,15,5,10,0.04,0.039,0.036,1674,70.393297,268,46,0.118251928020566
"707",110547,"CALIFORNIA STATE UNIVERSITY-DOMINGUEZ HILLS",1,0,1995,467,335,132,19,4,15,0.045,0.041,0.03,1891,78.89789,265,23,0.0492505353319058
"708",110547,"CALIFORNIA STATE UNIVERSITY-DOMINGUEZ HILLS",1,0,1996,475,358,117,24,3,21,0.059,0.051,0.026,1935,82.073628,276,14,0.0294736842105263
"709",110547,"CALIFORNIA STATE UNIVERSITY-DOMINGUEZ HILLS",1,0,1997,512,363,149,17,2,15,0.041,0.033,0.013,1791,84.988633,265,27,0.052734375
"710",110547,"CALIFORNIA STATE UNIVERSITY-DOMINGUEZ HILLS",1,0,1998,465,330,135,21,3,18,0.054,0.045,0.022,1748,89.067155,277,20,0.043010752688172
"711",110547,"CALIFORNIA STATE UNIVERSITY-DOMINGUEZ HILLS",1,0,1999,453,319,134,26,5,21,0.066,0.057,0.037,0,96.499688,294,24,0.0529801324503311
"712",110547,"CALIFORNIA STATE UNIVERSITY-DOMINGUEZ HILLS",1,0,2000,495,355,140,31,7,24,0.068,0.063,0.05,0,118.132519,290.5,25,0.0505050505050505
"713",110547,"CALIFORNIA STATE UNIVERSITY-DOMINGUEZ HILLS",1,0,2001,561,391,170,26,6,20,0.051,0.046,0.035,0,125.841564,287,25,0.0445632798573975
"714",110547,"CALIFORNIA STATE UNIVERSITY-DOMINGUEZ HILLS",1,0,2002,630,466,164,28,6,22,0.047,0.044,0.037,0,110.034192,295,30,0.0476190476190476
"715",110547,"CALIFORNIA STATE UNIVERSITY-DOMINGUEZ HILLS",1,0,2003,639,458,181,31,5,26,0.057,0.049,0.028,0,121.297004,310,25,0.0391236306729265
"716",110547,"CALIFORNIA STATE UNIVERSITY-DOMINGUEZ HILLS",1,0,2004,673,459,214,35,10,25,0.054,0.052,0.047,0,123.61311,288,36,0.0534918276374443
"717",110547,"California State University-Dominguez Hills",1,0,2005,705,476,229,42,9,33,0.069,0.06,0.039,0,122.340499,270,34,0.0482269503546099
"718",110547,"California State University-Dominguez Hills",1,0,2006,984,716,268,41,8,33,0.046,0.042,0.03,0,124.895812,268,41,0.0416666666666667
"719",110547,"California State University-Dominguez Hills",1,0,2007,913,602,311,35,11,24,0.04,0.038,0.035,0,131.00551,292,38,0.0416210295728368
"720",110547,"California State University-Dominguez Hills",1,0,2008,889,599,290,42,14,28,0.047,0.047,0.048,0,142.008291,282,35,0.0393700787401575
"721",110547,"California State University-Dominguez Hills",1,0,2009,1069,703,366,66,13,53,0.075,0.062,0.036,0,149.52373,293,34,0.0318054256314312
"722",110547,"California State University-Dominguez Hills",1,0,2010,982,633,349,50,17,33,0.052,0.051,0.049,0,141.153995,279,41,0.0417515274949083
"723",110556,"CALIFORNIA STATE UNIVERSITY-FRESNO",1,0,1991,1648,902,746,173,61,112,0.124,0.105,0.082,936,144.795062,734,711,0.431432038834951
"724",110556,"CALIFORNIA STATE UNIVERSITY-FRESNO",1,0,1992,1559,860,699,165,52,113,0.131,0.106,0.074,1446,151.33612,643,666,0.427196921103271
"725",110556,"CALIFORNIA STATE UNIVERSITY-FRESNO",1,0,1993,1436,792,644,152,32,120,0.152,0.106,0.05,1674,148.262589,649,522,0.363509749303621
"726",110556,"CALIFORNIA STATE UNIVERSITY-FRESNO",1,0,1995,1571,915,656,176,44,132,0.144,0.112,0.067,1891,155.563798,637,537,0.341820496499045
"727",110556,"CALIFORNIA STATE UNIVERSITY-FRESNO",1,0,1996,1503,846,657,198,54,144,0.17,0.132,0.082,1935,154.720254,630,469,0.312042581503659
"728",110556,"CALIFORNIA STATE UNIVERSITY-FRESNO",1,0,1997,1510,901,609,180,69,111,0.123,0.119,0.113,1802,163.274204,637,486,0.321854304635762
"729",110556,"CALIFORNIA STATE UNIVERSITY-FRESNO",1,0,1998,1566,933,633,215,44,171,0.183,0.137,0.07,1754,171.027393,625,488,0.311621966794381
"730",110556,"CALIFORNIA STATE UNIVERSITY-FRESNO",1,0,1999,1703,1002,701,225,56,169,0.169,0.132,0.08,0,176.479125,646,573,0.336465061655901
"731",110556,"CALIFORNIA STATE UNIVERSITY-FRESNO",1,0,2000,1885,1138,747,227,67,160,0.141,0.12,0.09,0,262.284871,646,629,0.33368700265252
"732",110556,"CALIFORNIA STATE UNIVERSITY-FRESNO",1,0,2001,1946,1179,767,275,74,201,0.17,0.141,0.096,0,278.695,646,704,0.361767728674203
"733",110556,"CALIFORNIA STATE UNIVERSITY-FRESNO",1,0,2002,2189,1274,915,346,109,237,0.186,0.158,0.119,0,225.074315,677,825,0.376884422110553
"734",110556,"CALIFORNIA STATE UNIVERSITY-FRESNO",1,0,2003,2485,1503,982,353,101,252,0.168,0.142,0.103,0,237.371519,648,915,0.368209255533199
"735",110556,"CALIFORNIA STATE UNIVERSITY-FRESNO",1,0,2004,2243,1351,892,378,102,276,0.204,0.169,0.114,0,234.268316,601,839,0.374052608114133
"736",110556,"California State University-Fresno",1,0,2005,2356,1403,953,323,106,217,0.155,0.137,0.111,0,219.52263,636,785,0.333191850594228
"737",110556,"California State University-Fresno",1,0,2006,2528,1501,1027,344,108,236,0.157,0.136,0.105,0,259.430683,664,843,0.333465189873418
"738",110556,"California State University-Fresno",1,0,2007,2552,1526,1026,350,112,238,0.156,0.137,0.109,0,207.464641,704,797,0.31230407523511
"739",110556,"California State University-Fresno",1,0,2008,2731,1604,1127,402,121,281,0.175,0.147,0.107,0,284.103506,703,847,0.310142804833394
"740",110556,"California State University-Fresno",1,0,2009,2619,1574,1045,407,123,284,0.18,0.155,0.118,0,285.931101,653,780,0.297823596792669
"741",110556,"California State University-Fresno",1,0,2010,2582,1551,1031,420,116,304,0.196,0.163,0.113,0,287.923239,642,667,0.258326878388846
"742",110565,"CALIFORNIA STATE UNIVERSITY-FULLERTON",1,0,1991,1847,1094,753,137,30,107,0.098,0.074,0.04,936,136.230621,686,714,0.386572820790471
"743",110565,"CALIFORNIA STATE UNIVERSITY-FULLERTON",1,0,1992,1589,926,663,108,27,81,0.088,0.068,0.041,1480,141.783862,645,562,0.353681560730019
"744",110565,"CALIFORNIA STATE UNIVERSITY-FULLERTON",1,0,1993,1309,748,561,112,40,72,0.096,0.086,0.071,1674,137.028144,623,431,0.3292589763178
"745",110565,"CALIFORNIA STATE UNIVERSITY-FULLERTON",1,0,1995,1832,1036,796,148,41,107,0.103,0.081,0.052,1891,154.680793,612,556,0.303493449781659
"746",110565,"CALIFORNIA STATE UNIVERSITY-FULLERTON",1,0,1996,2028,1158,870,199,48,151,0.13,0.098,0.055,1935,149.541084,618,610,0.300788954635108
"747",110565,"CALIFORNIA STATE UNIVERSITY-FULLERTON",1,0,1997,2192,1317,875,215,48,167,0.127,0.098,0.055,1936,172.027669,602,625,0.285127737226277
"748",110565,"CALIFORNIA STATE UNIVERSITY-FULLERTON",1,0,1998,2146,1240,906,274,65,209,0.168,0.128,0.072,1858,177.699594,621,636,0.296365330848089
"749",110565,"CALIFORNIA STATE UNIVERSITY-FULLERTON",1,0,1999,2544,1543,1001,349,63,286,0.185,0.137,0.063,0,234.680768,646,758,0.297955974842767
"750",110565,"CALIFORNIA STATE UNIVERSITY-FULLERTON",1,0,2000,2655,1609,1046,381,83,298,0.185,0.144,0.079,0,248.305684,690.5,843,0.317514124293785
"751",110565,"CALIFORNIA STATE UNIVERSITY-FULLERTON",1,0,2001,2772,1673,1099,416,86,330,0.197,0.15,0.078,0,288.025163,735,846,0.305194805194805
"752",110565,"CALIFORNIA STATE UNIVERSITY-FULLERTON",1,0,2002,3291,2039,1252,481,111,370,0.182,0.146,0.089,0,302.424816,776,1076,0.326952294135521
"753",110565,"CALIFORNIA STATE UNIVERSITY-FULLERTON",1,0,2003,3098,1873,1225,481,107,374,0.2,0.155,0.087,0,280.692214,755,1018,0.328599096191091
"754",110565,"CALIFORNIA STATE UNIVERSITY-FULLERTON",1,0,2004,3539,2094,1445,583,148,435,0.208,0.165,0.102,0,287.64523,719,1117,0.315625883017802
"755",110565,"California State University-Fullerton",1,0,2005,3816,2241,1575,524,134,390,0.174,0.137,0.085,0,271.180602,757,1127,0.295335429769392
"756",110565,"California State University-Fullerton",1,0,2006,3736,2262,1474,500,122,378,0.167,0.134,0.083,0,302.357831,826,1045,0.279710920770878
"757",110565,"California State University-Fullerton",1,0,2007,4040,2430,1610,550,135,415,0.171,0.136,0.084,0,341.782013,894,1078,0.266831683168317
"758",110565,"California State University-Fullerton",1,0,2008,4519,2673,1846,630,180,450,0.168,0.139,0.098,0,387.685385,879,1275,0.282142066828944
"759",110565,"California State University-Fullerton",1,0,2009,3842,2233,1609,666,180,486,0.218,0.173,0.112,0,377.034019,866,1034,0.269130661114003
"760",110565,"California State University-Fullerton",1,0,2010,3749,2160,1589,660,173,487,0.226,0.176,0.109,0,368.020662,848,975,0.260069351827154
"761",110574,"CALIFORNIA STATE UNIVERSITY-HAYWARD",0,1,1991,649,445,204,87,22,65,0.146,0.134,0.108,936,89.330659,435,217,0.334360554699538
"762",110574,"CALIFORNIA STATE UNIVERSITY-HAYWARD",0,1,1992,572,394,178,76,17,59,0.15,0.133,0.096,1423,91.122411,388,135,0.236013986013986
"763",110574,"CALIFORNIA STATE UNIVERSITY-HAYWARD",0,1,1993,553,371,182,59,11,48,0.129,0.107,0.06,1674,91.972147,383,134,0.242314647377939
"764",110574,"CALIFORNIA STATE UNIVERSITY-HAYWARD",0,1,1995,542,331,211,55,22,33,0.1,0.101,0.104,1891,105.835355,381,119,0.219557195571956
"765",110574,"CALIFORNIA STATE UNIVERSITY-HAYWARD",0,1,1996,661,420,241,83,26,57,0.136,0.126,0.108,1935,106.629523,384,129,0.195158850226929
"766",110574,"CALIFORNIA STATE UNIVERSITY-HAYWARD",0,1,1997,711,451,260,94,26,68,0.151,0.132,0.1,1812,113.048024,352,128,0.180028129395218
"767",110574,"CALIFORNIA STATE UNIVERSITY-HAYWARD",0,1,1998,732,470,262,106,24,82,0.174,0.145,0.092,1746,119.074689,350,159,0.217213114754098
"768",110574,"CALIFORNIA STATE UNIVERSITY-HAYWARD",0,1,1999,714,466,248,119,26,93,0.2,0.167,0.105,0,125.935615,355,147,0.205882352941176
"769",110574,"CALIFORNIA STATE UNIVERSITY-HAYWARD",0,1,2000,669,452,217,109,26,83,0.184,0.163,0.12,0,146.723655,353,156,0.233183856502242
"770",110574,"CALIFORNIA STATE UNIVERSITY-HAYWARD",0,1,2001,692,435,257,75,17,58,0.133,0.108,0.066,0,175.543366,351,131,0.189306358381503
"771",110574,"CALIFORNIA STATE UNIVERSITY-HAYWARD",0,1,2002,746,473,273,119,43,76,0.161,0.16,0.158,0,153.599935,336,164,0.219839142091153
"772",110574,"CALIFORNIA STATE UNIVERSITY-HAYWARD",0,1,2003,672,415,257,111,32,79,0.19,0.165,0.125,0,158.849789,330,140,0.208333333333333
"773",110574,"CALIFORNIA STATE UNIVERSITY-EAST BAY",0,1,2004,840,516,324,122,38,84,0.163,0.145,0.117,0,152.90706,312,159,0.189285714285714
"774",110574,"California State University-East Bay",0,1,2005,686,414,272,110,39,71,0.171,0.16,0.143,0,142.700631,322,138,0.201166180758017
"775",110574,"California State University-East Bay",0,1,2006,881,506,375,131,48,83,0.164,0.149,0.128,0,158.732382,334,126,0.143019296254257
"776",110574,"California State University-East Bay",0,1,2007,1032,602,430,111,49,62,0.103,0.108,0.114,0,171.032914,350,124,0.12015503875969
"777",110574,"California State University-East Bay",0,1,2008,1356,828,528,141,45,96,0.116,0.104,0.085,0,187.556246,372,188,0.138643067846608
"778",110574,"California State University-East Bay",0,1,2009,1436,884,552,184,54,130,0.147,0.128,0.098,0,201.326638,354,187,0.130222841225627
"779",110574,"California State University-East Bay",0,1,2010,1192,751,441,168,47,121,0.161,0.141,0.107,0,179.489946,327,165,0.138422818791946
"780",110583,"CALIFORNIA STATE UNIVERSITY-LONG BEACH",1,0,1991,2142,1283,859,88,25,63,0.049,0.041,0.029,936,196.148238,861,791,0.369281045751634
"781",110583,"CALIFORNIA STATE UNIVERSITY-LONG BEACH",1,0,1992,1565,961,604,79,27,52,0.054,0.05,0.045,1425,191.674428,793,497,0.317571884984026
"782",110583,"CALIFORNIA STATE UNIVERSITY-LONG BEACH",1,0,1993,1835,1125,710,80,21,59,0.052,0.044,0.03,1674,189.84985,780,439,0.239237057220708
"783",110583,"CALIFORNIA STATE UNIVERSITY-LONG BEACH",1,0,1995,2057,1307,750,88,26,62,0.047,0.043,0.035,1891,200.55184,773,515,0.250364608653379
"784",110583,"CALIFORNIA STATE UNIVERSITY-LONG BEACH",1,0,1996,2299,1407,892,152,38,114,0.081,0.066,0.043,1935,208.025075,775,641,0.278816876903001
"785",110583,"CALIFORNIA STATE UNIVERSITY-LONG BEACH",1,0,1997,2498,1597,901,205,60,145,0.091,0.082,0.067,1844,213.942025,779,706,0.282626100880705
"786",110583,"CALIFORNIA STATE UNIVERSITY-LONG BEACH",1,0,1998,2652,1707,945,285,61,224,0.131,0.107,0.065,1766,227.711567,782,809,0.305052790346908
"787",110583,"CALIFORNIA STATE UNIVERSITY-LONG BEACH",1,0,1999,3309,2128,1181,361,75,286,0.134,0.109,0.064,0,244.38148,815,1068,0.322756119673617
"788",110583,"CALIFORNIA STATE UNIVERSITY-LONG BEACH",1,0,2000,3214,2038,1176,375,87,288,0.141,0.117,0.074,0,328.493346,869.5,1078,0.335407591785937
"789",110583,"CALIFORNIA STATE UNIVERSITY-LONG BEACH",1,0,2001,4324,2751,1573,420,117,303,0.11,0.097,0.074,0,376.701472,924,1474,0.340888066604995
"790",110583,"CALIFORNIA STATE UNIVERSITY-LONG BEACH",1,0,2002,2912,1871,1041,365,91,274,0.146,0.125,0.087,0,288.394134,947,1064,0.365384615384615
"791",110583,"CALIFORNIA STATE UNIVERSITY-LONG BEACH",1,0,2003,3339,2236,1103,432,103,329,0.147,0.129,0.093,0,312.360925,964,1233,0.369272237196765
"792",110583,"CALIFORNIA STATE UNIVERSITY-LONG BEACH",1,0,2004,3300,2222,1078,406,103,303,0.136,0.123,0.096,0,314.028114,918,1000,0.303030303030303
"793",110583,"California State University-Long Beach",1,0,2005,4241,2666,1575,524,153,371,0.139,0.124,0.097,0,313.724487,968,1348,0.317849563782127
"794",110583,"California State University-Long Beach",1,0,2006,4334,2757,1577,550,175,375,0.136,0.127,0.111,0,353.262581,987,1307,0.301568989386248
"795",110583,"California State University-Long Beach",1,0,2007,4134,2620,1514,581,166,415,0.158,0.141,0.11,0,363.611753,1030,1135,0.274552491533624
"796",110583,"California State University-Long Beach",1,0,2008,4536,2856,1680,676,183,493,0.173,0.149,0.109,0,397.871551,1012,1324,0.291887125220459
"797",110583,"California State University-Long Beach",1,0,2009,3473,2133,1340,551,172,379,0.178,0.159,0.128,0,412.167584,1001,779,0.224301756406565
"798",110583,"California State University-Long Beach",1,0,2010,3913,2310,1603,585,189,396,0.171,0.15,0.118,0,388.372973,953,808,0.206491183235369
"799",110592,"CALIFORNIA STATE UNIVERSITY-LOS ANGELES",0,1,1991,1491,938,553,41,9,32,0.034,0.027,0.016,936,142.640395,616,75,0.0503018108651912
"800",110592,"CALIFORNIA STATE UNIVERSITY-LOS ANGELES",0,1,1992,1206,738,468,45,16,29,0.039,0.037,0.034,1427,139.483913,550,47,0.038971807628524
"801",110592,"CALIFORNIA STATE UNIVERSITY-LOS ANGELES",0,1,1993,1133,697,436,34,11,23,0.033,0.03,0.025,1674,133.528956,579,33,0.029126213592233
"802",110592,"CALIFORNIA STATE UNIVERSITY-LOS ANGELES",0,1,1995,1243,766,477,49,12,37,0.048,0.039,0.025,1891,142.597254,565,62,0.0498793242156074
"803",110592,"CALIFORNIA STATE UNIVERSITY-LOS ANGELES",0,1,1996,1313,763,550,51,15,36,0.047,0.039,0.027,1935,146.499114,555,66,0.0502665651180503
"804",110592,"CALIFORNIA STATE UNIVERSITY-LOS ANGELES",0,1,1997,1274,828,446,82,17,65,0.078,0.064,0.038,1758,145.874938,573,64,0.0502354788069074
"805",110592,"CALIFORNIA STATE UNIVERSITY-LOS ANGELES",0,1,1998,1255,789,466,103,22,81,0.103,0.082,0.047,1679,158.578482,569,80,0.0637450199203187
"806",110592,"CALIFORNIA STATE UNIVERSITY-LOS ANGELES",0,1,1999,1186,750,436,111,32,79,0.105,0.094,0.073,0,176.747372,592,86,0.0725126475548061
"807",110592,"CALIFORNIA STATE UNIVERSITY-LOS ANGELES",0,1,2000,1184,755,429,126,24,102,0.135,0.106,0.056,0,207.29963,586.5,75,0.0633445945945946
"808",110592,"CALIFORNIA STATE UNIVERSITY-LOS ANGELES",0,1,2001,1223,767,456,117,26,91,0.119,0.096,0.057,0,231.480958,581,70,0.0572363041700736
"809",110592,"CALIFORNIA STATE UNIVERSITY-LOS ANGELES",0,1,2002,1404,906,498,116,34,82,0.091,0.083,0.068,0,207.000523,599,97,0.0690883190883191
"810",110592,"CALIFORNIA STATE UNIVERSITY-LOS ANGELES",0,1,2003,1305,845,460,115,32,83,0.098,0.088,0.07,0,216.148036,600,83,0.0636015325670498
"811",110592,"CALIFORNIA STATE UNIVERSITY-LOS ANGELES",0,1,2004,1087,687,400,87,22,65,0.095,0.08,0.055,0,215.34514,558,61,0.0561177552897884
"812",110592,"California State University-Los Angeles",0,1,2005,1253,823,430,111,31,80,0.097,0.089,0.072,0,209.329662,581,60,0.0478850758180367
"813",110592,"California State University-Los Angeles",0,1,2006,1542,961,581,113,36,77,0.08,0.073,0.062,0,219.348374,565,76,0.0492866407263294
"814",110592,"California State University-Los Angeles",0,1,2007,1767,1106,661,119,40,79,0.071,0.067,0.061,0,231.458669,566,65,0.0367855121675156
"815",110592,"California State University-Los Angeles",0,1,2008,1676,1014,662,105,40,65,0.064,0.063,0.06,0,240.637994,579,67,0.0399761336515513
"816",110592,"California State University-Los Angeles",0,1,2009,1877,1173,704,127,40,87,0.074,0.068,0.057,0,259.144955,579,81,0.0431539690996271
"817",110592,"California State University-Los Angeles",0,1,2010,2013,1222,791,127,48,79,0.065,0.063,0.061,0,228.505556,556,80,0.0397416790859414
"818",110617,"CALIFORNIA STATE UNIVERSITY-SACRAMENTO",1,0,1991,1210,694,516,108,28,80,0.115,0.089,0.054,936,159.230999,808,678,0.560330578512397
"819",110617,"CALIFORNIA STATE UNIVERSITY-SACRAMENTO",1,0,1992,922,513,409,71,20,51,0.099,0.077,0.049,1460,160.762944,726,418,0.453362255965293
"820",110617,"CALIFORNIA STATE UNIVERSITY-SACRAMENTO",1,0,1993,1086,635,451,51,8,43,0.068,0.047,0.018,1674,163.371464,721,496,0.456721915285451
"821",110617,"CALIFORNIA STATE UNIVERSITY-SACRAMENTO",1,0,1995,1219,735,484,96,24,72,0.098,0.079,0.05,1891,177.360771,717,473,0.388022969647252
"822",110617,"CALIFORNIA STATE UNIVERSITY-SACRAMENTO",1,0,1996,1396,826,570,84,23,61,0.074,0.06,0.04,1935,173.012076,720,524,0.375358166189112
"823",110617,"CALIFORNIA STATE UNIVERSITY-SACRAMENTO",1,0,1997,1350,777,573,95,31,64,0.082,0.07,0.054,1982,194.941513,713,505,0.374074074074074
"824",110617,"CALIFORNIA STATE UNIVERSITY-SACRAMENTO",1,0,1998,1467,828,639,136,30,106,0.128,0.093,0.047,1934,197.155335,706,589,0.401499659168371
"825",110617,"CALIFORNIA STATE UNIVERSITY-SACRAMENTO",1,0,1999,1753,1013,740,159,39,120,0.118,0.091,0.053,0,215.393825,731,704,0.401597261836851
"826",110617,"CALIFORNIA STATE UNIVERSITY-SACRAMENTO",1,0,2000,2055,1198,857,178,36,142,0.118,0.087,0.042,0,293.10579,728,741,0.360583941605839
"827",110617,"CALIFORNIA STATE UNIVERSITY-SACRAMENTO",1,0,2001,2278,1387,891,221,49,172,0.124,0.097,0.055,0,321.154414,725,891,0.391132572431958
"828",110617,"CALIFORNIA STATE UNIVERSITY-SACRAMENTO",1,0,2002,2378,1395,983,221,56,165,0.118,0.093,0.057,0,272.023344,801,944,0.396972245584525
"829",110617,"CALIFORNIA STATE UNIVERSITY-SACRAMENTO",1,0,2003,2347,1415,932,227,62,165,0.117,0.097,0.067,0,289.708599,811,941,0.4009373668513
"830",110617,"CALIFORNIA STATE UNIVERSITY-SACRAMENTO",1,0,2004,2268,1375,893,240,57,183,0.133,0.106,0.064,0,295.132439,800,884,0.389770723104056
"831",110617,"California State University-Sacramento",1,0,2005,2436,1483,953,256,73,183,0.123,0.105,0.077,0,294.165252,765,911,0.373973727422003
"832",110617,"California State University-Sacramento",1,0,2006,2590,1570,1020,263,79,184,0.117,0.102,0.077,0,288.806071,786,901,0.347876447876448
"833",110617,"California State University-Sacramento",1,0,2007,2357,1426,931,194,64,130,0.091,0.082,0.069,0,310.747975,783,682,0.289350869749682
"834",110617,"California State University-Sacramento",1,0,2008,2536,1493,1043,191,50,141,0.094,0.075,0.048,0,334.269539,779,869,0.342665615141956
"835",110617,"California State University-Sacramento",1,0,2009,2954,1712,1242,196,50,146,0.085,0.066,0.04,0,346.734388,776,906,0.306702775897089
"836",110617,"California State University-Sacramento",1,0,2010,2625,1548,1077,238,69,169,0.109,0.091,0.064,0,340.387529,723,783,0.298285714285714
"837",113698,"DOMINICAN COLLEGE OF SAN RAFAEL",1,0,1991,66,50,16,22,3,19,0.38,0.333,0.188,10390,11.823311,42,44,0.666666666666667
"838",113698,"DOMINICAN COLLEGE OF SAN RAFAEL",1,0,1992,65,45,20,24,8,16,0.356,0.369,0.4,11280,14.336986,42,44,0.676923076923077
"839",113698,"DOMINICAN COLLEGE OF SAN RAFAEL",1,0,1993,75,46,29,17,4,13,0.283,0.227,0.138,12180,14.658314,40,49,0.653333333333333
"840",113698,"DOMINICAN COLLEGE OF SAN RAFAEL",1,0,1995,69,51,18,27,5,22,0.431,0.391,0.278,13890,18.581121,46,49,0.710144927536232
"841",113698,"DOMINICAN COLLEGE OF SAN RAFAEL",1,0,1996,58,41,17,23,6,17,0.415,0.397,0.353,14670,20.483669,39,31,0.53448275862069
"842",113698,"DOMINICAN COLLEGE OF SAN RAFAEL",1,0,1997,74,55,19,24,5,19,0.346,0.324,0.263,15424,19.668532,44,38,0.513513513513513
"843",113698,"DOMINICAN COLLEGE OF SAN RAFAEL",1,0,1998,72,58,14,30,6,24,0.414,0.417,0.429,16160,20.970784,49,45,0.625
"844",113698,"DOMINICAN COLLEGE OF SAN RAFAEL",1,0,1999,111,88,23,50,10,40,0.454,0.45,0.435,16512,19.783485,43,67,0.603603603603604
"845",113698,"DOMINICAN UNIVERSITY OF CALIFORNIA",1,0,2000,113,86,27,48,13,35,0.407,0.425,0.481,17256,20.041422,48.5,58,0.513274336283186
"846",113698,"DOMINICAN UNIVERSITY OF CALIFORNIA",1,0,2001,127,90,37,51,13,38,0.422,0.402,0.351,18648,23.328268,54,59,0.464566929133858
"847",113698,"DOMINICAN UNIVERSITY OF CALIFORNIA",1,0,2002,202,145,57,75,19,56,0.386,0.371,0.333,20320,26.339737,58,78,0.386138613861386
"848",113698,"DOMINICAN UNIVERSITY OF CALIFORNIA",1,0,2003,244,188,56,98,24,74,0.394,0.402,0.429,22250,28.86789,72,88,0.360655737704918
"849",113698,"DOMINICAN UNIVERSITY OF CALIFORNIA",1,0,2004,276,205,71,119,24,95,0.463,0.431,0.338,24254,29.978153,65,109,0.394927536231884
"850",113698,"Dominican University of California",1,0,2005,227,168,59,98,22,76,0.452,0.432,0.373,25950,30.967719,67,82,0.361233480176211
"851",113698,"Dominican University of California",1,0,2006,263,193,70,100,18,82,0.425,0.38,0.257,27770,32.016529,78,99,0.376425855513308
"852",113698,"Dominican University of California",1,0,2007,297,225,72,107,23,84,0.373,0.36,0.319,30270,39.115926,73,100,0.336700336700337
"853",113698,"Dominican University of California",1,0,2008,267,202,65,146,31,115,0.569,0.547,0.477,32090,42.870539,79,71,0.265917602996255
"854",113698,"Dominican University of California",1,0,2009,289,207,82,152,25,127,0.614,0.526,0.305,33540,43.29243,81,98,0.339100346020761
"855",113698,"Dominican University of California",1,0,2010,338,255,83,192,45,147,0.577,0.568,0.542,35220,48.183079,83,91,0.269230769230769
"856",115755,"HUMBOLDT STATE UNIVERSITY",1,0,1991,862,468,394,61,19,42,0.09,0.071,0.048,936,72.689966,342,649,0.752900232018561
"857",115755,"HUMBOLDT STATE UNIVERSITY",1,0,1992,779,421,358,45,16,29,0.069,0.058,0.045,1467,75.491862,324,560,0.718870346598203
"858",115755,"HUMBOLDT STATE UNIVERSITY",1,0,1993,553,324,229,60,9,51,0.157,0.108,0.039,1674,76.200026,301,390,0.705244122965642
"859",115755,"HUMBOLDT STATE UNIVERSITY",1,0,1995,908,503,405,69,18,51,0.101,0.076,0.044,1891,78.302663,311,644,0.709251101321586
"860",115755,"HUMBOLDT STATE UNIVERSITY",1,0,1996,823,471,352,62,13,49,0.104,0.075,0.037,1935,80.203681,315,529,0.64277035236938
"861",115755,"HUMBOLDT STATE UNIVERSITY",1,0,1997,718,401,317,85,14,71,0.177,0.118,0.044,1923,86.336329,309,481,0.66991643454039
"862",115755,"HUMBOLDT STATE UNIVERSITY",1,0,1998,731,405,326,71,24,47,0.116,0.097,0.074,1905,89.242899,319,477,0.652530779753762
"863",115755,"HUMBOLDT STATE UNIVERSITY",1,0,1999,751,436,315,89,25,64,0.147,0.119,0.079,0,93.20381,317,511,0.680426098535286
"864",115755,"HUMBOLDT STATE UNIVERSITY",1,0,2000,769,460,309,94,32,62,0.135,0.122,0.104,0,121.265421,313,535,0.695708712613784
"865",115755,"HUMBOLDT STATE UNIVERSITY",1,0,2001,725,416,309,81,18,63,0.151,0.112,0.058,0,128.869259,309,461,0.635862068965517
"866",115755,"HUMBOLDT STATE UNIVERSITY",1,0,2002,836,505,331,97,28,69,0.137,0.116,0.085,0,106.377971,303,499,0.59688995215311
"867",115755,"HUMBOLDT STATE UNIVERSITY",1,0,2003,853,481,372,97,26,71,0.148,0.114,0.07,0,111.739847,288,506,0.593200468933177
"868",115755,"HUMBOLDT STATE UNIVERSITY",1,0,2004,760,427,333,66,18,48,0.112,0.087,0.054,0,114.092962,288,426,0.560526315789474
"869",115755,"Humboldt State University",1,0,2005,813,461,352,99,32,67,0.145,0.122,0.091,0,115.057739,289,433,0.53259532595326
"870",115755,"Humboldt State University",1,0,2006,966,550,416,132,46,86,0.156,0.137,0.111,0,114.082254,299,485,0.502070393374741
"871",115755,"Humboldt State University",1,0,2007,1039,551,488,112,39,73,0.132,0.108,0.08,0,123.378558,284,472,0.454282964388835
"872",115755,"Humboldt State University",1,0,2008,1168,661,507,147,37,110,0.166,0.126,0.073,0,125.379857,279,555,0.475171232876712
"873",115755,"Humboldt State University",1,0,2009,1345,745,600,214,57,157,0.211,0.159,0.095,0,136.422938,272,741,0.55092936802974
"874",115755,"Humboldt State University",1,0,2010,1282,701,581,188,65,123,0.176,0.147,0.112,0,136.869009,250,644,0.502340093603744
"875",119173,"MOUNT SAINT MARYS COLLEGE",1,0,1993,276,273,3,56,0,56,0.205,0.203,0,11690,22.30449,52,39,0.141304347826087
"876",119173,"MOUNT SAINT MARYS COLLEGE",1,0,1995,222,220,2,50,2,48,0.218,0.225,1,13812,28.593324,72,30,0.135135135135135
"877",119173,"MOUNT SAINT MARYS COLLEGE",1,0,1998,295,293,2,62,0,62,0.212,0.21,0,15452,27.281992,82,43,0.145762711864407
"878",119173,"MOUNT ST MARY'S COLLEGE",1,0,1999,294,293,1,57,0,57,0.194,0.194,0,16776,30.176358,76,26,0.0884353741496599
"879",119173,"MOUNT ST MARY'S COLLEGE",1,0,2000,297,296,1,67,1,66,0.223,0.226,1,17036,31.923066,75.5,33,0.111111111111111
"880",119173,"MOUNT ST MARY'S COLLEGE",1,0,2001,328,325,3,47,1,46,0.142,0.143,0.333,17888,34.320554,75,38,0.115853658536585
"881",119173,"MOUNT ST MARY'S COLLEGE",1,0,2002,127,123,4,64,1,63,0.512,0.504,0.25,18782,33.796777,55,21,0.165354330708661
"882",119173,"MOUNT ST MARY'S COLLEGE",1,0,2003,339,330,9,84,4,80,0.242,0.248,0.444,19722,36.499404,71,40,0.117994100294985
"883",119173,"MOUNT ST MARY'S COLLEGE",1,0,2004,364,352,12,93,4,89,0.253,0.255,0.333,20708,38.197317,70,33,0.0906593406593407
"884",119173,"Mount St Mary's College",1,0,2005,393,378,15,68,3,65,0.172,0.173,0.2,22054,40.521984,74,46,0.11704834605598
"885",119173,"Mount St Mary's College",1,0,2006,345,336,9,76,1,75,0.223,0.22,0.111,23380,46.609149,77,26,0.0753623188405797
"886",119173,"Mount St Mary's College",1,0,2007,348,331,17,93,7,86,0.26,0.267,0.412,24550,46.291806,81,20,0.0574712643678161
"887",119173,"Mount St Mary's College",1,0,2008,313,302,11,84,2,82,0.272,0.268,0.182,26280,48.985649,83,21,0.0670926517571885
"888",119173,"Mount St Mary's College",1,0,2009,367,351,16,109,5,104,0.296,0.297,0.312,27840,54.179416,90,17,0.0463215258855586
"889",119173,"Mount St Mary's College",1,0,2010,525,507,18,140,3,137,0.27,0.267,0.167,29232,54.041751,95,29,0.0552380952380952
"890",120184,"COLLEGE OF NOTRE DAME",1,0,1991,71,51,20,25,6,19,0.372,0.352,0.3,10165,10.793662,55,32,0.450704225352113
"891",120184,"COLLEGE OF NOTRE DAME",1,0,1992,85,54,31,34,14,20,0.37,0.4,0.452,11015,11.41318,57,32,0.376470588235294
"892",120184,"COLLEGE OF NOTRE DAME",1,0,1993,96,76,20,36,5,31,0.408,0.375,0.25,11750,13.193448,59,39,0.40625
"893",120184,"COLLEGE OF NOTRE DAME",1,0,1995,115,79,36,44,9,35,0.443,0.383,0.25,13535,17.44828,60,42,0.365217391304348
"894",120184,"COLLEGE OF NOTRE DAME",1,0,1996,124,75,49,49,16,33,0.44,0.395,0.327,14400,18.73215,60,40,0.32258064516129
"895",120184,"COLLEGE OF NOTRE DAME",1,0,1997,129,79,50,38,15,23,0.291,0.295,0.3,14976,16.843001,62,41,0.317829457364341
"896",120184,"COLLEGE OF NOTRE DAME",1,0,1998,130,80,50,52,14,38,0.475,0.4,0.28,15576,18.456511,63,40,0.307692307692308
"897",120184,"COLLEGE OF NOTRE DAME",1,0,1999,129,85,44,50,17,33,0.388,0.388,0.386,16200,18.976356,66,38,0.294573643410853
"898",120184,"COLLEGE OF NOTRE DAME",1,0,2000,137,99,38,54,15,39,0.394,0.394,0.395,16850,20.61308,61.5,49,0.357664233576642
"899",120184,"NOTRE DAME DE NAMUR UNIVERSITY",1,0,2001,111,85,26,55,10,45,0.529,0.495,0.385,18200,22.254229,57,29,0.261261261261261
"900",120184,"NOTRE DAME DE NAMUR UNIVERSITY",1,0,2002,97,57,40,42,12,30,0.526,0.433,0.3,19110,23.261017,51,43,0.443298969072165
"901",120184,"NOTRE DAME DE NAMUR UNIVERSITY",1,0,2003,190,106,84,90,36,54,0.509,0.474,0.429,20050,23.550623,57,70,0.368421052631579
"902",120184,"NOTRE DAME DE NAMUR UNIVERSITY",1,0,2004,161,108,53,68,19,49,0.454,0.422,0.358,21350,23.976562,52,78,0.484472049689441
"903",120184,"Notre Dame de Namur University",1,0,2005,144,95,49,59,14,45,0.474,0.41,0.286,22520,26.176489,50,50,0.347222222222222
"904",120184,"Notre Dame de Namur University",1,0,2006,134,93,41,51,15,36,0.387,0.381,0.366,23650,26.112578,53,59,0.440298507462687
"905",120184,"Notre Dame de Namur University",1,0,2007,96,57,39,35,12,23,0.404,0.365,0.308,24450,27.290143,54,30,0.3125
"906",120184,"Notre Dame de Namur University",1,0,2008,147,85,62,63,21,42,0.494,0.429,0.339,25300,28.070661,54,32,0.217687074829932
"907",120184,"Notre Dame de Namur University",1,0,2009,116,78,38,33,10,23,0.295,0.284,0.263,26830,27.042563,55,26,0.224137931034483
"908",120184,"Notre Dame de Namur University",1,0,2010,145,94,51,50,15,35,0.372,0.345,0.294,28200,27.010381,59,31,0.213793103448276
"909",121309,"POINT LOMA NAZARENE COLLEGE",0,1,1991,317,194,123,103,34,69,0.356,0.325,0.276,8058,29.089436,92,243,0.766561514195584
"910",121309,"POINT LOMA NAZARENE COLLEGE",1,0,1992,374,248,126,94,27,67,0.27,0.251,0.214,8838,28.655224,91,317,0.8475935828877
"911",121309,"POINT LOMA NAZARENE COLLEGE",1,0,1993,425,255,170,127,34,93,0.365,0.299,0.2,9542,32.47261,94,361,0.849411764705882
"912",121309,"POINT LOMA NAZARENE COLLEGE",1,0,1995,475,313,162,185,57,128,0.409,0.389,0.352,10880,37.197425,101,405,0.852631578947368
"913",121309,"POINT LOMA NAZARENE COLLEGE",1,0,1996,515,313,202,218,70,148,0.473,0.423,0.347,11824,39.405134,100,445,0.864077669902913
"914",121309,"POINT LOMA NAZARENE COLLEGE",1,0,1997,494,306,188,187,64,123,0.402,0.379,0.34,12464,33.023352,108,424,0.8582995951417
"915",121309,"POINT LOMA NAZARENE UNIVERSITY",1,0,1998,598,375,223,261,87,174,0.464,0.436,0.39,12650,36.035182,109,499,0.834448160535117
"916",121309,"POINT LOMA NAZARENE UNIVERSITY",1,0,1999,613,392,221,332,117,215,0.548,0.542,0.529,13186,41.540455,117,520,0.848287112561175
"917",121309,"POINT LOMA NAZARENE UNIVERSITY",1,0,2000,539,312,227,274,101,173,0.554,0.508,0.445,13900,43.74673,120.5,457,0.847866419294991
"918",121309,"POINT LOMA NAZARENE UNIVERSITY",1,0,2001,545,346,199,327,106,221,0.639,0.6,0.533,14800,47.813317,124,478,0.877064220183486
"919",121309,"POINT LOMA NAZARENE UNIVERSITY",1,0,2002,535,324,211,321,111,210,0.648,0.6,0.526,15760,49.845379,128,459,0.857943925233645
"920",121309,"POINT LOMA NAZARENE UNIVERSITY",1,0,2003,566,356,210,353,119,234,0.657,0.624,0.567,18000,53.769917,134,455,0.803886925795053
"921",121309,"POINT LOMA NAZARENE UNIVERSITY",1,0,2004,535,339,196,395,141,254,0.749,0.738,0.719,19040,58.209741,135,425,0.794392523364486
"922",121309,"Point Loma Nazarene University",1,0,2005,562,339,223,348,125,223,0.658,0.619,0.561,20200,61.344362,139,446,0.793594306049822
"923",121309,"Point Loma Nazarene University",1,0,2006,537,342,195,352,118,234,0.684,0.655,0.605,21620,64.712386,145,412,0.767225325884544
"924",121309,"Point Loma Nazarene University",1,0,2007,530,336,194,327,109,218,0.649,0.617,0.562,23200,70.395941,151,420,0.792452830188679
"925",121309,"Point Loma Nazarene University",1,0,2008,538,327,211,318,116,202,0.618,0.591,0.55,24580,74.603572,146,425,0.78996282527881
"926",121309,"Point Loma Nazarene University",1,0,2009,533,343,190,338,113,225,0.656,0.634,0.595,25300,75.869748,154,390,0.731707317073171
"927",121309,"Point Loma Nazarene University",1,0,2010,588,360,228,367,130,237,0.658,0.624,0.57,26500,74.640141,142,409,0.695578231292517
"928",121345,"POMONA COLLEGE",1,0,1991,359,164,195,294,155,139,0.848,0.819,0.795,14800,51.18819,145,209,0.582172701949861
"929",121345,"POMONA COLLEGE",1,0,1992,382,192,190,316,148,168,0.875,0.827,0.779,15700,48.318258,160,212,0.554973821989529
"930",121345,"POMONA COLLEGE",1,0,1993,390,183,207,317,167,150,0.82,0.813,0.807,16720,50.93858,161,205,0.525641025641026
"931",121345,"POMONA COLLEGE",1,0,1995,392,190,202,336,166,170,0.895,0.857,0.822,18600,53.782854,154,209,0.533163265306122
"932",121345,"POMONA COLLEGE",1,0,1996,396,187,209,331,173,158,0.845,0.836,0.828,19530,59.827445,154,190,0.47979797979798
"933",121345,"POMONA COLLEGE",1,0,1997,393,195,198,338,166,172,0.882,0.86,0.838,20500,54.944,152,210,0.534351145038168
"934",121345,"POMONA COLLEGE",1,0,1998,396,182,214,321,168,153,0.841,0.811,0.785,21420,58.713,161,211,0.532828282828283
"935",121345,"POMONA COLLEGE",1,0,1999,390,194,196,338,167,171,0.881,0.867,0.852,22940,61.649,155,224,0.574358974358974
"936",121345,"POMONA COLLEGE",1,0,2000,398,208,190,346,163,183,0.88,0.869,0.858,23910,68.362,156,238,0.597989949748744
"937",121345,"POMONA COLLEGE",1,0,2001,393,192,201,339,173,166,0.865,0.863,0.861,24750,73.691,157,234,0.595419847328244
"938",121345,"POMONA COLLEGE",1,0,2002,374,191,183,338,158,180,0.942,0.904,0.863,25730,79.614,168,224,0.598930481283422
"939",121345,"POMONA COLLEGE",1,0,2003,398,202,196,354,170,184,0.911,0.889,0.867,26890,81.475,174,208,0.522613065326633
"940",121345,"POMONA COLLEGE",1,0,2004,393,196,197,356,181,175,0.893,0.906,0.919,28100,85.903,181,204,0.519083969465649
"941",121345,"Pomona College",1,0,2005,382,193,189,347,169,178,0.922,0.908,0.894,29650,92.208,190,186,0.486910994764398
"942",121345,"Pomona College",1,0,2006,378,190,188,337,162,175,0.921,0.892,0.862,31580,97.923,197,185,0.489417989417989
"943",121345,"Pomona College",1,0,2007,375,188,187,348,172,176,0.936,0.928,0.92,33635,107.885,204,173,0.461333333333333
"944",121345,"Pomona College",1,0,2008,382,194,188,344,168,176,0.907,0.901,0.894,35318,117.795,199,174,0.455497382198953
"945",121345,"Pomona College",1,0,2009,389,190,199,355,180,175,0.921,0.913,0.905,36710,122.066,200,166,0.426735218508997
"946",121345,"Pomona College",1,0,2010,401,217,184,369,169,200,0.922,0.92,0.918,38087,119.226,200,191,0.476309226932668
"947",122409,"SAN DIEGO STATE UNIVERSITY",1,0,1991,2479,1440,1039,151,39,112,0.078,0.061,0.038,936,227.019824,1018,1325,0.534489713594191
"948",122409,"SAN DIEGO STATE UNIVERSITY",1,0,1992,1974,1129,845,154,45,109,0.096,0.078,0.053,1500,227.233457,940,947,0.479736575481256
"949",122409,"SAN DIEGO STATE UNIVERSITY",1,0,1993,1973,1081,892,126,25,101,0.093,0.064,0.028,1674,224.287564,909,842,0.426761277242778
"950",122409,"SAN DIEGO STATE UNIVERSITY",1,0,1995,2840,1716,1124,212,58,154,0.09,0.075,0.052,1891,232.012356,894,1238,0.435915492957746
"951",122409,"SAN DIEGO STATE UNIVERSITY",1,0,1996,2908,1752,1156,208,55,153,0.087,0.072,0.048,1935,239.045921,891,1234,0.424346629986245
"952",122409,"SAN DIEGO STATE UNIVERSITY",1,0,1997,3008,1766,1242,280,73,207,0.117,0.093,0.059,1932,259.9739,904,1347,0.44780585106383
"953",122409,"SAN DIEGO STATE UNIVERSITY",1,0,1998,3128,1815,1313,308,79,229,0.126,0.098,0.06,1784,270.970122,907,1419,0.453644501278772
"954",122409,"SAN DIEGO STATE UNIVERSITY",1,0,1999,2834,1574,1260,394,119,275,0.175,0.139,0.094,0,455.657919,934,1433,0.505645730416373
"955",122409,"SAN DIEGO STATE UNIVERSITY",1,0,2000,2719,1598,1121,472,130,342,0.214,0.174,0.116,0,491.896381,984.5,1441,0.529974255240897
"956",122409,"SAN DIEGO STATE UNIVERSITY",1,0,2001,3338,1986,1352,664,178,486,0.245,0.199,0.132,0,552.161941,1035,1694,0.507489514679449
"957",122409,"SAN DIEGO STATE UNIVERSITY",1,0,2002,3662,2217,1445,879,237,642,0.29,0.24,0.164,0,358.4087,1042,1890,0.516111414527581
"958",122409,"SAN DIEGO STATE UNIVERSITY",1,0,2003,3418,2106,1312,973,286,687,0.326,0.285,0.218,0,376.491591,977,1859,0.543885313048566
"959",122409,"SAN DIEGO STATE UNIVERSITY",1,0,2004,3527,2128,1399,1073,307,766,0.36,0.304,0.219,0,375.735184,886,1905,0.540119081372271
"960",122409,"San Diego State University",1,0,2005,3439,2039,1400,1011,323,688,0.337,0.294,0.231,0,380.037223,931,1807,0.525443442861297
"961",122409,"San Diego State University",1,0,2006,4109,2458,1651,1309,382,927,0.377,0.319,0.231,0,409.635765,964,2158,0.525188610367486
"962",122409,"San Diego State University",1,0,2007,4506,2685,1821,1472,449,1023,0.381,0.327,0.247,0,442.960243,959,2312,0.513093652907235
"963",122409,"San Diego State University",1,0,2008,3578,2086,1492,1053,346,707,0.339,0.294,0.232,0,461.274537,966,1577,0.440749021799888
"964",122409,"San Diego State University",1,0,2009,3291,1881,1410,990,332,658,0.35,0.301,0.235,0,485.907668,900,1389,0.422060164083865
"965",122409,"San Diego State University",1,0,2010,3031,1802,1229,1017,352,665,0.369,0.336,0.286,0,448.380833,849,1332,0.439458924447377
"966",122436,"UNIVERSITY OF SAN DIEGO",1,0,1991,882,528,354,471,181,290,0.549,0.534,0.511,11440,87.507968,254,645,0.731292517006803
"967",122436,"UNIVERSITY OF SAN DIEGO",1,0,1992,929,524,405,462,175,287,0.548,0.497,0.432,12240,95.281353,263,636,0.684607104413348
"968",122436,"UNIVERSITY OF SAN DIEGO",1,0,1993,890,516,374,468,171,297,0.576,0.526,0.457,12970,101.857006,265,619,0.695505617977528
"969",122436,"UNIVERSITY OF SAN DIEGO",1,0,1995,978,597,381,500,186,314,0.526,0.511,0.488,14320,114.33794,271,674,0.689161554192229
"970",122436,"UNIVERSITY OF SAN DIEGO",1,0,1996,1042,569,473,542,213,329,0.578,0.52,0.45,14960,113.301942,274,734,0.704414587332054
"971",122436,"UNIVERSITY OF SAN DIEGO",1,0,1997,1036,630,406,589,194,395,0.627,0.569,0.478,15780,118.7915,283,736,0.71042471042471
"972",122436,"UNIVERSITY OF SAN DIEGO",1,0,1998,1028,614,414,610,222,388,0.632,0.593,0.536,16470,104.398779,288,719,0.699416342412451
"973",122436,"UNIVERSITY OF SAN DIEGO",1,0,1999,990,621,369,611,204,407,0.655,0.617,0.553,17780,100.223179,294,726,0.733333333333333
"974",122436,"UNIVERSITY OF SAN DIEGO",1,0,2000,1024,642,382,656,225,431,0.671,0.641,0.589,19020,126.694407,305,745,0.7275390625
"975",122436,"UNIVERSITY OF SAN DIEGO",1,0,2001,1003,646,357,635,217,418,0.647,0.633,0.608,20350,140.623237,316,677,0.674975074775673
"976",122436,"UNIVERSITY OF SAN DIEGO",1,0,2002,1049,681,368,672,219,453,0.665,0.641,0.595,21880,159.117364,328,732,0.697807435653003
"977",122436,"UNIVERSITY OF SAN DIEGO",1,0,2003,1059,718,341,695,208,487,0.678,0.656,0.61,23410,172.482766,341,726,0.685552407932011
"978",122436,"UNIVERSITY OF SAN DIEGO",1,0,2004,1174,705,469,706,259,447,0.634,0.601,0.552,24860,186.105454,340,830,0.706984667802385
"979",122436,"University of San Diego",1,0,2005,1131,710,421,726,238,488,0.687,0.642,0.565,26350,202.442757,359,760,0.671971706454465
"980",122436,"University of San Diego",1,0,2006,1103,703,400,714,214,500,0.711,0.647,0.535,30480,217.95647,363,702,0.636446056210335
"981",122436,"University of San Diego",1,0,2007,1089,635,454,704,254,450,0.709,0.646,0.559,32300,228.228196,367,654,0.600550964187328
"982",122436,"University of San Diego",1,0,2008,1259,771,488,838,289,549,0.712,0.666,0.592,34000,240.35038,369,810,0.643367752184273
"983",122436,"University of San Diego",1,0,2009,1081,621,460,714,259,455,0.733,0.66,0.563,35870,250.522,381,645,0.596669750231267
"984",122436,"University of San Diego",1,0,2010,1148,662,486,752,280,472,0.713,0.655,0.576,36950,249.17,393,729,0.635017421602787
"985",122597,"SAN FRANCISCO STATE UNIVERSITY",1,0,1991,1219,774,445,72,28,44,0.057,0.059,0.063,936,173.74552,807,308,0.252666119770304
"986",122597,"SAN FRANCISCO STATE UNIVERSITY",1,0,1992,1125,693,432,73,19,54,0.078,0.065,0.044,1444,177.144916,727,276,0.245333333333333
"987",122597,"SAN FRANCISCO STATE UNIVERSITY",1,0,1993,1141,668,473,60,16,44,0.066,0.053,0.034,1674,177.210792,709,263,0.230499561787905
"988",122597,"SAN FRANCISCO STATE UNIVERSITY",1,0,1995,1539,966,573,89,26,63,0.065,0.058,0.045,1891,213.031231,728,349,0.226770630279402
"989",122597,"SAN FRANCISCO STATE UNIVERSITY",1,0,1996,1727,1102,625,111,35,76,0.069,0.064,0.056,1935,221.825775,760,393,0.227562246670527
"990",122597,"SAN FRANCISCO STATE UNIVERSITY",1,0,1997,1732,1086,646,115,36,79,0.073,0.066,0.056,1978,260.352475,767,380,0.219399538106236
"991",122597,"SAN FRANCISCO STATE UNIVERSITY",1,0,1998,1805,1143,662,134,23,111,0.097,0.074,0.035,1884,270.610503,772,413,0.228808864265928
"992",122597,"SAN FRANCISCO STATE UNIVERSITY",1,0,1999,1898,1158,740,178,54,124,0.107,0.094,0.073,0,270.28207,793,491,0.258693361433087
"993",122597,"SAN FRANCISCO STATE UNIVERSITY",1,0,2000,1870,1212,658,205,54,151,0.125,0.11,0.082,0,321.215251,781,474,0.253475935828877
"994",122597,"SAN FRANCISCO STATE UNIVERSITY",1,0,2001,1820,1157,663,209,58,151,0.13,0.115,0.087,0,330.565769,769,477,0.262087912087912
"995",122597,"SAN FRANCISCO STATE UNIVERSITY",1,0,2002,2130,1378,752,211,52,159,0.115,0.099,0.069,0,318.102245,784,510,0.23943661971831
"996",122597,"SAN FRANCISCO STATE UNIVERSITY",1,0,2003,2291,1474,817,267,69,198,0.134,0.117,0.084,0,334.352479,792,685,0.298996071584461
"997",122597,"SAN FRANCISCO STATE UNIVERSITY",1,0,2004,2739,1770,969,390,114,276,0.156,0.142,0.118,0,349.783837,767,843,0.307776560788609
"998",122597,"San Francisco State University",1,0,2005,2999,1942,1057,360,105,255,0.131,0.12,0.099,0,363.029773,775,981,0.327109036345448
"999",122597,"San Francisco State University",1,0,2006,3117,2017,1100,418,128,290,0.144,0.134,0.116,0,372.458625,787,1019,0.326916907282644
"1000",122597,"San Francisco State University",1,0,2007,3341,2123,1218,424,118,306,0.144,0.127,0.097,0,401.986541,845,1118,0.334630350194553
"1001",122597,"San Francisco State University",1,0,2008,3512,2334,1178,524,145,379,0.162,0.149,0.123,0,431.055092,860,1157,0.329441913439636
"1002",122597,"San Francisco State University",1,0,2009,3855,2497,1358,704,178,526,0.211,0.183,0.131,0,437.219606,852,1182,0.306614785992218
"1003",122597,"San Francisco State University",1,0,2010,3609,2179,1430,648,210,438,0.201,0.18,0.147,0,425.501559,803,1049,0.290662233305625
"1004",122612,"UNIVERSITY OF SAN FRANCISCO",1,0,1991,459,299,160,205,72,133,0.445,0.447,0.45,11040,76.347,240,227,0.494553376906318
"1005",122612,"UNIVERSITY OF SAN FRANCISCO",1,0,1992,492,319,173,233,75,158,0.495,0.474,0.434,11816,91.964,261,219,0.445121951219512
"1006",122612,"UNIVERSITY OF SAN FRANCISCO",1,0,1993,530,359,171,225,61,164,0.457,0.425,0.357,12578,99.669,262,208,0.392452830188679
"1007",122612,"UNIVERSITY OF SAN FRANCISCO",1,0,1995,550,350,200,237,71,166,0.474,0.431,0.355,14108,115.33,284,196,0.356363636363636
"1008",122612,"UNIVERSITY OF SAN FRANCISCO",1,0,1996,616,413,203,307,89,218,0.528,0.498,0.438,14920,118.647501,290,214,0.347402597402597
"1009",122612,"UNIVERSITY OF SAN FRANCISCO",1,0,1997,600,385,215,285,96,189,0.491,0.475,0.447,15850,130.843,303,210,0.35
"1010",122612,"UNIVERSITY OF SAN FRANCISCO",1,0,1998,640,436,204,296,80,216,0.495,0.462,0.392,16630,134.134,303,249,0.3890625
"1011",122612,"UNIVERSITY OF SAN FRANCISCO",1,0,1999,757,500,257,379,109,270,0.54,0.501,0.424,17710,142.61,332,328,0.4332892998679
"1012",122612,"UNIVERSITY OF SAN FRANCISCO",1,0,2000,757,518,239,363,100,263,0.508,0.48,0.418,18860,151.306,321,315,0.416116248348745
"1013",122612,"UNIVERSITY OF SAN FRANCISCO",1,0,2001,840,572,268,411,114,297,0.519,0.489,0.425,20190,137.386,310,357,0.425
"1014",122612,"UNIVERSITY OF SAN FRANCISCO",1,0,2002,839,582,257,431,132,299,0.514,0.514,0.514,21660,151.415,326,303,0.361144219308701
"1015",122612,"UNIVERSITY OF SAN FRANCISCO",1,0,2003,914,632,282,452,131,321,0.508,0.495,0.465,23220,160.713,345,351,0.384026258205689
"1016",122612,"UNIVERSITY OF SAN FRANCISCO",1,0,2004,929,614,315,518,151,367,0.598,0.558,0.479,24800,176.31,344,358,0.385360602798708
"1017",122612,"University of San Francisco",1,0,2005,932,665,267,542,131,411,0.618,0.582,0.491,26680,186.497,348,372,0.399141630901288
"1018",122612,"University of San Francisco",1,0,2006,1073,733,340,582,166,416,0.568,0.542,0.488,28420,196.554,367,417,0.388630009319665
"1019",122612,"University of San Francisco",1,0,2007,1052,680,372,595,179,416,0.612,0.566,0.481,30840,209.197,371,428,0.406844106463878
"1020",122612,"University of San Francisco",1,0,2008,1036,686,350,632,196,436,0.636,0.61,0.56,33160,227.664,380,439,0.423745173745174
"1021",122612,"University of San Francisco",1,0,2009,1073,744,329,648,172,476,0.64,0.604,0.523,34430,242.267,386,416,0.387698042870457
"1022",122612,"University of San Francisco",1,0,2010,1171,750,421,721,233,488,0.651,0.616,0.553,36000,241.025,394,413,0.35269000853971
"1023",122931,"SANTA CLARA UNIVERSITY",0,1,1991,928,457,471,675,335,340,0.744,0.727,0.711,11271,100.83,317,620,0.668103448275862
"1024",122931,"SANTA CLARA UNIVERSITY",0,1,1992,900,458,442,661,303,358,0.782,0.734,0.686,12150,104.169999,326,552,0.613333333333333
"1025",122931,"SANTA CLARA UNIVERSITY",0,1,1993,888,489,399,657,287,370,0.757,0.74,0.719,12879,114.575,324,492,0.554054054054054
"1026",122931,"SANTA CLARA UNIVERSITY",0,1,1995,1043,558,485,757,329,428,0.767,0.726,0.678,14604,126.403,322,580,0.556088207094918
"1027",122931,"SANTA CLARA UNIVERSITY",0,1,1996,1075,586,489,798,349,449,0.766,0.742,0.714,15450,135.478,344,618,0.574883720930233
"1028",122931,"SANTA CLARA UNIVERSITY",0,1,1997,1004,543,461,766,328,438,0.807,0.763,0.711,16455,116.713,359,592,0.589641434262948
"1029",122931,"SANTA CLARA UNIVERSITY",0,1,1998,1032,570,462,783,331,452,0.793,0.759,0.716,17442,123.907,369,588,0.569767441860465
"1030",122931,"SANTA CLARA UNIVERSITY",0,1,1999,1101,619,482,854,358,496,0.801,0.776,0.743,19095,129.263,399,649,0.589464123524069
"1031",122931,"SANTA CLARA UNIVERSITY",0,1,2000,1025,544,481,814,366,448,0.824,0.794,0.761,20337,140.502,405,601,0.586341463414634
"1032",122931,"SANTA CLARA UNIVERSITY",0,1,2001,1017,556,461,799,339,460,0.827,0.786,0.735,22572,153.908,411,597,0.587020648967552
"1033",122931,"SANTA CLARA UNIVERSITY",0,1,2002,1116,659,457,873,342,531,0.806,0.782,0.748,23925,166.079,413,694,0.621863799283154
"1034",122931,"SANTA CLARA UNIVERSITY",0,1,2003,892,509,383,690,284,406,0.798,0.774,0.742,25365,176.398,416,566,0.634529147982063
"1035",122931,"SANTA CLARA UNIVERSITY",0,1,2004,1171,658,513,941,392,549,0.834,0.804,0.764,27135,185.846,423,693,0.591801878736123
"1036",122931,"Santa Clara University",0,1,2005,1197,667,530,917,384,533,0.799,0.766,0.725,28899,192.145,447,699,0.583959899749373
"1037",122931,"Santa Clara University",0,1,2006,1340,740,600,1055,448,607,0.82,0.787,0.747,30900,202.454,474,655,0.488805970149254
"1038",122931,"Santa Clara University",0,1,2007,1201,619,582,923,431,492,0.795,0.769,0.741,33000,216.959,506,548,0.456286427976686
"1039",122931,"Santa Clara University",0,1,2008,1220,623,597,951,436,515,0.827,0.78,0.73,34950,233.935,512,471,0.386065573770492
"1040",122931,"Santa Clara University",0,1,2009,1084,571,513,830,371,459,0.804,0.766,0.723,36000,251.943,434,412,0.380073800738007
"1041",122931,"Santa Clara University",0,1,2010,1295,644,651,1056,498,558,0.867,0.815,0.765,37368,253.701,448,639,0.493436293436293
"1042",123554,"SAINT MARY'S COLLEGE OF CALIFORNIA",1,0,1991,437,241,196,247,101,146,0.606,0.565,0.515,11036,42.020652,123,292,0.668192219679634
"1043",123554,"SAINT MARY'S COLLEGE OF CALIFORNIA",1,0,1992,472,257,215,289,126,163,0.634,0.612,0.586,11966,43.954359,135,324,0.686440677966102
"1044",123554,"SAINT MARYS COLLEGE OF CALIFORNIA",1,0,1993,464,249,215,294,128,166,0.667,0.634,0.595,12636,49.22622,135,301,0.648706896551724
"1045",123554,"SAINT MARYS COLLEGE OF CALIFORNIA",1,0,1995,474,256,218,306,141,165,0.645,0.646,0.647,14250,55.791762,160,326,0.687763713080169
"1046",123554,"SAINT MARYS COLLEGE OF CALIFORNIA",1,0,1996,488,288,200,307,102,205,0.712,0.629,0.51,15098,53.887764,155,317,0.649590163934426
"1047",123554,"SAINT MARYS COLLEGE OF CALIFORNIA",1,0,1997,596,348,248,390,144,246,0.707,0.654,0.581,15880,52.776669,164,388,0.651006711409396
"1048",123554,"SAINT MARYS COLLEGE OF CALIFORNIA",1,0,1998,573,343,230,352,125,227,0.662,0.614,0.543,16809,55.857277,172,386,0.673647469458988
"1049",123554,"SAINT MARYS COLLEGE OF CALIFORNIA",1,0,1999,629,363,266,369,142,227,0.625,0.587,0.534,17340,59.771396,175,404,0.642289348171701
"1050",123554,"SAINT MARYS COLLEGE OF CALIFORNIA",1,0,2000,620,366,254,368,149,219,0.598,0.594,0.587,18120,62.471787,178.5,388,0.625806451612903
"1051",123554,"SAINT MARYS COLLEGE OF CALIFORNIA",1,0,2001,580,352,228,350,129,221,0.628,0.603,0.566,19390,67.548924,182,344,0.593103448275862
"1052",123554,"SAINT MARYS COLLEGE OF CALIFORNIA",1,0,2002,663,408,255,381,141,240,0.588,0.575,0.553,20750,72.524608,185,389,0.586726998491704
"1053",123554,"SAINT MARYS COLLEGE OF CALIFORNIA",1,0,2003,562,317,245,285,106,179,0.565,0.507,0.433,23640,81.45585,199,327,0.581850533807829
"1054",123554,"SAINT MARYS COLLEGE OF CALIFORNIA",1,0,2004,603,388,215,319,102,217,0.559,0.529,0.474,25000,88.519819,198,299,0.495854063018242
"1055",123554,"Saint Marys College of California",1,0,2005,659,399,260,313,107,206,0.516,0.475,0.412,27130,91.396151,197,347,0.526555386949924
"1056",123554,"Saint Marys College of California",1,0,2006,600,384,216,292,105,187,0.487,0.487,0.486,28900,88.95581,200,299,0.498333333333333
"1057",123554,"Saint Marys College of California",1,0,2007,600,366,234,283,102,181,0.495,0.472,0.436,30930,93.168485,207,342,0.57
"1058",123554,"Saint Marys College of California",1,0,2008,665,436,229,349,100,249,0.571,0.525,0.437,33100,99.117713,207,326,0.490225563909774
"1059",123554,"Saint Marys College of California",1,0,2009,567,354,213,320,101,219,0.619,0.564,0.474,33760,103.393226,202,254,0.447971781305115
"1060",123554,"Saint Marys College of California",1,0,2010,694,421,273,387,139,248,0.589,0.558,0.509,35280,100.850075,189,308,0.443804034582133
"1061",123572,"SONOMA STATE UNIVERSITY",1,0,1991,680,429,251,95,18,77,0.18,0.14,0.072,936,57.300334,260,459,0.675
"1062",123572,"SONOMA STATE UNIVERSITY",1,0,1992,591,380,211,97,20,77,0.203,0.164,0.095,1474,59.863135,241,407,0.688663282571912
"1063",123572,"SONOMA STATE UNIVERSITY",1,0,1993,539,362,177,82,18,64,0.177,0.152,0.102,1674,57.564295,233,355,0.658627087198516
"1064",123572,"SONOMA STATE UNIVERSITY",1,0,1995,681,441,240,131,41,90,0.204,0.192,0.171,1891,61.241571,238,459,0.674008810572687
"1065",123572,"SONOMA STATE UNIVERSITY",1,0,1996,781,502,279,156,36,120,0.239,0.2,0.129,1935,65.546205,243,538,0.688860435339309
"1066",123572,"SONOMA STATE UNIVERSITY",1,0,1997,872,581,291,192,43,149,0.256,0.22,0.148,2110,75.034695,234,586,0.672018348623853
"1067",123572,"SONOMA STATE UNIVERSITY",1,0,1998,823,557,266,177,37,140,0.251,0.215,0.139,2082,72.938255,249,545,0.66221142162819
"1068",123572,"SONOMA STATE UNIVERSITY",1,0,1999,844,555,289,161,24,137,0.247,0.191,0.083,0,83.36342,243,551,0.652843601895735
"1069",123572,"SONOMA STATE UNIVERSITY",1,0,2000,1064,714,350,236,46,190,0.266,0.222,0.131,0,110.049097,248.5,705,0.662593984962406
"1070",123572,"SONOMA STATE UNIVERSITY",1,0,2001,1018,673,345,258,53,205,0.305,0.253,0.154,0,118.653292,254,691,0.678781925343811
"1071",123572,"SONOMA STATE UNIVERSITY",1,0,2002,1210,816,394,289,53,236,0.289,0.239,0.135,0,124.088983,254,825,0.681818181818182
"1072",123572,"SONOMA STATE UNIVERSITY",1,0,2003,1287,838,449,341,80,261,0.312,0.265,0.178,0,132.820586,267,918,0.713286713286713
"1073",123572,"SONOMA STATE UNIVERSITY",1,0,2004,1102,713,389,344,76,268,0.376,0.312,0.195,0,146.481549,240,778,0.705989110707804
"1074",123572,"Sonoma State University",1,0,2005,1043,697,346,309,69,240,0.344,0.296,0.199,0,141.976344,263,719,0.689357622243528
"1075",123572,"Sonoma State University",1,0,2006,1513,1033,480,410,104,306,0.296,0.271,0.217,0,142.28714,266,985,0.65102445472571
"1076",123572,"Sonoma State University",1,0,2007,1673,1073,600,434,97,337,0.314,0.259,0.162,0,153.148951,273,1150,0.68738792588165
"1077",123572,"Sonoma State University",1,0,2008,1631,1058,573,444,96,348,0.329,0.272,0.168,0,148.127205,274,1136,0.696505211526671
"1078",123572,"Sonoma State University",1,0,2009,1465,953,512,413,94,319,0.335,0.282,0.184,0,150.164562,272,913,0.62320819112628
"1079",123572,"Sonoma State University",1,0,2010,1547,925,622,430,106,324,0.35,0.278,0.17,0,143.959652,254,878,0.567550096961862
"1080",126562,"UNIVERSITY OF COLORADO AT DENVER",1,0,1991,262,152,110,25,7,18,0.118,0.095,0.064,1808,63.855438,347,128,0.488549618320611
"1081",126562,"UNIVERSITY OF COLORADO AT DENVER",1,0,1992,272,175,97,29,6,23,0.131,0.107,0.062,1917,66.475499,355,131,0.481617647058824
"1082",126562,"UNIVERSITY OF COLORADO AT DENVER",1,0,1993,243,141,102,38,9,29,0.206,0.156,0.088,1955,75.246309,368,131,0.539094650205761
"1083",126562,"UNIVERSITY OF COLORADO AT DENVER",1,0,1995,266,166,100,41,14,27,0.163,0.154,0.14,2098,81.810342,374,124,0.466165413533835
"1084",126562,"UNIVERSITY OF COLORADO AT DENVER",1,0,1996,373,215,158,54,20,34,0.158,0.145,0.127,2183,88.277184,382,229,0.613941018766756
"1085",126562,"UNIVERSITY OF COLORADO AT DENVER",1,0,1997,439,245,194,63,23,40,0.163,0.144,0.119,2191,94.893815,411,231,0.52619589977221
"1086",126562,"UNIVERSITY OF COLORADO AT DENVER",1,0,1998,394,223,171,58,17,41,0.184,0.147,0.099,2255,100.272768,392,202,0.512690355329949
"1087",126562,"UNIVERSITY OF COLORADO AT DENVER",1,0,1999,478,259,219,76,30,46,0.178,0.159,0.137,2068,107.993826,417,253,0.52928870292887
"1088",126562,"UNIVERSITY OF COLORADO AT DENVER",1,0,2000,515,296,219,71,23,48,0.162,0.138,0.105,2298,114.467118,423,271,0.52621359223301
"1089",126562,"UNIVERSITY OF COLORADO AT DENVER",1,0,2001,492,288,204,63,27,36,0.125,0.128,0.132,2934,128.631791,429,287,0.583333333333333
"1090",126562,"UNIVERSITY OF COLORADO AT DENVER",1,0,2002,580,326,254,86,26,60,0.184,0.148,0.102,2752,131.699303,509,356,0.613793103448276
"1091",126562,"UNIVERSITY OF COLORADO AT DENVER",1,0,2003,624,353,271,104,36,68,0.193,0.167,0.133,3028,118.976774,465,380,0.608974358974359
"1092",126562,"UNIVERSITY OF COLORADO AT DENVER",1,0,2004,686,387,299,101,34,67,0.173,0.147,0.114,3300,118.223896,450,414,0.603498542274053
"1093",126562,"University of Colorado at Denver and Health Sciences Center",1,0,2005,744,414,330,108,30,78,0.188,0.145,0.091,4224,831.954148,616,435,0.584677419354839
"1094",126562,"University of Colorado at Denver and Health Sciences Center",1,0,2006,885,510,375,155,52,103,0.202,0.175,0.139,4330,906.798442,637,514,0.580790960451977
"1095",126562,"University of Colorado Denver",1,0,2007,1010,571,439,163,66,97,0.17,0.161,0.15,5054,984.695531,639,565,0.559405940594059
"1096",126562,"University of Colorado Denver",1,0,2008,1036,603,433,156,68,88,0.146,0.151,0.157,5484,1067.328874,705,597,0.576254826254826
"1097",126562,"University of Colorado Denver",1,0,2009,1037,556,481,172,64,108,0.194,0.166,0.133,5712,1161.661412,755,524,0.505303760848602
"1098",126562,"University of Colorado Denver",1,0,2010,1020,551,469,210,76,134,0.243,0.206,0.162,6216,1198.312863,816,522,0.511764705882353
"1099",126580,"UNIVERSITY OF COLORADO-COLORADO SPRINGS",1,0,1991,319,183,136,36,12,24,0.131,0.113,0.088,2044,33.201361,156,270,0.846394984326019
"1100",126580,"UNIVERSITY OF COLORADO-COLORADO SPRINGS",1,0,1992,313,174,139,29,9,20,0.115,0.093,0.065,2167,35.05173,159,241,0.769968051118211
"1101",126580,"UNIVERSITY OF COLORADO AT COLORADO SPRINGS",1,0,1993,306,164,142,46,18,28,0.171,0.15,0.127,2225,36.420682,161,252,0.823529411764706
"1102",126580,"UNIVERSITY OF COLORADO AT COLORADO SPRINGS",1,0,1995,363,197,166,88,36,52,0.264,0.242,0.217,2375,38.215483,181,283,0.779614325068871
"1103",126580,"UNIVERSITY OF COLORADO AT COLORADO SPRINGS",1,0,1996,375,227,148,63,18,45,0.198,0.168,0.122,2439,39.549367,180,295,0.786666666666667
"1104",126580,"UNIVERSITY OF COLORADO AT COLORADO SPRINGS",1,0,1997,519,298,221,83,27,56,0.188,0.16,0.122,2681,45.028436,208,400,0.770712909441233
"1105",126580,"UNIVERSITY OF COLORADO AT COLORADO SPRINGS",1,0,1998,635,372,263,154,53,101,0.272,0.243,0.202,2681,52.523497,219,500,0.78740157480315
"1106",126580,"UNIVERSITY OF COLORADO AT COLORADO SPRINGS",1,0,1999,682,395,287,104,35,69,0.175,0.152,0.122,2234,123.679767,206,524,0.768328445747801
"1107",126580,"UNIVERSITY OF COLORADO AT COLORADO SPRINGS",1,0,2000,718,457,261,162,38,124,0.271,0.226,0.146,2690,58.980889,214,551,0.767409470752089
"1108",126580,"UNIVERSITY OF COLORADO AT COLORADO SPRINGS",1,0,2001,785,453,332,171,54,117,0.258,0.218,0.163,2864,64.216824,222,596,0.759235668789809
"1109",126580,"UNIVERSITY OF COLORADO AT COLORADO SPRINGS",1,0,2002,834,501,333,211,66,145,0.289,0.253,0.198,3154,75.838655,259,658,0.788968824940048
"1110",126580,"UNIVERSITY OF COLORADO AT COLORADO SPRINGS",1,0,2003,892,552,340,193,43,150,0.272,0.216,0.126,3026,71.709142,251,694,0.778026905829596
"1111",126580,"UNIVERSITY OF COLORADO AT COLORADO SPRINGS",1,0,2004,939,562,377,198,54,144,0.256,0.211,0.143,3296,76.250785,266,726,0.773162939297125
"1112",126580,"University of Colorado at Colorado Springs",1,0,2005,947,595,352,210,50,160,0.269,0.222,0.142,3966,82.159797,296,737,0.778247096092925
"1113",126580,"University of Colorado at Colorado Springs",1,0,2006,914,531,383,216,75,141,0.266,0.236,0.196,4054,83.685026,247,693,0.758205689277899
"1114",126580,"University of Colorado at Colorado Springs",1,0,2007,933,511,422,247,89,158,0.309,0.265,0.211,4338,91.925186,263,676,0.72454448017149
"1115",126580,"University of Colorado at Colorado Springs",1,0,2008,1075,577,498,288,110,178,0.308,0.268,0.221,4464,103.073555,305,815,0.758139534883721
"1116",126580,"University of Colorado at Colorado Springs",1,0,2009,1035,543,492,247,98,149,0.274,0.239,0.199,4680,109.777738,317,742,0.716908212560387
"1117",126580,"University of Colorado at Colorado Springs",1,0,2010,1123,568,555,284,112,172,0.303,0.253,0.202,5016,118.938522,317,798,0.71059661620659
"1118",126614,"UNIVERSITY OF COLORADO AT BOULDER",1,0,1991,3421,1631,1790,1268,550,718,0.44,0.371,0.307,3066,376.268767,909,2666,0.779304296989184
"1119",126614,"UNIVERSITY OF COLORADO AT BOULDER",1,0,1992,3559,1700,1859,1198,514,684,0.402,0.337,0.276,2560,416.592808,1024,2818,0.791795448159595
"1120",126614,"UNIVERSITY OF COLORADO AT BOULDER",1,0,1993,3440,1693,1747,1215,509,706,0.417,0.353,0.291,2574,440.037533,1081,2656,0.772093023255814
"1121",126614,"UNIVERSITY OF COLORADO AT BOULDER",1,0,1995,4170,2020,2150,1454,602,852,0.422,0.349,0.28,2770,473.232821,1093,3359,0.805515587529976
"1122",126614,"UNIVERSITY OF COLORADO AT BOULDER",1,0,1996,3953,1983,1970,1529,623,906,0.457,0.387,0.316,2840,501.016024,1084,3224,0.815583101441943
"1123",126614,"UNIVERSITY OF COLORADO AT BOULDER",1,0,1997,4259,2157,2102,1565,633,932,0.432,0.367,0.301,2939,526.278582,1063,3456,0.811458088753228
"1124",126614,"UNIVERSITY OF COLORADO AT BOULDER",1,0,1998,4263,2037,2226,1545,647,898,0.441,0.362,0.291,3038,575.821964,1094,3483,0.817030260380014
"1125",126614,"UNIVERSITY OF COLORADO AT BOULDER",1,0,1999,4545,2303,2242,1728,700,1028,0.446,0.38,0.312,2444,576.711199,1076,3768,0.829042904290429
"1126",126614,"UNIVERSITY OF COLORADO AT BOULDER",1,0,2000,5047,2445,2602,1937,829,1108,0.453,0.384,0.319,2514,639.080989,1076,4131,0.818506043193977
"1127",126614,"UNIVERSITY OF COLORADO AT BOULDER",1,0,2001,4962,2396,2566,2013,887,1126,0.47,0.406,0.346,2614,662.543832,1076,3899,0.785771866182991
"1128",126614,"UNIVERSITY OF COLORADO AT BOULDER",1,0,2002,5377,2607,2770,2218,1001,1217,0.467,0.412,0.361,2776,671.695376,1127,4294,0.798586572438163
"1129",126614,"UNIVERSITY OF COLORADO AT BOULDER",1,0,2003,5515,2761,2754,2267,966,1301,0.471,0.411,0.351,3192,692.178298,1105,4461,0.808884859474161
"1130",126614,"UNIVERSITY OF COLORADO AT BOULDER",1,0,2004,5124,2484,2640,2093,909,1184,0.477,0.408,0.344,3480,711.9636,1108,4025,0.78551912568306
"1131",126614,"University of Colorado at Boulder",1,0,2005,5007,2364,2643,2007,900,1107,0.468,0.401,0.341,4446,768.570245,1115,3977,0.794287996804474
"1132",126614,"University of Colorado at Boulder",1,0,2006,5606,2688,2918,2336,1016,1320,0.491,0.417,0.348,4554,790.615607,1166,4416,0.787727434891188
"1133",126614,"University of Colorado at Boulder",1,0,2007,5540,2734,2806,2456,1059,1397,0.511,0.443,0.377,5418,836.65186,1223,4405,0.795126353790614
"1134",126614,"University of Colorado at Boulder",1,0,2008,5811,2890,2921,2678,1158,1520,0.526,0.461,0.396,5922,875.935263,1368,4568,0.786095336430907
"1135",126614,"University of Colorado at Boulder",1,0,2009,5515,2719,2796,2598,1102,1496,0.55,0.471,0.394,6446,941.566282,1395,4285,0.776971894832276
"1136",126614,"University of Colorado Boulder",1,0,2010,5138,2403,2735,2438,1094,1344,0.559,0.475,0.4,7018,994.55599,1385,4000,0.778513040093422
"1137",126818,"COLORADO STATE UNIVERSITY",1,0,1991,2155,1144,1011,516,173,343,0.3,0.239,0.171,2362,311.329,935,1773,0.822737819025522
"1138",126818,"COLORADO STATE UNIVERSITY",1,0,1992,2202,1150,1052,575,205,370,0.322,0.261,0.195,2511,334.083,937,1872,0.850136239782016
"1139",126818,"COLORADO STATE UNIVERSITY",1,0,1993,2168,1160,1008,611,210,401,0.346,0.282,0.208,2558,338.402,926,1803,0.831642066420664
"1140",126818,"COLORADO STATE UNIVERSITY",1,0,1995,2546,1354,1192,805,287,518,0.383,0.316,0.241,2771,393.350031,935,2155,0.846425765907306
"1141",126818,"COLORADO STATE UNIVERSITY",1,0,1996,2695,1511,1184,847,307,540,0.357,0.314,0.259,2847,411.101,948,2299,0.853061224489796
"1142",126818,"COLORADO STATE UNIVERSITY",1,0,1997,2615,1435,1180,861,304,557,0.388,0.329,0.258,2925,418.434,939,2230,0.852772466539197
"1143",126818,"COLORADO STATE UNIVERSITY",1,0,1998,3028,1772,1256,1028,301,727,0.41,0.339,0.24,2986,475.616,919,2590,0.855350066050198
"1144",126818,"COLORADO STATE UNIVERSITY",1,0,1999,3076,1702,1374,1054,371,683,0.401,0.343,0.27,2340,467.996,921,2642,0.858907672301691
"1145",126818,"COLORADO STATE UNIVERSITY",1,0,2000,3240,1862,1378,1119,370,749,0.402,0.345,0.269,2408,503.418639,927.5,2710,0.83641975308642
"1146",126818,"COLORADO STATE UNIVERSITY",1,0,2001,3683,2061,1622,1285,420,865,0.42,0.349,0.259,2502,516.181845,934,3112,0.844963345099104
"1147",126818,"COLORADO STATE UNIVERSITY",1,0,2002,3783,2121,1662,1340,442,898,0.423,0.354,0.266,2655,583.403,898,3159,0.835051546391753
"1148",126818,"COLORADO STATE UNIVERSITY",1,0,2003,3730,2012,1718,1319,483,836,0.416,0.354,0.281,2908,602.093883,1088,3142,0.842359249329759
"1149",126818,"COLORADO STATE UNIVERSITY",1,0,2004,4047,2216,1831,1484,522,962,0.434,0.367,0.285,2940,603.520584,1099,3412,0.843093649617
"1150",126818,"Colorado State University",1,0,2005,3622,2036,1586,1278,406,872,0.428,0.353,0.256,3381,586.291923,1099,2994,0.826615129762562
"1151",126818,"Colorado State University",1,0,2006,3825,2166,1659,1448,441,1007,0.465,0.379,0.266,3466,622.828032,1122,3136,0.819869281045752
"1152",126818,"Colorado State University",1,0,2007,4352,2387,1965,1609,564,1045,0.438,0.37,0.287,4040,662.786257,1136,3659,0.840762867647059
"1153",126818,"Colorado State University",1,0,2008,4386,2435,1951,1693,567,1126,0.462,0.386,0.291,4424,738.295377,1184,3479,0.793205654354765
"1154",126818,"Colorado State University",1,0,2009,4274,2360,1914,1732,593,1139,0.483,0.405,0.31,4822,782.39672,1175,3303,0.772812353766963
"1155",126818,"Colorado State University-Fort Collins",1,0,2010,4321,2414,1907,1820,656,1164,0.482,0.421,0.344,5256,777.275616,1175,3339,0.772737792177737
"1156",127060,"UNIVERSITY OF DENVER",0,1,1991,504,265,239,280,123,157,0.593,0.556,0.515,12990,107.560545,375,396,0.785714285714286
"1157",127060,"UNIVERSITY OF DENVER",0,1,1992,555,284,271,303,130,173,0.609,0.546,0.48,13572,114.917148,374,425,0.765765765765766
"1158",127060,"UNIVERSITY OF DENVER",0,1,1993,576,306,270,332,144,188,0.614,0.576,0.533,14472,122.270185,378,438,0.760416666666667
"1159",127060,"UNIVERSITY OF DENVER",0,1,1995,654,330,324,376,175,201,0.609,0.575,0.54,16056,143.853468,389,506,0.773700305810398
"1160",127060,"UNIVERSITY OF DENVER",0,1,1996,717,372,345,389,168,221,0.594,0.543,0.487,16848,155.05437,402,515,0.718270571827057
"1161",127060,"UNIVERSITY OF DENVER",0,1,1997,689,354,335,387,173,214,0.605,0.562,0.516,17640,149.838334,403,495,0.718432510885341
"1162",127060,"UNIVERSITY OF DENVER",0,1,1998,768,393,375,414,185,229,0.583,0.539,0.493,18468,149.591347,405,598,0.778645833333333
"1163",127060,"UNIVERSITY OF DENVER",0,1,1999,812,410,402,420,181,239,0.583,0.517,0.45,18936,157.042626,402,671,0.826354679802956
"1164",127060,"UNIVERSITY OF DENVER",0,1,2000,926,505,421,526,214,312,0.618,0.568,0.508,20052,181.51124,413.5,764,0.825053995680346
"1165",127060,"UNIVERSITY OF DENVER",0,1,2001,933,486,447,561,249,312,0.642,0.601,0.557,21456,201.442211,425,749,0.802786709539121
"1166",127060,"UNIVERSITY OF DENVER",0,1,2002,988,527,461,571,235,336,0.638,0.578,0.51,22680,209.655586,439,803,0.812753036437247
"1167",127060,"UNIVERSITY OF DENVER",0,1,2003,1010,549,461,540,216,324,0.59,0.535,0.469,24264,227.729095,440,850,0.841584158415842
"1168",127060,"UNIVERSITY OF DENVER",0,1,2004,1124,588,536,633,286,347,0.59,0.563,0.534,25956,245.2528,463,924,0.822064056939502
"1169",127060,"University of Denver",0,1,2005,1089,608,481,655,251,404,0.665,0.601,0.522,27756,261.203975,488,895,0.821854912764004
"1170",127060,"University of Denver",0,1,2006,1135,615,520,692,290,402,0.654,0.61,0.558,29628,279.972205,534,900,0.79295154185022
"1171",127060,"University of Denver",0,1,2007,1130,619,511,752,321,431,0.696,0.665,0.628,31428,292.974326,574,727,0.643362831858407
"1172",127060,"University of Denver",0,1,2008,1131,633,498,743,317,426,0.673,0.657,0.637,32976,312.236408,586,796,0.703801945181255
"1173",127060,"University of Denver",0,1,2009,1196,684,512,797,314,483,0.706,0.666,0.613,34596,325.561654,612,829,0.69314381270903
"1174",127060,"University of Denver",0,1,2010,1215,663,552,806,320,486,0.733,0.663,0.58,35604,327.27269,635,866,0.712757201646091
"1175",127185,"FORT LEWIS COLLEGE",0,1,1991,935,424,511,67,30,37,0.087,0.072,0.059,1550,26.082223,167,731,0.781818181818182
"1176",127185,"FORT LEWIS COLLEGE",0,1,1992,1004,439,565,118,49,69,0.157,0.118,0.087,1701,28.016824,170,785,0.781872509960159
"1177",127185,"FORT LEWIS COLLEGE",0,1,1993,1078,438,640,95,39,56,0.128,0.088,0.061,1777,32.295443,165,851,0.789424860853432
"1178",127185,"FORT LEWIS COLLEGE",0,1,1995,1010,434,576,96,26,70,0.161,0.095,0.045,1904,35.840477,174,777,0.769306930693069
"1179",127185,"FORT LEWIS COLLEGE",0,1,1996,1124,493,631,122,43,79,0.16,0.109,0.068,2050,37.479293,165,890,0.791814946619217
"1180",127185,"FORT LEWIS COLLEGE",0,1,1997,1056,450,606,97,39,58,0.129,0.092,0.064,2084,38.188565,175,797,0.754734848484849
"1181",127185,"FORT LEWIS COLLEGE",0,1,1998,970,405,565,108,46,62,0.153,0.111,0.081,2110,41.777175,174,722,0.744329896907217
"1182",127185,"FORT LEWIS COLLEGE",0,1,1999,1019,429,590,102,37,65,0.152,0.1,0.063,1676,46.310188,175,728,0.714425907752699
"1183",127185,"FORT LEWIS COLLEGE",1,0,2000,938,428,510,120,45,75,0.175,0.128,0.088,1724,45.243125,178,674,0.718550106609808
"1184",127185,"FORT LEWIS COLLEGE",1,0,2001,1047,469,578,139,50,89,0.19,0.133,0.087,1792,49.481107,181,702,0.670487106017192
"1185",127185,"FORT LEWIS COLLEGE",1,0,2002,1035,467,568,147,59,88,0.188,0.142,0.104,1902,48.033889,177,730,0.705314009661836
"1186",127185,"FORT LEWIS COLLEGE",1,0,2003,899,422,477,138,51,87,0.206,0.154,0.107,2020,51.202287,176,622,0.691879866518354
"1187",127185,"FORT LEWIS COLLEGE",1,0,2004,930,448,482,181,67,114,0.254,0.195,0.139,2270,47.97254,185,645,0.693548387096774
"1188",127185,"Fort Lewis College",1,0,2005,860,386,474,161,70,91,0.236,0.187,0.148,4862,51.335475,190,580,0.674418604651163
"1189",127185,"Fort Lewis College",1,0,2006,821,367,454,161,59,102,0.278,0.196,0.13,5102,51.048468,174,518,0.630937880633374
"1190",127185,"Fort Lewis College",1,0,2007,863,404,459,149,50,99,0.245,0.173,0.109,5138,54.294316,171,565,0.654692931633835
"1191",127185,"Fort Lewis College",1,0,2008,758,355,403,136,62,74,0.209,0.179,0.154,2846,57.932171,175,475,0.62664907651715
"1192",127185,"Fort Lewis College",1,0,2009,766,344,422,138,64,74,0.215,0.18,0.152,3102,60.798808,183,515,0.672323759791123
"1193",127185,"Fort Lewis College",1,0,2010,830,393,437,203,74,129,0.328,0.245,0.169,3380,60.285036,167,552,0.665060240963855
"1194",127565,"METROPOLITAN STATE COLLEGE OF DENVER",1,0,1991,1357,669,688,35,12,23,0.034,0.026,0.017,1483,62.91045,362,1004,0.739867354458364
"1195",127565,"METROPOLITAN STATE COLLEGE OF DENVER",1,0,1992,1227,614,613,49,17,32,0.052,0.04,0.028,1709,69.635175,372,905,0.737571312143439
"1196",127565,"METROPOLITAN STATE COLLEGE OF DENVER",1,0,1993,1380,682,698,43,22,21,0.031,0.031,0.032,1749,70.779798,370,968,0.701449275362319
"1197",127565,"METROPOLITAN STATE COLLEGE OF DENVER",1,0,1995,1239,691,548,48,19,29,0.042,0.039,0.035,1850,75.320438,385,801,0.646489104116223
"1198",127565,"METROPOLITAN STATE COLLEGE OF DENVER",1,0,1996,1324,677,647,51,15,36,0.053,0.039,0.023,1942,80.986213,364,891,0.672960725075529
"1199",127565,"METROPOLITAN STATE COLLEGE OF DENVER",1,0,1997,1478,787,691,69,19,50,0.064,0.047,0.027,1976,87.557281,376,1016,0.687415426251691
"1200",127565,"METROPOLITAN STATE COLLEGE OF DENVER",1,0,1998,1382,759,623,81,29,52,0.068,0.059,0.047,2033,92.386016,381,935,0.676555716353111
"1201",127565,"METROPOLITAN STATE COLLEGE OF DENVER",1,0,1999,1440,764,676,86,40,46,0.06,0.06,0.059,1718,98.380516,386,989,0.686805555555556
"1202",127565,"METROPOLITAN STATE COLLEGE OF DENVER",1,0,2000,1435,778,657,79,27,52,0.067,0.055,0.041,1768,98.110756,416,950,0.662020905923345
"1203",127565,"METROPOLITAN STATE COLLEGE OF DENVER",1,0,2001,1596,816,780,97,42,55,0.067,0.061,0.054,1893,106.064514,446,1087,0.681077694235589
"1204",127565,"METROPOLITAN STATE COLLEGE OF DENVER",1,0,2002,1655,852,803,73,25,48,0.056,0.044,0.031,1925,102.255155,489,1143,0.690634441087613
"1205",127565,"METROPOLITAN STATE COLLEGE OF DENVER",1,0,2003,1809,931,878,82,26,56,0.06,0.045,0.03,2021,107.176515,392,1209,0.66832504145937
"1206",127565,"METROPOLITAN STATE COLLEGE OF DENVER",1,0,2004,1815,937,878,86,34,52,0.056,0.047,0.039,2044,103.893242,395,1242,0.684297520661157
"1207",127565,"Metropolitan State College of Denver",1,0,2005,1840,939,901,79,32,47,0.05,0.043,0.036,2191,107.255792,431,1201,0.652717391304348
"1208",127565,"Metropolitan State College of Denver",1,0,2006,1711,925,786,102,33,69,0.075,0.06,0.042,2246,107.91832,458,1014,0.592635885447107
"1209",127565,"Metropolitan State College of Denver",1,0,2007,1910,1036,874,108,38,70,0.068,0.057,0.043,2432,116.538553,500,1287,0.673821989528796
"1210",127565,"Metropolitan State College of Denver",1,0,2008,1918,969,949,88,33,55,0.057,0.046,0.035,2615,124.675459,516,1218,0.635036496350365
"1211",127565,"Metropolitan State College of Denver",1,0,2009,1959,985,974,115,46,69,0.07,0.059,0.047,2850,134.640006,509,1168,0.596222562531904
"1212",127565,"Metropolitan State College of Denver",1,0,2010,1876,916,960,112,43,69,0.075,0.06,0.045,3107,140.542231,517,1086,0.578891257995736
"1213",127741,"UNIVERSITY OF NORTHERN COLORADO",1,0,1991,1639,937,702,258,78,180,0.192,0.157,0.111,1926,89.940724,458,1365,0.832824893227578
"1214",127741,"UNIVERSITY OF NORTHERN COLORADO",1,0,1992,1464,921,543,232,63,169,0.184,0.158,0.116,2027,94.236719,447,1168,0.797814207650273
"1215",127741,"UNIVERSITY OF NORTHERN COLORADO",1,0,1993,1704,1019,685,309,81,228,0.224,0.181,0.118,2114,94.968098,467,1372,0.805164319248826
"1216",127741,"UNIVERSITY OF NORTHERN COLORADO",1,0,1995,1763,1091,672,404,90,314,0.288,0.229,0.134,2408,104.066212,463,1456,0.825865002836075
"1217",127741,"UNIVERSITY OF NORTHERN COLORADO",1,0,1996,1642,1000,642,413,120,293,0.293,0.252,0.187,2542,114.001645,445,1365,0.831303288672351
"1218",127741,"UNIVERSITY OF NORTHERN COLORADO",1,0,1997,1905,1147,758,490,107,383,0.334,0.257,0.141,2578,112.227271,445,1543,0.80997375328084
"1219",127741,"UNIVERSITY OF NORTHERN COLORADO",1,0,1998,2165,1314,851,515,123,392,0.298,0.238,0.145,2652,116.271996,452,1825,0.842956120092379
"1220",127741,"UNIVERSITY OF NORTHERN COLORADO",1,0,1999,2291,1401,890,589,129,460,0.328,0.257,0.145,2014,123.679767,461,1892,0.825840244434745
"1221",127741,"UNIVERSITY OF NORTHERN COLORADO",1,0,2000,2113,1240,873,605,162,443,0.357,0.286,0.186,2072,128.89674,444,1748,0.827259820160909
"1222",127741,"UNIVERSITY OF NORTHERN COLORADO",1,0,2001,2108,1309,799,623,140,483,0.369,0.296,0.175,2155,132.826733,427,1740,0.825426944971537
"1223",127741,"UNIVERSITY OF NORTHERN COLORADO",1,0,2002,1938,1253,685,548,116,432,0.345,0.283,0.169,2290,126.487537,452,1622,0.836945304437565
"1224",127741,"UNIVERSITY OF NORTHERN COLORADO",1,0,2003,2118,1337,781,598,169,429,0.321,0.282,0.216,2520,128.970239,410,1747,0.824834749763928
"1225",127741,"UNIVERSITY OF NORTHERN COLORADO",1,0,2004,2412,1459,953,648,190,458,0.314,0.269,0.199,2850,127.915555,412,1906,0.790215588723051
"1226",127741,"University of Northern Colorado",1,0,2005,2483,1479,1004,620,173,447,0.302,0.25,0.172,3192,130.728738,400,1987,0.80024164317358
"1227",127741,"University of Northern Colorado",1,0,2006,2491,1442,1049,659,204,455,0.316,0.265,0.194,3276,146.158663,446,1950,0.782818145323163
"1228",127741,"University of Northern Colorado",1,0,2007,2199,1328,871,583,149,434,0.327,0.265,0.171,3600,146.97813,438,1722,0.783083219645293
"1229",127741,"University of Northern Colorado",1,0,2008,2071,1227,844,558,156,402,0.328,0.269,0.185,3942,157.570463,458,1613,0.778850796716562
"1230",127741,"University of Northern Colorado",1,0,2009,2275,1360,915,605,165,440,0.324,0.266,0.18,4296,168.611766,488,1696,0.745494505494505
"1231",127741,"University of Northern Colorado",1,0,2010,2221,1420,801,653,183,470,0.331,0.294,0.228,4680,183.537278,498,1537,0.692030616839262
"1232",128106,"UNIVERSITY OF SOUTHERN COLORADO",1,0,1991,579,287,292,59,23,36,0.125,0.102,0.079,1725,33.59886,171,386,0.666666666666667
"1233",128106,"UNIVERSITY OF SOUTHERN COLORADO",1,0,1992,656,342,314,58,21,37,0.108,0.088,0.067,1833,34.773687,164,433,0.660060975609756
"1234",128106,"UNIVERSITY OF SOUTHERN COLORADO",1,0,1993,678,321,357,78,34,44,0.137,0.115,0.095,1878,38.655854,170,466,0.687315634218289
"1235",128106,"UNIVERSITY OF SOUTHERN COLORADO",1,0,1995,590,299,291,69,31,38,0.127,0.117,0.107,2080,44.043485,175,377,0.638983050847458
"1236",128106,"UNIVERSITY OF SOUTHERN COLORADO",1,0,1996,574,305,269,68,19,49,0.161,0.118,0.071,2149,46.021248,168,381,0.663763066202091
"1237",128106,"UNIVERSITY OF SOUTHERN COLORADO",1,0,1997,580,299,281,49,20,29,0.097,0.084,0.071,2186,46.091093,171,369,0.636206896551724
"1238",128106,"UNIVERSITY OF SOUTHERN COLORADO",1,0,1998,611,345,266,80,30,50,0.145,0.131,0.113,2219,48.251459,164,350,0.572831423895254
"1239",128106,"UNIVERSITY OF SOUTHERN COLORADO",1,0,1999,611,326,285,76,27,49,0.15,0.124,0.095,1808,71.658569,165,391,0.639934533551555
"1240",128106,"UNIVERSITY OF SOUTHERN COLORADO",1,0,2000,641,331,310,101,41,60,0.181,0.158,0.132,1860,50.109783,161.5,392,0.611544461778471
"1241",128106,"UNIVERSITY OF SOUTHERN COLORADO",1,0,2001,634,343,291,115,47,68,0.198,0.181,0.162,1940,51.574996,158,353,0.556782334384858
"1242",128106,"UNIVERSITY OF SOUTHERN COLORADO",1,0,2002,642,329,313,105,39,66,0.201,0.164,0.125,2060,50.763605,160,383,0.596573208722741
"1243",128106,"COLORADO STATE UNIVERSITY-PUEBLO",1,0,2003,686,372,314,93,35,58,0.156,0.136,0.111,1873,48.668116,161,422,0.615160349854227
"1244",128106,"COLORADO STATE UNIVERSITY-PUEBLO",1,0,2004,753,423,330,118,34,84,0.199,0.157,0.103,2524,48.243761,158,454,0.602921646746348
"1245",128106,"Colorado State University-Pueblo",1,0,2005,665,361,304,125,54,71,0.197,0.188,0.178,2903,49.106477,160,382,0.574436090225564
"1246",128106,"Colorado State University-Pueblo",1,0,2006,628,350,278,112,42,70,0.2,0.178,0.151,2975,51.260561,168,349,0.555732484076433
"1247",128106,"Colorado State University-Pueblo",1,0,2007,602,308,294,109,41,68,0.221,0.181,0.139,3184,51.233298,155,314,0.521594684385382
"1248",128106,"Colorado State University-Pueblo",1,0,2008,1002,465,537,160,65,95,0.204,0.16,0.121,3422,55.620998,177,517,0.515968063872255
"1249",128106,"Colorado State University-Pueblo",1,0,2009,1013,513,500,178,67,111,0.216,0.176,0.134,3732,66.771502,180,521,0.51431391905232
"1250",128106,"Colorado State University-Pueblo",1,0,2010,977,467,510,182,80,102,0.218,0.186,0.157,4068,66.414622,180,486,0.497441146366428
"1251",128744,"UNIVERSITY OF BRIDGEPORT",1,0,1991,208,110,98,12,5,7,0.064,0.058,0.051,12774,62.2698,152,81,0.389423076923077
"1252",128744,"UNIVERSITY OF BRIDGEPORT",1,0,1992,18,12,6,1,0,1,0.083,0.056,0,12880,42.828,91,3,0.166666666666667
"1253",128744,"UNIVERSITY OF BRIDGEPORT",1,0,1993,137,66,71,58,20,38,0.576,0.423,0.282,12905,33.997,90,37,0.27007299270073
"1254",128744,"UNIVERSITY OF BRIDGEPORT",1,0,1995,123,73,50,38,14,24,0.329,0.309,0.28,13124,41.791,83,37,0.300813008130081
"1255",128744,"UNIVERSITY OF BRIDGEPORT",1,0,1996,116,58,58,35,17,18,0.31,0.302,0.293,13144,37.647488,83,25,0.21551724137931
"1256",128744,"UNIVERSITY OF BRIDGEPORT",1,0,1997,187,93,94,58,24,34,0.366,0.31,0.255,13644,31.709,88,49,0.262032085561497
"1257",128744,"UNIVERSITY OF BRIDGEPORT",1,0,1998,233,94,139,80,48,32,0.34,0.343,0.345,14041,32.247,99,30,0.128755364806867
"1258",128744,"UNIVERSITY OF BRIDGEPORT",1,0,1999,190,96,94,39,15,24,0.25,0.205,0.16,13800,35.537,94,42,0.221052631578947
"1259",128744,"UNIVERSITY OF BRIDGEPORT",1,0,2000,161,80,81,53,21,32,0.4,0.329,0.259,14150,35.805,89,45,0.279503105590062
"1260",128744,"UNIVERSITY OF BRIDGEPORT",1,0,2001,175,97,78,49,17,32,0.33,0.28,0.218,14720,36.862,84,20,0.114285714285714
"1261",128744,"UNIVERSITY OF BRIDGEPORT",1,0,2002,234,144,90,66,23,43,0.299,0.282,0.256,15604,37.399,86,48,0.205128205128205
"1262",128744,"UNIVERSITY OF BRIDGEPORT",1,0,2003,286,158,128,61,14,47,0.298,0.213,0.109,17008,44.823,87,67,0.234265734265734
"1263",128744,"UNIVERSITY OF BRIDGEPORT",1,0,2004,241,134,107,47,19,28,0.209,0.195,0.178,18300,38.55,88,62,0.257261410788382
"1264",128744,"University of Bridgeport",1,0,2005,352,212,140,64,20,44,0.208,0.182,0.143,19200,41.752,89,78,0.221590909090909
"1265",128744,"University of Bridgeport",1,0,2006,303,176,127,70,20,50,0.284,0.231,0.157,20250,47.985,102,72,0.237623762376238
"1266",128744,"University of Bridgeport",1,0,2007,331,209,122,62,17,45,0.215,0.187,0.139,21150,54.289,114,70,0.211480362537764
"1267",128744,"University of Bridgeport",1,0,2008,444,266,178,90,30,60,0.226,0.203,0.169,22500,66.795,117,72,0.162162162162162
"1268",128744,"University of Bridgeport",1,0,2009,429,260,169,108,37,71,0.273,0.252,0.219,23400,73.673,125,75,0.174825174825175
"1269",128744,"University of Bridgeport",1,0,2010,594,397,197,122,41,81,0.204,0.205,0.208,24300,73.803,120,93,0.156565656565657
"1270",128771,"CENTRAL CONNECTICUT STATE UNIVERSITY",1,0,1991,1088,627,461,115,34,81,0.129,0.106,0.074,2414,62.489637,396,914,0.840073529411765
"1271",128771,"CENTRAL CONNECTICUT STATE UNIVERSITY",1,0,1992,964,552,412,98,31,67,0.121,0.102,0.075,2804,65.585739,383,801,0.830912863070539
"1272",128771,"CENTRAL CONNECTICUT STATE UNIVERSITY",1,0,1993,902,483,419,80,18,62,0.128,0.089,0.043,2976,67.25079,390,714,0.791574279379157
"1273",128771,"CENTRAL CONNECTICUT STATE UNIVERSITY",1,0,1995,1076,566,510,68,28,40,0.071,0.063,0.055,3266,75.605881,387,843,0.783457249070632
"1274",128771,"CENTRAL CONNECTICUT STATE UNIVERSITY",1,0,1996,1092,534,558,165,65,100,0.187,0.151,0.116,3542,74.80828,367,886,0.811355311355311
"1275",128771,"CENTRAL CONNECTICUT STATE UNIVERSITY",1,0,1997,1213,626,587,82,36,46,0.074,0.068,0.061,3614,82.981808,354,948,0.781533388293487
"1276",128771,"CENTRAL CONNECTICUT STATE UNIVERSITY",1,0,1998,1317,675,642,163,46,117,0.173,0.124,0.072,3670,98.982177,377,1063,0.807137433561124
"1277",128771,"CENTRAL CONNECTICUT STATE UNIVERSITY",1,0,1999,1280,559,721,143,47,96,0.172,0.112,0.065,2062,106.164734,379,932,0.728125
"1278",128771,"CENTRAL CONNECTICUT STATE UNIVERSITY",1,0,2000,1304,635,669,141,42,99,0.156,0.108,0.063,2142,120.849151,385,1001,0.767638036809816
"1279",128771,"CENTRAL CONNECTICUT STATE UNIVERSITY",1,0,2001,1261,623,638,169,74,95,0.152,0.134,0.116,2226,118.533213,391,975,0.77319587628866
"1280",128771,"CENTRAL CONNECTICUT STATE UNIVERSITY",1,0,2002,1473,735,738,192,61,131,0.178,0.13,0.083,2314,135.366475,400,1188,0.806517311608961
"1281",128771,"CENTRAL CONNECTICUT STATE UNIVERSITY",1,0,2003,1176,571,605,166,59,107,0.187,0.141,0.098,2648,150.414226,395,906,0.770408163265306
"1282",128771,"CENTRAL CONNECTICUT STATE UNIVERSITY",1,0,2004,1278,596,682,213,80,133,0.223,0.167,0.117,2862,164.912631,409,977,0.764475743348983
"1283",128771,"Central Connecticut State University",1,0,2005,1333,663,670,188,82,106,0.16,0.141,0.122,3034,209.640469,416,1050,0.787696924231058
"1284",128771,"Central Connecticut State University",1,0,2006,1282,603,679,272,117,155,0.257,0.212,0.172,3187,176.126949,417,1008,0.786271450858034
"1285",128771,"Central Connecticut State University",1,0,2007,1466,676,790,294,133,161,0.238,0.201,0.168,3346,186.188386,432,1154,0.787175989085948
"1286",128771,"Central Connecticut State University",1,0,2008,1297,578,719,279,133,146,0.253,0.215,0.185,3514,198.875571,434,992,0.764841942945258
"1287",128771,"Central Connecticut State University",1,0,2009,1277,621,656,321,128,193,0.311,0.251,0.195,3742,210.116234,433,940,0.736100234925607
"1288",128771,"Central Connecticut State University",1,0,2010,1340,592,748,279,125,154,0.26,0.208,0.167,4023,198.411623,440,1031,0.769402985074627
"1289",129020,"UNIVERSITY OF CONNECTICUT",1,0,1991,2904,1464,1440,977,359,618,0.422,0.336,0.249,3402,324.761273,1093,2381,0.819903581267218
"1290",129020,"UNIVERSITY OF CONNECTICUT",1,0,1992,2831,1454,1377,968,354,614,0.422,0.342,0.257,3902,362.364299,1045,2197,0.77605086541858
"1291",129020,"UNIVERSITY OF CONNECTICUT",1,0,1993,2052,1068,984,775,297,478,0.448,0.378,0.302,4290,360.891026,1044,1670,0.813840155945419
"1292",129020,"UNIVERSITY OF CONNECTICUT",1,0,1995,2010,1051,959,855,341,514,0.489,0.425,0.356,4810,454.445549,1068,1558,0.775124378109453
"1293",129020,"UNIVERSITY OF CONNECTICUT",1,0,1996,2142,1156,986,908,311,597,0.516,0.424,0.315,4974,447.579354,1025,1643,0.767040149393091
"1294",129020,"UNIVERSITY OF CONNECTICUT",1,0,1997,2172,1181,991,977,340,637,0.539,0.45,0.343,5242,431.466304,962,1663,0.765653775322284
"1295",129020,"UNIVERSITY OF CONNECTICUT",1,0,1998,2536,1358,1178,1135,431,704,0.518,0.448,0.366,5330,444.855561,1014,1907,0.751971608832808
"1296",129020,"UNIVERSITY OF CONNECTICUT",1,0,1999,2940,1596,1344,1454,523,931,0.583,0.495,0.389,4158,488.314951,1043,2256,0.76734693877551
"1297",129020,"UNIVERSITY OF CONNECTICUT",1,0,2000,2802,1549,1253,1484,554,930,0.6,0.53,0.442,4282,537.163218,1039.5,2112,0.753747323340471
"1298",129020,"UNIVERSITY OF CONNECTICUT",1,0,2001,3122,1648,1474,1671,682,989,0.6,0.535,0.463,4448,577.627672,1036,1979,0.633888532991672
"1299",129020,"UNIVERSITY OF CONNECTICUT",1,0,2002,3157,1722,1435,1766,674,1092,0.634,0.559,0.47,4730,620.483377,1068,2382,0.754513778904023
"1300",129020,"UNIVERSITY OF CONNECTICUT",1,0,2003,3182,1733,1449,1912,757,1155,0.667,0.601,0.522,5260,676.241921,1017,2402,0.754871150219987
"1301",129020,"UNIVERSITY OF CONNECTICUT",1,0,2004,3229,1789,1440,2104,830,1274,0.712,0.652,0.576,5772,716.706319,1109,2402,0.743883555280273
"1302",129020,"University of Connecticut",1,0,2005,3239,1789,1450,2176,881,1295,0.724,0.672,0.608,6096,812.00528,1187,2212,0.682926829268293
"1303",129020,"University of Connecticut",1,0,2006,3222,1631,1591,2148,962,1186,0.727,0.667,0.605,6456,835.62865,1202,2074,0.643699565487275
"1304",129020,"University of Connecticut",1,0,2007,3160,1682,1478,2136,921,1215,0.722,0.676,0.623,6816,863.553752,1233,2012,0.636708860759494
"1305",129020,"University of Connecticut",1,0,2008,3587,1780,1807,2382,1098,1284,0.721,0.664,0.608,7200,937.972827,1254,2208,0.615556175076666
"1306",129020,"University of Connecticut",1,0,2009,3206,1652,1554,2216,986,1230,0.745,0.691,0.634,7632,1762.235439,1296,2125,0.662819713038054
"1307",129020,"University of Connecticut",1,0,2010,3317,1629,1688,2300,1076,1224,0.751,0.693,0.637,8064,1764.68145,1312,2284,0.688574012662044
"1308",129242,"FAIRFIELD UNIVERSITY",1,0,1991,749,429,320,597,255,342,0.797,0.797,0.797,12920,60.842871,190,672,0.897196261682243
"1309",129242,"FAIRFIELD UNIVERSITY",1,0,1992,861,506,355,672,277,395,0.781,0.78,0.78,13720,65.459896,188,780,0.905923344947735
"1310",129242,"FAIRFIELD UNIVERSITY",1,0,1993,773,392,381,595,283,312,0.796,0.77,0.743,14560,71.812542,192,677,0.875808538163001
"1311",129242,"FAIRFIELD UNIVERSITY",1,0,1995,784,450,334,602,248,354,0.787,0.768,0.743,16340,79.863921,199,681,0.868622448979592
"1312",129242,"FAIRFIELD UNIVERSITY",1,0,1996,876,440,436,642,299,343,0.78,0.733,0.686,17360,84.50492,199,765,0.873287671232877
"1313",129242,"FAIRFIELD UNIVERSITY",1,0,1997,876,462,414,649,286,363,0.786,0.741,0.691,18310,73.515714,202,781,0.891552511415525
"1314",129242,"FAIRFIELD UNIVERSITY",1,0,1998,875,478,397,679,299,380,0.795,0.776,0.753,19210,76.214108,202,749,0.856
"1315",129242,"FAIRFIELD UNIVERSITY",1,0,1999,837,446,391,662,287,375,0.841,0.791,0.734,20000,80.089765,206,756,0.903225806451613
"1316",129242,"FAIRFIELD UNIVERSITY",1,0,2000,1008,610,398,797,291,506,0.83,0.791,0.731,21000,85.765883,214,908,0.900793650793651
"1317",129242,"FAIRFIELD UNIVERSITY",1,0,2001,831,463,368,646,265,381,0.823,0.777,0.72,22430,95.931345,222,697,0.838748495788207
"1318",129242,"FAIRFIELD UNIVERSITY",1,0,2002,813,461,352,609,240,369,0.8,0.749,0.682,24100,106.639003,219,708,0.870848708487085
"1319",129242,"FAIRFIELD UNIVERSITY",1,0,2003,789,459,330,636,260,376,0.819,0.806,0.788,26100,113.137,219,692,0.877059569074778
"1320",129242,"FAIRFIELD UNIVERSITY",1,0,2004,856,475,381,679,282,397,0.836,0.793,0.74,27930,119.058,221,784,0.91588785046729
"1321",129242,"Fairfield University",1,0,2005,940,551,389,744,297,447,0.811,0.791,0.763,29730,126.183,225,742,0.78936170212766
"1322",129242,"Fairfield University",1,0,2006,896,534,362,696,269,427,0.8,0.777,0.743,31450,130.838,238,614,0.685267857142857
"1323",129242,"Fairfield University",1,0,2007,842,496,346,664,268,396,0.798,0.789,0.775,33340,140.847,239,619,0.735154394299287
"1324",129242,"Fairfield University",1,0,2008,898,537,361,688,257,431,0.803,0.766,0.712,35510,156.314,252,536,0.596881959910913
"1325",129242,"Fairfield University",1,0,2009,848,479,369,664,270,394,0.823,0.783,0.732,36900,156.152,253,540,0.636792452830189
"1326",129242,"Fairfield University",1,0,2010,921,576,345,722,250,472,0.819,0.784,0.725,38450,156.122,250,627,0.680781758957655
"1327",129941,"UNIVERSITY OF NEW HAVEN",1,0,1991,320,84,236,60,42,18,0.214,0.188,0.178,9600,30.5354,149,208,0.65
"1328",129941,"UNIVERSITY OF NEW HAVEN",1,0,1992,302,74,228,42,30,12,0.162,0.139,0.132,9870,32.519697,152,194,0.642384105960265
"1329",129941,"UNIVERSITY OF NEW HAVEN",1,0,1993,289,103,186,47,27,20,0.194,0.163,0.145,10180,34.442269,152,171,0.591695501730104
"1330",129941,"UNIVERSITY OF NEW HAVEN",1,0,1995,352,115,237,110,74,36,0.313,0.312,0.312,11450,31.845538,154,247,0.701704545454545
"1331",129941,"UNIVERSITY OF NEW HAVEN",1,0,1996,329,109,220,68,40,28,0.257,0.207,0.182,12110,42.052795,157,229,0.696048632218845
"1332",129941,"UNIVERSITY OF NEW HAVEN",1,0,1997,324,130,194,87,46,41,0.315,0.269,0.237,13100,42.908727,152,207,0.638888888888889
"1333",129941,"UNIVERSITY OF NEW HAVEN",1,0,1998,370,141,229,95,51,44,0.312,0.257,0.223,13800,45.333252,158,236,0.637837837837838
"1334",129941,"UNIVERSITY OF NEW HAVEN",1,0,1999,322,117,205,66,32,34,0.291,0.205,0.156,14250,40.659727,159,194,0.602484472049689
"1335",129941,"UNIVERSITY OF NEW HAVEN",1,0,2000,457,195,262,101,48,53,0.272,0.221,0.183,15210,41.289997,165,242,0.529540481400438
"1336",129941,"UNIVERSITY OF NEW HAVEN",1,0,2001,503,202,301,123,54,69,0.342,0.245,0.179,16200,44.055776,171,283,0.562624254473161
"1337",129941,"UNIVERSITY OF NEW HAVEN",1,0,2002,529,240,289,166,67,99,0.413,0.314,0.232,18800,46.950285,168,374,0.706994328922495
"1338",129941,"UNIVERSITY OF NEW HAVEN",1,0,2003,618,301,317,223,85,138,0.458,0.361,0.268,20150,53.018749,178,467,0.755663430420712
"1339",129941,"UNIVERSITY OF NEW HAVEN",1,0,2004,571,264,307,197,111,86,0.326,0.345,0.362,21120,58.084867,169,437,0.765323992994746
"1340",129941,"University of New Haven",1,0,2005,653,322,331,256,117,139,0.432,0.392,0.353,22380,61.808839,162,503,0.770290964777948
"1341",129941,"University of New Haven",1,0,2006,690,325,365,305,157,148,0.455,0.442,0.43,24000,75.030993,169,513,0.743478260869565
"1342",129941,"University of New Haven",1,0,2007,700,331,369,296,138,158,0.477,0.423,0.374,25380,81.408869,182,498,0.711428571428571
"1343",129941,"University of New Haven",1,0,2008,1129,569,560,430,175,255,0.448,0.381,0.312,27000,94.173239,183,686,0.607617360496014
"1344",129941,"University of New Haven",1,0,2009,1252,639,613,553,247,306,0.479,0.442,0.403,28250,107.799487,200,486,0.388178913738019
"1345",129941,"University of New Haven",1,0,2010,1005,534,471,452,198,254,0.476,0.45,0.42,29500,118.004788,207,189,0.188059701492537
"1346",130253,"SACRED HEART UNIVERSITY",1,0,1991,485,196,289,93,41,52,0.265,0.192,0.142,8970,24.914975,103,356,0.734020618556701
"1347",130253,"SACRED HEART UNIVERSITY",1,0,1992,491,240,251,114,52,62,0.258,0.232,0.207,9740,30.209619,108,375,0.763747454175153
"1348",130253,"SACRED HEART UNIVERSITY",1,0,1993,515,274,241,197,72,125,0.456,0.383,0.299,10550,35.578677,111,400,0.776699029126214
"1349",130253,"SACRED HEART UNIVERSITY",1,0,1995,639,357,282,269,107,162,0.454,0.421,0.379,12100,48.368655,128,550,0.860719874804382
"1350",130253,"SACRED HEART UNIVERSITY",1,0,1996,602,361,241,281,81,200,0.554,0.467,0.336,12714,48.474822,127,534,0.887043189368771
"1351",130253,"SACRED HEART UNIVERSITY",1,0,1997,632,377,255,297,113,184,0.488,0.47,0.443,13435,48.681343,130,546,0.863924050632911
"1352",130253,"SACRED HEART UNIVERSITY",1,0,1998,702,409,293,308,112,196,0.479,0.439,0.382,13972,52.6266,137,618,0.88034188034188
"1353",130253,"SACRED HEART UNIVERSITY",1,0,1999,718,416,302,401,141,260,0.625,0.558,0.467,14670,56.802974,144,621,0.864902506963788
"1354",130253,"SACRED HEART UNIVERSITY",1,0,2000,834,498,336,477,168,309,0.62,0.572,0.5,15404,63.95978,148.5,749,0.898081534772182
"1355",130253,"SACRED HEART UNIVERSITY",1,0,2001,766,465,301,457,172,285,0.613,0.597,0.571,16328,69.308769,153,696,0.908616187989556
"1356",130253,"SACRED HEART UNIVERSITY",1,0,2002,797,457,340,445,171,274,0.6,0.558,0.503,19260,72.858312,160,752,0.943538268506901
"1357",130253,"SACRED HEART UNIVERSITY",1,0,2003,816,497,319,462,144,318,0.64,0.566,0.451,20220,79.117017,165,734,0.899509803921569
"1358",130253,"SACRED HEART UNIVERSITY",1,0,2004,876,521,355,528,196,332,0.637,0.603,0.552,21990,82.270772,181,786,0.897260273972603
"1359",130253,"Sacred Heart University",1,0,2005,886,542,344,544,186,358,0.66,0.614,0.541,23750,94.641473,182,821,0.926636568848758
"1360",130253,"Sacred Heart University",1,0,2006,931,603,328,536,172,364,0.604,0.576,0.524,25300,103.230096,189,846,0.908700322234157
"1361",130253,"Sacred Heart University",1,0,2007,956,580,376,606,220,386,0.665,0.634,0.585,26950,106.507013,199,850,0.889121338912134
"1362",130253,"Sacred Heart University",1,0,2008,981,577,404,583,201,382,0.662,0.594,0.498,28790,114.390165,212,788,0.803261977573904
"1363",130253,"Sacred Heart University",1,0,2009,907,542,365,526,180,346,0.638,0.58,0.493,30090,121.868961,201,681,0.750826901874311
"1364",130253,"Sacred Heart University",1,0,2010,974,610,364,529,167,362,0.593,0.543,0.459,31224,119.275122,217,690,0.708418891170431
"1365",130314,"SAINT JOSEPH COLLEGE",1,0,1995,153,152,1,82,0,82,0.54,0.536,0,13020,19.10017,74,134,0.875816993464052
"1366",130493,"SOUTHERN CONNECTICUT STATE UNIVERSITY",1,0,1991,1002,539,463,188,49,139,0.258,0.188,0.106,2199,60.905016,404,806,0.80439121756487
"1367",130493,"SOUTHERN CONNECTICUT STATE UNIVERSITY",1,0,1992,933,493,440,134,35,99,0.201,0.144,0.08,2646,62.755355,397,754,0.808145766345123
"1368",130493,"SOUTHERN CONNECTICUT STATE UNIVERSITY",1,0,1993,1044,572,472,139,38,101,0.177,0.133,0.081,2838,67.394825,389,868,0.831417624521073
"1369",130493,"SOUTHERN CONNECTICUT STATE UNIVERSITY",1,0,1995,917,526,391,121,36,85,0.162,0.132,0.092,3128,79.456218,382,665,0.725190839694656
"1370",130493,"SOUTHERN CONNECTICUT STATE UNIVERSITY",1,0,1996,1009,587,422,137,39,98,0.167,0.136,0.092,3474,70.715215,374,720,0.713577799801784
"1371",130493,"SOUTHERN CONNECTICUT STATE UNIVERSITY",1,0,1997,1089,624,465,146,39,107,0.171,0.134,0.084,3568,79.630362,343,789,0.724517906336088
"1372",130493,"SOUTHERN CONNECTICUT STATE UNIVERSITY",1,0,1998,1077,647,430,140,24,116,0.179,0.13,0.056,3716,82.551804,381,808,0.750232126276695
"1373",130493,"SOUTHERN CONNECTICUT STATE UNIVERSITY",1,0,1999,1238,702,536,148,50,98,0.14,0.12,0.093,2124,102.33545,388,877,0.708400646203554
"1374",130493,"SOUTHERN CONNECTICUT STATE UNIVERSITY",1,0,2000,1350,775,575,142,38,104,0.134,0.105,0.066,2142,114.252145,394.5,945,0.7
"1375",130493,"SOUTHERN CONNECTICUT STATE UNIVERSITY",1,0,2001,1429,858,571,134,37,97,0.113,0.094,0.065,2226,120.718752,401,1015,0.710286913925822
"1376",130493,"SOUTHERN CONNECTICUT STATE UNIVERSITY",1,0,2002,1276,719,557,144,46,98,0.136,0.113,0.083,2314,130.652394,402,895,0.70141065830721
"1377",130493,"SOUTHERN CONNECTICUT STATE UNIVERSITY",1,0,2003,1310,802,508,7,2,5,0.006,0.005,0.004,2648,132.238169,396,944,0.720610687022901
"1378",130493,"SOUTHERN CONNECTICUT STATE UNIVERSITY",1,0,2004,1396,899,497,219,46,173,0.192,0.157,0.093,3010,131.897909,403,1035,0.741404011461318
"1379",130493,"Southern Connecticut State University",1,0,2005,1313,866,447,192,43,149,0.172,0.146,0.096,3034,161.025689,403,958,0.72962680883473
"1380",130493,"Southern Connecticut State University",1,0,2006,1516,987,529,262,54,208,0.211,0.173,0.102,3187,167.58286,409,1069,0.705145118733509
"1381",130493,"Southern Connecticut State University",1,0,2007,1333,884,449,239,56,183,0.207,0.179,0.125,3346,179.224713,438,951,0.713428357089272
"1382",130493,"Southern Connecticut State University",1,0,2008,1288,858,430,293,77,216,0.252,0.227,0.179,3514,192.754315,449,928,0.720496894409938
"1383",130493,"Southern Connecticut State University",1,0,2009,1237,792,445,280,65,215,0.272,0.226,0.146,3742,203.083639,407,909,0.734842360549717
"1384",130493,"Southern Connecticut State University",1,0,2010,1248,792,456,299,58,241,0.304,0.24,0.127,4023,188.447417,424,862,0.690705128205128
"1385",130590,"TRINITY COLLEGE",1,0,1991,481,226,255,387,192,195,0.863,0.805,0.753,16740,52.820515,145,401,0.833679833679834
"1386",130590,"TRINITY COLLEGE",1,0,1992,472,240,232,352,161,191,0.796,0.746,0.694,17620,56.832357,143,385,0.815677966101695
"1387",130590,"TRINITY COLLEGE",1,0,1993,476,242,234,362,173,189,0.781,0.761,0.739,17950,60.838502,146,398,0.836134453781513
"1388",130590,"TRINITY COLLEGE",1,0,1995,507,246,261,388,174,214,0.87,0.765,0.667,19690,65.298861,142,411,0.810650887573965
"1389",130590,"TRINITY COLLEGE",1,0,1996,504,238,266,387,195,192,0.807,0.768,0.733,21410,71.814962,151,405,0.803571428571429
"1390",130590,"TRINITY COLLEGE",1,0,1997,500,220,280,386,205,181,0.823,0.772,0.732,22470,71.590014,150,377,0.754
"1391",130590,"TRINITY COLLEGE",1,0,1998,509,263,246,390,176,214,0.814,0.766,0.715,23570,78.550715,151,362,0.711198428290766
"1392",130590,"TRINITY COLLEGE",1,0,1999,565,286,279,442,206,236,0.825,0.782,0.738,23730,85.981271,166,389,0.688495575221239
"1393",130590,"TRINITY COLLEGE",1,0,2000,489,253,236,389,181,208,0.822,0.796,0.767,24660,93.808451,181,349,0.713701431492842
"1394",130590,"TRINITY COLLEGE",1,0,2001,491,239,252,388,184,204,0.854,0.79,0.73,25880,97.721241,196,344,0.70061099796334
"1395",130590,"TRINITY COLLEGE",1,0,2002,548,286,262,445,207,238,0.832,0.812,0.79,27170,105.583341,201,349,0.636861313868613
"1396",130590,"TRINITY COLLEGE",1,0,2003,548,257,291,421,212,209,0.813,0.768,0.729,28740,109.993188,191,335,0.611313868613139
"1397",130590,"TRINITY COLLEGE",1,0,2004,569,283,286,442,213,229,0.809,0.777,0.745,30380,113.101795,201,302,0.530755711775044
"1398",130590,"Trinity College",1,0,2005,573,289,284,469,221,248,0.858,0.818,0.778,32000,118.75715,189,358,0.62478184991274
"1399",130590,"Trinity College",1,0,2006,608,294,314,466,229,237,0.806,0.766,0.729,33440,114.666196,180,397,0.652960526315789
"1400",130590,"Trinity College",1,0,2007,576,292,284,469,224,245,0.839,0.814,0.789,35110,120.698422,179,382,0.663194444444444
"1401",130590,"Trinity College",1,0,2008,589,300,289,464,214,250,0.833,0.788,0.74,36864,129.384562,196,355,0.602716468590832
"1402",130590,"Trinity College",1,0,2009,573,272,301,464,232,232,0.853,0.81,0.771,38900,128.259577,206,398,0.694589877835951
"1403",130590,"Trinity College",1,0,2010,591,300,291,473,223,250,0.833,0.8,0.766,40410,129.970895,193,387,0.654822335025381
"1404",130697,"WESLEYAN UNIVERSITY",1,0,1991,663,347,316,501,223,278,0.801,0.756,0.706,16250,82.768,255,435,0.656108597285068
"1405",130697,"WESLEYAN UNIVERSITY",1,0,1992,704,361,343,553,263,290,0.803,0.786,0.767,17190,85.839,252,449,0.637784090909091
"1406",130697,"WESLEYAN UNIVERSITY",1,0,1993,703,365,338,547,257,290,0.795,0.778,0.76,18150,92.272,254,474,0.67425320056899
"1407",130697,"WESLEYAN UNIVERSITY",1,0,1995,710,356,354,584,288,296,0.832,0.823,0.814,20820,101.244,241,484,0.68169014084507
"1408",130697,"WESLEYAN UNIVERSITY",1,0,1996,738,374,364,633,311,322,0.861,0.858,0.854,21910,109.513,246,503,0.681571815718157
"1409",130697,"WESLEYAN UNIVERSITY",1,0,1997,700,371,329,583,263,320,0.863,0.833,0.799,22980,106.258,252,463,0.661428571428571
"1410",130697,"WESLEYAN UNIVERSITY",1,0,1998,716,382,334,593,264,329,0.861,0.828,0.79,24050,112.777,259,463,0.646648044692737
"1411",130697,"WESLEYAN UNIVERSITY",1,0,1999,732,375,357,609,283,326,0.869,0.832,0.793,24330,116.573,263,499,0.681693989071038
"1412",130697,"WESLEYAN UNIVERSITY",1,0,2000,720,371,349,607,281,326,0.879,0.843,0.805,25380,123.895,287,447,0.620833333333333
"1413",130697,"WESLEYAN UNIVERSITY",1,0,2001,722,372,350,606,280,326,0.876,0.839,0.8,26290,130.341,311,465,0.64404432132964
"1414",130697,"WESLEYAN UNIVERSITY",1,0,2002,716,377,339,634,288,346,0.918,0.885,0.85,27474,140.323,311,444,0.620111731843575
"1415",130697,"WESLEYAN UNIVERSITY",1,0,2003,713,376,337,631,291,340,0.904,0.885,0.864,29784,147.91,329,431,0.604488078541374
"1416",130697,"WESLEYAN UNIVERSITY",1,0,2004,728,385,343,649,300,349,0.907,0.891,0.875,31436,159.757,322,428,0.587912087912088
"1417",130697,"Wesleyan University",1,0,2005,705,360,345,614,305,309,0.858,0.871,0.884,32976,161.525,325,422,0.598581560283688
"1418",130697,"Wesleyan University",1,0,2006,716,352,364,624,316,308,0.875,0.872,0.868,34630,166.772,333,448,0.625698324022346
"1419",130697,"Wesleyan University",1,0,2007,733,377,356,632,305,327,0.867,0.862,0.857,36536,167.591,325,451,0.615279672578445
"1420",130697,"Wesleyan University",1,0,2008,715,355,360,622,300,322,0.907,0.87,0.833,38364,177.849,328,366,0.511888111888112
"1421",130697,"Wesleyan University",1,0,2009,744,389,355,681,322,359,0.923,0.915,0.907,39822,187.436,330,380,0.510752688172043
"1422",130697,"Wesleyan University",1,0,2010,748,411,337,652,292,360,0.876,0.872,0.866,41814,174.457,339,446,0.596256684491979
"1423",130776,"WESTERN CONNECTICUT STATE UNIVERSITY",1,0,1991,349,187,162,96,32,64,0.342,0.275,0.198,2361,30.092942,180,288,0.825214899713467
"1424",130776,"WESTERN CONNECTICUT STATE UNIVERSITY",1,0,1992,372,161,211,88,47,41,0.255,0.237,0.223,2910,29.632729,183,275,0.739247311827957
"1425",130776,"WESTERN CONNECTICUT STATE UNIVERSITY",1,0,1993,526,247,279,115,50,65,0.263,0.219,0.179,2900,32.390268,178,417,0.792775665399239
"1426",130776,"WESTERN CONNECTICUT STATE UNIVERSITY",1,0,1995,460,237,223,79,35,44,0.186,0.172,0.157,3168,38.574731,187,336,0.730434782608696
"1427",130776,"WESTERN CONNECTICUT STATE UNIVERSITY",1,0,1996,496,242,254,60,32,28,0.116,0.121,0.126,3528,36.572844,181,383,0.772177419354839
"1428",130776,"WESTERN CONNECTICUT STATE UNIVERSITY",1,0,1997,668,303,365,90,35,55,0.182,0.135,0.096,3626,41.076663,174,495,0.741017964071856
"1429",130776,"WESTERN CONNECTICUT STATE UNIVERSITY",1,0,1998,655,315,340,91,33,58,0.184,0.139,0.097,3626,43.955476,175,479,0.731297709923664
"1430",130776,"WESTERN CONNECTICUT STATE UNIVERSITY",1,0,1999,697,359,338,70,22,48,0.134,0.1,0.065,2062,49.620362,178,525,0.753228120516499
"1431",130776,"WESTERN CONNECTICUT STATE UNIVERSITY",1,0,2000,822,404,418,104,42,62,0.154,0.127,0.1,2142,59.529369,183.5,591,0.718978102189781
"1432",130776,"WESTERN CONNECTICUT STATE UNIVERSITY",1,0,2001,841,439,402,111,36,75,0.171,0.132,0.09,2226,47.623472,189,617,0.733650416171225
"1433",130776,"WESTERN CONNECTICUT STATE UNIVERSITY",1,0,2002,794,434,360,113,32,81,0.187,0.142,0.089,2314,74.784714,188,582,0.732997481108312
"1434",130776,"WESTERN CONNECTICUT STATE UNIVERSITY",1,0,2003,808,444,364,105,40,65,0.146,0.13,0.11,2648,75.054286,186,630,0.77970297029703
"1435",130776,"WESTERN CONNECTICUT STATE UNIVERSITY",1,0,2004,755,382,373,120,53,67,0.175,0.159,0.142,3010,76.83233,196,624,0.826490066225166
"1436",130776,"Western Connecticut State University",1,0,2005,773,396,377,124,52,72,0.182,0.16,0.138,3034,95.814121,197,617,0.798188874514877
"1437",130776,"Western Connecticut State University",1,0,2006,843,413,430,167,64,103,0.249,0.198,0.149,3187,120.915378,200,655,0.776986951364176
"1438",130776,"Western Connecticut State University",1,0,2007,913,494,419,190,77,113,0.229,0.208,0.184,3346,106.657935,212,701,0.767798466593647
"1439",130776,"Western Connecticut State University",1,0,2008,928,462,466,180,82,98,0.212,0.194,0.176,3514,107.563677,221,700,0.754310344827586
"1440",130776,"Western Connecticut State University",1,0,2009,1008,549,459,255,99,156,0.284,0.253,0.216,3742,110.766005,218,761,0.754960317460317
"1441",130776,"Western Connecticut State University",1,0,2010,975,524,451,209,85,124,0.237,0.214,0.188,4023,110.530666,228,653,0.66974358974359
"1442",130794,"YALE UNIVERSITY",1,0,1991,1290,592,698,1127,608,519,0.877,0.874,0.871,16300,745.931568,773,800,0.62015503875969
"1443",130794,"YALE UNIVERSITY",1,0,1992,1326,640,686,1139,561,578,0.903,0.859,0.818,17500,799.262466,755,805,0.607088989441931
"1444",130794,"YALE UNIVERSITY",1,0,1993,1317,627,690,1135,582,553,0.882,0.862,0.843,18630,837.577402,767,696,0.528473804100228
"1445",130794,"YALE UNIVERSITY",1,0,1995,1360,692,668,1198,575,623,0.9,0.881,0.861,21000,934.937954,765,773,0.568382352941176
"1446",130794,"YALE UNIVERSITY",1,0,1996,1403,688,715,1235,611,624,0.907,0.88,0.855,22200,983.280245,772,767,0.546685673556664
"1447",130794,"YALE UNIVERSITY",1,0,1997,1307,662,645,1170,552,618,0.933,0.895,0.856,23100,995.215,758,701,0.536342769701607
"1448",130794,"YALE UNIVERSITY",1,0,1998,1295,646,649,1146,573,573,0.887,0.885,0.883,23780,1066.49,777,656,0.506563706563707
"1449",130794,"YALE UNIVERSITY",1,0,1999,1358,682,676,1219,594,625,0.916,0.898,0.879,24500,1136.545,814,736,0.541973490427099
"1450",130794,"YALE UNIVERSITY",1,0,2000,1349,678,671,1189,582,607,0.895,0.881,0.867,25220,1283.533,845.5,693,0.513713862120089
"1451",130794,"YALE UNIVERSITY",1,0,2001,1293,648,645,1125,538,587,0.906,0.87,0.834,26100,1334.913,877,645,0.498839907192575
"1452",130794,"YALE UNIVERSITY",1,0,2002,1299,643,656,1164,576,588,0.915,0.896,0.878,27130,1426.989,893,661,0.508852963818322
"1453",130794,"YALE UNIVERSITY",1,0,2003,1350,680,670,1221,582,639,0.94,0.904,0.869,28400,1543.176,1044,695,0.514814814814815
"1454",130794,"YALE UNIVERSITY",1,0,2004,1306,632,674,1161,589,572,0.905,0.889,0.874,29820,1675.908,1037,650,0.497702909647779
"1455",130794,"Yale University",1,0,2005,1320,651,669,1172,574,598,0.919,0.888,0.858,31460,1786.94,1038,624,0.472727272727273
"1456",130794,"Yale University",1,0,2006,1313,654,659,1169,578,591,0.904,0.89,0.877,33030,1963.572,1081,628,0.478293983244478
"1457",130794,"Yale University",1,0,2007,1313,661,652,1177,578,599,0.906,0.896,0.887,34530,2108.514,1079,697,0.530845392231531
"1458",130794,"Yale University",1,0,2008,1316,664,652,1150,543,607,0.914,0.874,0.833,35300,2314.45,1129,638,0.484802431610942
"1459",130794,"Yale University",1,0,2009,1305,651,654,1145,553,592,0.909,0.877,0.846,36500,2493.475,1164,667,0.511111111111111
"1460",130794,"Yale University",1,0,2010,1343,696,647,1161,547,614,0.882,0.864,0.845,38300,2572.137,1152,665,0.495160089352197
"1461",130934,"DELAWARE STATE COLLEGE",1,0,1991,585,330,255,53,12,41,0.124,0.091,0.047,1546,32.081375,158,103,0.176068376068376
"1462",130934,"DELAWARE STATE COLLEGE",1,0,1992,579,305,274,47,22,25,0.082,0.081,0.08,1788,36.031014,185,107,0.184801381692573
"1463",130934,"DELAWARE STATE UNIVERSITY",1,0,1993,686,386,300,68,11,57,0.148,0.099,0.037,1966,37.691971,176,103,0.150145772594752
"1464",130934,"DELAWARE STATE UNIVERSITY",1,0,1995,563,333,230,76,27,49,0.147,0.135,0.117,2250,46.250521,168,53,0.0941385435168739
"1465",130934,"DELAWARE STATE UNIVERSITY",1,0,1996,544,305,239,87,21,66,0.216,0.16,0.088,2636,47.290445,173,63,0.115808823529412
"1466",130934,"DELAWARE STATE UNIVERSITY",1,0,1997,637,359,278,121,35,86,0.24,0.19,0.126,2810,49.98577,175,60,0.0941915227629513
"1467",130934,"DELAWARE STATE UNIVERSITY",1,0,1998,578,339,239,118,39,79,0.233,0.204,0.163,2974,53.432805,177,48,0.0830449826989619
"1468",130934,"DELAWARE STATE UNIVERSITY",1,0,1999,632,375,257,132,37,95,0.253,0.209,0.144,3096,58.769636,184,67,0.106012658227848
"1469",130934,"DELAWARE STATE UNIVERSITY",1,0,2000,684,405,279,155,36,119,0.294,0.227,0.129,3290,63.480464,179,70,0.10233918128655
"1470",130934,"DELAWARE STATE UNIVERSITY",1,0,2001,686,385,301,107,30,77,0.2,0.156,0.1,3422,64.829804,174,55,0.0801749271137026
"1471",130934,"DELAWARE STATE UNIVERSITY",1,0,2002,761,439,322,1,0,1,0.002,0.001,0,3956,60.612916,182,64,0.0840998685939553
"1472",130934,"DELAWARE STATE UNIVERSITY",1,0,2003,597,355,242,89,13,76,0.214,0.149,0.054,3996,63.521403,194,53,0.0887772194304858
"1473",130934,"DELAWARE STATE UNIVERSITY",1,0,2004,687,400,287,133,23,110,0.275,0.194,0.08,4646,67.950029,179,62,0.0902474526928675
"1474",130934,"Delaware State University",1,0,2005,885,514,371,164,40,124,0.241,0.185,0.108,5480,74.162341,177,53,0.0598870056497175
"1475",130934,"Delaware State University",1,0,2006,818,463,355,126,37,89,0.192,0.154,0.104,5366,80.082297,166,66,0.0806845965770171
"1476",130934,"Delaware State University",1,0,2007,799,495,304,145,37,108,0.218,0.181,0.122,5366,92.997394,184,58,0.0725907384230288
"1477",130934,"Delaware State University",1,0,2008,721,455,266,154,36,118,0.259,0.214,0.135,5701,102.995991,193,44,0.0610263522884882
"1478",130934,"Delaware State University",1,0,2009,739,463,276,165,42,123,0.266,0.223,0.152,5701,107.647559,190,57,0.0771312584573748
"1479",130934,"Delaware State University",1,0,2010,887,556,331,220,58,162,0.291,0.248,0.175,5901,99.109336,198,57,0.0642615558060879
"1480",130943,"UNIVERSITY OF DELAWARE",1,0,1991,3170,1871,1299,1592,524,1068,0.571,0.502,0.403,3520,316.913314,972,2948,0.929968454258675
"1481",130943,"UNIVERSITY OF DELAWARE",1,0,1992,2944,1729,1215,1593,590,1003,0.58,0.541,0.486,3722,333.674797,960,2695,0.915421195652174
"1482",130943,"UNIVERSITY OF DELAWARE",1,0,1993,3181,1847,1334,1623,573,1050,0.569,0.51,0.43,3948,346.072111,901,2892,0.909148066645709
"1483",130943,"UNIVERSITY OF DELAWARE",1,0,1995,3155,1883,1272,1719,621,1098,0.583,0.545,0.488,4286,388.758975,915,2784,0.882408874801902
"1484",130943,"UNIVERSITY OF DELAWARE",1,0,1996,3290,1980,1310,1823,623,1200,0.606,0.554,0.476,4430,403.319051,920,2881,0.875683890577508
"1485",130943,"UNIVERSITY OF DELAWARE",1,0,1997,3179,1881,1298,1823,622,1201,0.639,0.573,0.479,4574,408.309118,935,2781,0.874803397294747
"1486",130943,"UNIVERSITY OF DELAWARE",1,0,1998,3545,2149,1396,2078,696,1382,0.643,0.586,0.499,4716,433.526077,930,3145,0.887165021156558
"1487",130943,"UNIVERSITY OF DELAWARE",1,0,1999,3513,2146,1367,2193,764,1429,0.666,0.624,0.559,4380,467.776004,933,3123,0.888983774551665
"1488",130943,"UNIVERSITY OF DELAWARE",1,0,2000,3128,1926,1202,1884,620,1264,0.656,0.602,0.516,4510,479.046543,989,2722,0.870204603580563
"1489",130943,"UNIVERSITY OF DELAWARE",1,0,2001,3362,1944,1418,2147,767,1380,0.71,0.639,0.541,4770,473.703,1045,2939,0.874182034503272
"1490",130943,"UNIVERSITY OF DELAWARE",1,0,2002,3712,2222,1490,2282,777,1505,0.677,0.615,0.521,5070,509.917,1124,3256,0.877155172413793
"1491",130943,"UNIVERSITY OF DELAWARE",1,0,2003,3794,2157,1637,2016,761,1255,0.582,0.531,0.465,5890,514.103629,1116,3154,0.831312598840274
"1492",130943,"UNIVERSITY OF DELAWARE",1,0,2004,3769,2173,1596,2131,776,1355,0.624,0.565,0.486,6304,540.045285,1121,3170,0.841071902361369
"1493",130943,"University of Delaware",1,0,2005,3830,2252,1578,2250,803,1447,0.642,0.587,0.509,6614,578.911928,1077,3183,0.831070496083551
"1494",130943,"University of Delaware",1,0,2006,3563,2127,1436,2175,777,1398,0.657,0.61,0.541,6980,603.64744,1117,2907,0.815885489755824
"1495",130943,"University of Delaware",1,0,2007,3912,2305,1607,2445,879,1566,0.679,0.625,0.547,7340,639.637603,1117,3046,0.778629856850716
"1496",130943,"University of Delaware",1,0,2008,3834,2211,1623,2378,891,1487,0.672,0.62,0.549,7780,674.991354,1117,3028,0.789775691184142
"1497",130943,"University of Delaware",1,0,2009,4211,2424,1787,2486,929,1557,0.642,0.59,0.52,8540,702.104681,1112,3261,0.774400379957255
"1498",130943,"University of Delaware",1,0,2010,3719,2116,1603,2399,913,1486,0.702,0.645,0.57,9040,738.021556,1126,2863,0.769830599623555
"1499",131159,"AMERICAN UNIVERSITY",1,0,1991,1027,633,394,622,223,399,0.63,0.606,0.566,13716,159.183,468,794,0.773125608568647
"1500",131159,"AMERICAN UNIVERSITY",1,0,1992,1025,629,396,629,235,394,0.626,0.614,0.593,14594,169.135,452,786,0.766829268292683
"1501",131159,"AMERICAN UNIVERSITY",1,0,1993,1039,660,379,641,219,422,0.639,0.617,0.578,15386,176.246,446,805,0.774783445620789
"1502",131159,"AMERICAN UNIVERSITY",1,0,1995,1221,794,427,789,288,501,0.631,0.646,0.674,17115,190.096,441,964,0.789516789516789
"1503",131159,"AMERICAN UNIVERSITY",1,0,1996,1107,703,404,643,224,419,0.596,0.581,0.554,17744,180.8096,452,799,0.721770551038844
"1504",131159,"AMERICAN UNIVERSITY",1,0,1997,1056,665,391,678,239,439,0.66,0.642,0.611,18555,173.445,456,781,0.739583333333333
"1505",131159,"AMERICAN UNIVERSITY",1,0,1998,1232,774,458,802,262,540,0.698,0.651,0.572,19433,186.721,457,919,0.745941558441558
"1506",131159,"AMERICAN UNIVERSITY",1,0,1999,1146,744,402,723,231,492,0.661,0.631,0.575,20118,203.919,463,706,0.616055846422339
"1507",131159,"AMERICAN UNIVERSITY",1,0,2000,1272,821,451,818,260,558,0.68,0.643,0.576,21144,204.735,475,813,0.639150943396226
"1508",131159,"AMERICAN UNIVERSITY",1,0,2001,1387,875,512,924,330,594,0.679,0.666,0.645,22116,219.535,487,925,0.666906993511175
"1509",131159,"AMERICAN UNIVERSITY",1,0,2002,1303,811,492,917,329,588,0.725,0.704,0.669,23068,243.192,476,910,0.698388334612433
"1510",131159,"AMERICAN UNIVERSITY",1,0,2003,1238,832,406,882,286,596,0.716,0.712,0.704,24452,262.941,492,835,0.674474959612278
"1511",131159,"AMERICAN UNIVERSITY",1,0,2004,1210,776,434,902,306,596,0.768,0.745,0.705,25920,275.704,490,811,0.670247933884297
"1512",131159,"American University",1,0,2005,1216,778,438,898,319,579,0.744,0.738,0.728,27552,292.926,543,820,0.674342105263158
"1513",131159,"American University",1,0,2006,1385,923,462,1007,321,686,0.743,0.727,0.695,29206,306.724,547,966,0.697472924187726
"1514",131159,"American University",1,0,2007,1288,840,448,975,334,641,0.763,0.757,0.746,30958,323.304,568,850,0.659937888198758
"1515",131159,"American University",1,0,2008,1570,967,603,1199,442,757,0.783,0.764,0.733,32816,357.045,588,917,0.584076433121019
"1516",131159,"American University",1,0,2009,1527,917,610,1164,449,715,0.78,0.762,0.736,34456,369.268,637,914,0.598559266535691
"1517",131159,"American University",1,0,2010,1498,911,587,1145,438,707,0.776,0.764,0.746,36180,406.717,681,935,0.624165554072096
"1518",131283,"CATHOLIC UNIVERSITY OF AMERICA",1,0,1991,532,308,224,309,124,185,0.601,0.581,0.554,11936,95.508327,386,428,0.804511278195489
"1519",131283,"CATHOLIC UNIVERSITY OF AMERICA",1,0,1992,471,252,219,272,121,151,0.599,0.577,0.553,12986,101.395719,389,380,0.806794055201699
"1520",131283,"CATHOLIC UNIVERSITY OF AMERICA",1,0,1993,505,276,229,306,130,176,0.638,0.606,0.568,13614,100.512002,380,418,0.827722772277228
"1521",131283,"CATHOLIC UNIVERSITY OF AMERICA",1,0,1995,514,265,249,290,125,165,0.623,0.564,0.502,15062,111.225676,357,408,0.793774319066148
"1522",131283,"CATHOLIC UNIVERSITY OF AMERICA",1,0,1996,452,264,188,261,100,161,0.61,0.577,0.532,16152,115.749063,355,362,0.800884955752212
"1523",131283,"CATHOLIC UNIVERSITY OF AMERICA",1,0,1997,567,313,254,337,148,189,0.604,0.594,0.583,17110,104.300142,347,472,0.832451499118166
"1524",131283,"CATHOLIC UNIVERSITY OF AMERICA",1,0,1998,597,338,259,378,149,229,0.677,0.633,0.575,18066,108.415656,350,489,0.819095477386935
"1525",131283,"CATHOLIC UNIVERSITY OF AMERICA",1,0,1999,762,381,381,457,204,253,0.664,0.6,0.535,18200,118.18978,349,641,0.841207349081365
"1526",131283,"CATHOLIC UNIVERSITY OF AMERICA",1,0,2000,530,298,232,315,126,189,0.634,0.594,0.543,19100,90.61575,354.5,406,0.766037735849057
"1527",131283,"CATHOLIC UNIVERSITY OF AMERICA",1,0,2001,613,342,271,407,170,237,0.693,0.664,0.627,20050,125.972533,360,513,0.836867862969005
"1528",131283,"CATHOLIC UNIVERSITY OF AMERICA",1,0,2002,700,406,294,438,170,268,0.66,0.626,0.578,21050,134.824305,359,550,0.785714285714286
"1529",131283,"CATHOLIC UNIVERSITY OF AMERICA",1,0,2003,646,362,284,423,167,256,0.707,0.655,0.588,22200,141.813545,336,506,0.78328173374613
"1530",131283,"CATHOLIC UNIVERSITY OF AMERICA",1,0,2004,719,387,332,429,182,247,0.638,0.597,0.548,23600,154.839,354,545,0.757997218358832
"1531",131283,"Catholic University of America",1,0,2005,786,455,331,482,187,295,0.648,0.613,0.565,24800,160.025,344,569,0.723918575063613
"1532",131283,"Catholic University of America",1,0,2006,856,459,397,527,219,308,0.671,0.616,0.552,26200,165.236,344,608,0.710280373831776
"1533",131283,"Catholic University of America",1,0,2007,864,451,413,535,233,302,0.67,0.619,0.564,27700,177.691,347,653,0.755787037037037
"1534",131283,"Catholic University of America",1,0,2008,901,475,426,537,234,303,0.638,0.596,0.549,30520,191.431,352,605,0.671476137624861
"1535",131283,"Catholic University of America",1,0,2009,813,456,357,501,184,317,0.695,0.616,0.515,31740,194.316,368,542,0.666666666666667
"1536",131283,"Catholic University of America",1,0,2010,991,576,415,613,240,373,0.648,0.619,0.578,33580,202.389,385,666,0.67204843592331
"1537",131450,"GALLAUDET UNIVERSITY",1,0,1991,227,129,98,15,2,13,0.101,0.066,0.02,3854,73.488546,266,149,0.656387665198238
"1538",131450,"GALLAUDET UNIVERSITY",1,0,1992,339,177,162,15,6,9,0.051,0.044,0.037,4194,75.441221,264,210,0.619469026548673
"1539",131450,"GALLAUDET UNIVERSITY",1,0,1993,306,164,142,18,6,12,0.073,0.059,0.042,4570,79.054144,261,190,0.620915032679739
"1540",131450,"GALLAUDET UNIVERSITY",1,0,1995,225,120,105,10,2,8,0.067,0.044,0.019,6140,86.111985,244,137,0.608888888888889
"1541",131450,"GALLAUDET UNIVERSITY",1,0,1996,186,105,81,13,6,7,0.067,0.07,0.074,6650,87.688446,225,113,0.60752688172043
"1542",131450,"GALLAUDET UNIVERSITY",1,0,1997,211,116,95,10,3,7,0.06,0.047,0.032,7043,84.508447,225,134,0.635071090047393
"1543",131450,"GALLAUDET UNIVERSITY",1,0,1998,230,112,118,17,7,10,0.089,0.074,0.059,7464,86.84098,221,125,0.543478260869565
"1544",131450,"GALLAUDET UNIVERSITY",1,0,1999,254,135,119,14,6,8,0.059,0.055,0.05,6870,90.235296,227,168,0.661417322834646
"1545",131450,"GALLAUDET UNIVERSITY",1,0,2000,241,123,118,16,3,13,0.106,0.066,0.025,7350,94.310997,225,142,0.589211618257261
"1546",131450,"GALLAUDET UNIVERSITY",1,0,2001,213,113,100,10,3,7,0.062,0.047,0.03,7870,96.727512,223,126,0.591549295774648
"1547",131450,"GALLAUDET UNIVERSITY",1,0,2002,235,122,113,12,6,6,0.049,0.051,0.053,8420,106.925012,229,143,0.608510638297872
"1548",131450,"GALLAUDET UNIVERSITY",1,0,2003,236,124,112,25,8,17,0.137,0.106,0.071,9000,105.853054,230,144,0.610169491525424
"1549",131450,"GALLAUDET UNIVERSITY",1,0,2004,227,121,106,18,8,10,0.083,0.079,0.075,9630,107.836458,230,128,0.563876651982379
"1550",131450,"Gallaudet University",1,0,2005,280,151,129,28,7,21,0.139,0.1,0.054,9920,115.852149,235,176,0.628571428571429
"1551",131450,"Gallaudet University",1,0,2006,209,96,113,15,5,10,0.104,0.072,0.044,10220,119.653942,227,146,0.698564593301435
"1552",131450,"Gallaudet University",1,0,2007,174,97,77,27,9,18,0.186,0.155,0.117,10220,123.553504,211,123,0.706896551724138
"1553",131450,"Gallaudet University",1,0,2008,179,97,82,29,9,20,0.206,0.162,0.11,10850,129.00714,200,111,0.620111731843575
"1554",131450,"Gallaudet University",1,0,2009,211,112,99,51,13,38,0.339,0.242,0.131,10850,134.85567,201,141,0.66824644549763
"1555",131450,"Gallaudet University",1,0,2010,198,107,91,39,10,29,0.271,0.197,0.11,10850,135.636281,191,120,0.606060606060606
"1556",131469,"GEORGE WASHINGTON UNIVERSITY",1,0,1991,1151,622,529,686,282,404,0.65,0.596,0.533,14902,522.1887,633,802,0.696785403996525
"1557",131469,"GEORGE WASHINGTON UNIVERSITY",1,0,1992,1193,642,551,695,291,404,0.629,0.583,0.528,16080,578.24166,643,765,0.641240569991618
"1558",131469,"GEORGE WASHINGTON UNIVERSITY",1,0,1993,1492,801,691,887,373,514,0.642,0.595,0.54,16988,671.295592,637,983,0.658847184986595
"1559",131469,"GEORGE WASHINGTON UNIVERSITY",1,0,1995,1367,803,564,905,346,559,0.696,0.662,0.613,19032,778.990692,633,917,0.670811997073884
"1560",131469,"GEORGE WASHINGTON UNIVERSITY",1,0,1996,1643,973,670,1082,427,655,0.673,0.659,0.637,19980,767.369564,649,1081,0.657942787583688
"1561",131469,"GEORGE WASHINGTON UNIVERSITY",1,0,1997,1716,972,744,1185,485,700,0.72,0.691,0.652,21360,724.9783,670,1102,0.642191142191142
"1562",131469,"GEORGE WASHINGTON UNIVERSITY",1,0,1998,1773,1057,716,1285,471,814,0.77,0.725,0.658,22625,669.005063,692,1182,0.666666666666667
"1563",131469,"GEORGE WASHINGTON UNIVERSITY",1,0,1999,2109,1282,827,1515,556,959,0.748,0.718,0.672,22925,697.857863,717,1427,0.676623992413466
"1564",131469,"GEORGE WASHINGTON UNIVERSITY",1,0,2000,2093,1241,852,1504,574,930,0.749,0.719,0.674,24005,651.967,742,1426,0.681318681318681
"1565",131469,"GEORGE WASHINGTON UNIVERSITY",1,0,2001,2566,1433,1133,1864,761,1103,0.77,0.726,0.672,24880,554.647,767,1696,0.660950896336711
"1566",131469,"GEORGE WASHINGTON UNIVERSITY",1,0,2002,2283,1359,924,1735,660,1075,0.791,0.76,0.714,27790,608.002,890,1518,0.664914586070959
"1567",131469,"GEORGE WASHINGTON UNIVERSITY",1,0,2003,2260,1333,927,1726,683,1043,0.782,0.764,0.737,29320,639.937,862,1550,0.685840707964602
"1568",131469,"GEORGE WASHINGTON UNIVERSITY",1,0,2004,2623,1441,1182,1957,830,1127,0.782,0.746,0.702,34000,671.814,859,1763,0.672131147540984
"1569",131469,"George Washington University",1,0,2005,2408,1375,1033,1823,732,1091,0.793,0.757,0.709,33992,718.34,841,1562,0.648671096345515
"1570",131469,"George Washington University",1,0,2006,2440,1348,1092,1804,756,1048,0.777,0.739,0.692,35604,776.728,854,1544,0.632786885245902
"1571",131469,"George Washington University",1,0,2007,2123,1198,925,1604,668,936,0.781,0.756,0.722,37000,821.815644,904,1275,0.600565237870937
"1572",131469,"George Washington University",1,0,2008,2449,1408,1041,1755,687,1068,0.758,0.717,0.66,38630,903.268295,910,1224,0.499795835034708
"1573",131469,"George Washington University",1,0,2009,2582,1435,1147,1940,825,1115,0.777,0.751,0.719,39962,953.345881,939,1437,0.556545313710302
"1574",131469,"George Washington University",1,0,2010,2376,1316,1060,1805,761,1044,0.793,0.76,0.718,41182,986.274,983,1535,0.646043771043771
"1575",131496,"GEORGETOWN UNIVERSITY",1,0,1991,1369,710,659,1133,547,586,0.825,0.828,0.83,15652,645.2,499,964,0.704163623082542
"1576",131496,"GEORGETOWN UNIVERSITY",1,0,1992,1383,733,650,1179,550,629,0.858,0.852,0.846,16589,717.625,514,945,0.683297180043384
"1577",131496,"GEORGETOWN UNIVERSITY",1,0,1993,1377,720,657,1155,551,604,0.839,0.839,0.839,17586,745.768,528,940,0.682643427741467
"1578",131496,"GEORGETOWN UNIVERSITY",1,0,1995,1403,742,661,1207,568,639,0.861,0.86,0.859,19402,822.65,553,973,0.693513898788311
"1579",131496,"GEORGETOWN UNIVERSITY",1,0,1996,1408,760,648,1256,569,687,0.904,0.892,0.878,20388,863.097,576,1020,0.724431818181818
"1580",131496,"GEORGETOWN UNIVERSITY",1,0,1997,1394,757,637,1247,561,686,0.906,0.895,0.881,21405,837.388,616,978,0.701578192252511
"1581",131496,"GEORGETOWN UNIVERSITY",1,0,1998,1470,810,660,1302,581,721,0.89,0.886,0.88,22446,854.905,617,1036,0.704761904761905
"1582",131496,"GEORGETOWN UNIVERSITY",1,0,1999,1474,802,672,1299,587,712,0.888,0.881,0.874,23088,889.587,622,1028,0.697421981004071
"1583",131496,"GEORGETOWN UNIVERSITY",1,0,2000,1469,789,680,1327,603,724,0.918,0.903,0.887,23952,545.138,634,1064,0.72430224642614
"1584",131496,"GEORGETOWN UNIVERSITY",1,0,2001,1482,757,725,1339,648,691,0.913,0.904,0.894,25152,540.712,646,1066,0.719298245614035
"1585",131496,"GEORGETOWN UNIVERSITY",1,0,2002,1477,795,682,1324,608,716,0.901,0.896,0.891,26544,584.273361,746,1042,0.705484089370345
"1586",131496,"GEORGETOWN UNIVERSITY",1,0,2003,1504,827,677,1321,575,746,0.902,0.878,0.849,27864,639.27,780,970,0.644946808510638
"1587",131496,"GEORGETOWN UNIVERSITY",1,0,2004,1523,855,668,1358,574,784,0.917,0.892,0.859,29808,680.496,821,1055,0.692711753118844
"1588",131496,"Georgetown University",1,0,2005,1530,774,756,1378,669,709,0.916,0.901,0.885,31656,711.847,836,1007,0.658169934640523
"1589",131496,"Georgetown University",1,0,2006,1588,877,711,1419,630,789,0.9,0.894,0.886,33552,744.101,875,1047,0.659319899244333
"1590",131496,"Georgetown University",1,0,2007,1577,864,713,1387,616,771,0.892,0.88,0.864,35568,818.381,915,1083,0.686746987951807
"1591",131496,"Georgetown University",1,0,2008,1571,822,749,1430,665,765,0.931,0.91,0.888,37536,890.08,943,1099,0.6995544239338
"1592",131496,"Georgetown University",1,0,2009,1550,861,689,1389,601,788,0.915,0.896,0.872,38616,937.521,980,1027,0.66258064516129
"1593",131496,"Georgetown University",1,0,2010,1569,859,710,1414,623,791,0.921,0.901,0.877,39768,974.494,966,1016,0.647546207775653
"1594",131520,"HOWARD UNIVERSITY",1,0,1991,1089,687,402,261,64,197,0.287,0.24,0.159,6438,458.204544,820,3,0.00275482093663912
"1595",131520,"HOWARD UNIVERSITY",1,0,1992,1264,797,467,264,70,194,0.243,0.209,0.15,6981,461.85769,825,3,0.00237341772151899
"1596",131520,"HOWARD UNIVERSITY",1,0,1993,1492,951,541,352,88,264,0.278,0.236,0.163,7535,563.779917,891,0,0
"1597",131520,"HOWARD UNIVERSITY",1,0,1995,834,540,294,438,117,321,0.594,0.525,0.398,8105,605.034512,723,1,0.00119904076738609
"1598",131520,"HOWARD UNIVERSITY",1,0,1996,1002,648,354,463,126,337,0.52,0.462,0.356,8725,551.302333,809,1,0.000998003992015968
"1599",131520,"HOWARD UNIVERSITY",1,0,1997,1098,715,383,402,98,304,0.425,0.366,0.256,8985,509.244147,873,3,0.00273224043715847
"1600",131520,"HOWARD UNIVERSITY",1,0,1998,1244,831,413,469,103,366,0.44,0.377,0.249,9155,535.250342,849,0,0
"1601",131520,"HOWARD UNIVERSITY",1,0,1999,937,632,305,405,99,306,0.484,0.432,0.325,8925,599.148295,865,2,0.00213447171824973
"1602",131520,"HOWARD UNIVERSITY",1,0,2000,1355,909,446,624,145,479,0.527,0.461,0.325,9190,635.548,922,6,0.0044280442804428
"1603",131520,"HOWARD UNIVERSITY",1,0,2001,1344,900,444,680,185,495,0.55,0.506,0.417,9515,642.609,979,0,0
"1604",131520,"HOWARD UNIVERSITY",1,0,2002,1366,931,435,621,125,496,0.533,0.455,0.287,9515,657.273,810,2,0.00146412884333821
"1605",131520,"HOWARD UNIVERSITY",1,0,2003,1446,992,454,679,155,524,0.528,0.47,0.341,10130,676.498,836,1,0.000691562932226833
"1606",131520,"HOWARD UNIVERSITY",1,0,2004,1445,987,458,691,151,540,0.547,0.478,0.33,10840,716.631,842,2,0.0013840830449827
"1607",131520,"Howard University",1,0,2005,1410,944,466,635,166,469,0.497,0.45,0.356,11490,726.605,859,3,0.00212765957446809
"1608",131520,"Howard University",1,0,2006,1512,1022,490,629,155,474,0.464,0.416,0.316,12180,737.797,1177,0,0
"1609",131520,"Howard University",1,0,2007,1451,1028,423,574,129,445,0.433,0.396,0.305,13215,793.362,1034,0,0
"1610",131520,"Howard University",1,0,2008,1477,1004,473,629,133,496,0.494,0.426,0.281,14205,834.328,807,0,0
"1611",131520,"Howard University",1,0,2009,1600,1097,503,633,144,489,0.446,0.396,0.286,15270,1051.876,955,0,0
"1612",131520,"Howard University",1,0,2010,1464,1034,430,571,122,449,0.434,0.39,0.284,17100,903.5,676,0,0
"1613",132471,"BARRY UNIVERSITY",1,0,1991,301,179,122,85,34,51,0.285,0.282,0.279,9793,39.444381,188,122,0.40531561461794
"1614",132471,"BARRY UNIVERSITY",1,0,1992,265,146,119,80,28,52,0.356,0.302,0.235,10180,44.689633,195,129,0.486792452830189
"1615",132471,"BARRY UNIVERSITY",1,0,1993,232,143,89,77,19,58,0.406,0.332,0.213,11030,57.433438,215,111,0.478448275862069
"1616",132471,"BARRY UNIVERSITY",1,0,1995,177,103,74,46,10,36,0.35,0.26,0.135,12110,61.105119,245,71,0.401129943502825
"1617",132471,"BARRY UNIVERSITY",1,0,1996,177,101,76,40,16,24,0.238,0.226,0.211,12790,66.640852,238,70,0.395480225988701
"1618",132471,"BARRY UNIVERSITY",1,0,1997,176,112,64,58,18,40,0.357,0.33,0.281,13460,55.773125,248,64,0.363636363636364
"1619",132471,"BARRY UNIVERSITY",1,0,1998,393,249,144,82,20,62,0.249,0.209,0.139,14790,65.228266,254,133,0.338422391857506
"1620",132471,"BARRY UNIVERSITY",1,0,1999,398,251,147,9,1,8,0.032,0.023,0.007,15530,71.855426,267,123,0.309045226130653
"1621",132471,"BARRY UNIVERSITY",1,0,2000,401,258,143,70,18,52,0.202,0.175,0.126,15530,85.930472,296.5,120,0.29925187032419
"1622",132471,"BARRY UNIVERSITY",1,0,2001,431,264,167,101,32,69,0.261,0.234,0.192,17500,94.248373,326,148,0.34338747099768
"1623",132471,"BARRY UNIVERSITY",1,0,2002,446,273,173,110,34,76,0.278,0.247,0.197,18900,108.609981,334,162,0.36322869955157
"1624",132471,"BARRY UNIVERSITY",1,0,2003,517,336,181,91,33,58,0.173,0.176,0.182,20320,116.246649,342,190,0.367504835589942
"1625",132471,"BARRY UNIVERSITY",1,0,2004,553,349,204,101,29,72,0.206,0.183,0.142,21350,118.228736,353,160,0.289330922242315
"1626",132471,"Barry University",1,0,2005,563,356,207,117,35,82,0.23,0.208,0.169,22430,125.508712,357,209,0.371225577264654
"1627",132471,"Barry University",1,0,2006,387,255,132,82,24,58,0.228,0.212,0.182,24000,132.102308,340,96,0.248062015503876
"1628",132471,"Barry University",1,0,2007,472,316,156,102,28,74,0.234,0.216,0.179,24500,137.808492,315,117,0.247881355932203
"1629",132471,"Barry University",1,0,2008,584,400,184,120,34,86,0.215,0.205,0.185,25500,134.588154,325,111,0.190068493150685
"1630",132471,"Barry University",1,0,2009,648,433,215,102,25,77,0.178,0.157,0.116,26400,139.035915,341,88,0.135802469135802
"1631",132471,"Barry University",1,0,2010,625,403,222,98,32,66,0.164,0.157,0.144,27200,146.715626,422,73,0.1168
"1632",132602,"BETHUNE COOKMAN COLLEGE",1,0,1991,619,348,271,134,25,109,0.313,0.216,0.092,4835,27.451481,122,4,0.00646203554119548
"1633",132602,"BETHUNE COOKMAN COLLEGE",1,0,1992,597,326,271,99,29,70,0.215,0.166,0.107,4965,30.730046,123,4,0.0067001675041876
"1634",132602,"BETHUNE COOKMAN COLLEGE",1,0,1993,543,291,252,100,28,72,0.247,0.184,0.111,5165,31.321708,125,4,0.00736648250460405
"1635",132602,"BETHUNE COOKMAN COLLEGE",1,0,1995,729,393,336,106,31,75,0.191,0.145,0.092,6458,31.275504,126,1,0.00137174211248285
"1636",132602,"BETHUNE COOKMAN COLLEGE",1,0,1996,575,322,253,93,20,73,0.227,0.162,0.079,6780,36.702346,128,0,0
"1637",132602,"BETHUNE COOKMAN COLLEGE",1,0,1997,749,388,361,77,25,52,0.134,0.103,0.069,7280,28.062388,130,1,0.00133511348464619
"1638",132602,"BETHUNE COOKMAN COLLEGE",1,0,1998,623,316,307,97,24,73,0.231,0.156,0.078,8047,35.05529,133,10,0.0160513643659711
"1639",132602,"BETHUNE COOKMAN COLLEGE",1,0,1999,677,360,317,134,36,98,0.272,0.198,0.114,8560,36.077863,132,5,0.00738552437223043
"1640",132602,"BETHUNE COOKMAN COLLEGE",1,0,2000,833,478,355,105,26,79,0.165,0.126,0.073,8988,37.868112,135,7,0.00840336134453781
"1641",132602,"BETHUNE COOKMAN COLLEGE",1,0,2001,720,386,334,91,31,60,0.155,0.126,0.093,9617,42.452761,138,13,0.0180555555555556
"1642",132602,"BETHUNE COOKMAN COLLEGE",1,0,2002,607,351,256,161,59,102,0.291,0.265,0.23,9810,43.459963,136,10,0.0164744645799012
"1643",132602,"BETHUNE COOKMAN COLLEGE",1,0,2003,827,492,335,112,24,88,0.179,0.135,0.072,10106,45.020787,141,7,0.00846432889963724
"1644",132602,"BETHUNE COOKMAN COLLEGE",1,0,2004,818,503,315,118,29,89,0.177,0.144,0.092,10610,48.25973,150,5,0.00611246943765281
"1645",132602,"Bethune Cookman College",1,0,2005,913,525,388,140,52,88,0.168,0.153,0.134,11140,49.287771,147,9,0.00985761226725082
"1646",132602,"Bethune Cookman College",1,0,2006,901,497,404,142,64,78,0.157,0.158,0.158,11792,50.060341,161,12,0.0133185349611543
"1647",132602,"Bethune-Cookman University",1,0,2007,821,511,310,136,44,92,0.18,0.166,0.142,12382,54.839892,162,5,0.00609013398294762
"1648",132602,"Bethune-Cookman University",1,0,2008,719,478,241,198,38,160,0.335,0.275,0.158,12876,57.628416,204,6,0.00834492350486787
"1649",132602,"Bethune-Cookman University",1,0,2009,917,551,366,233,76,157,0.285,0.254,0.208,12936,63.393489,202,6,0.00654307524536532
"1650",132602,"Bethune-Cookman University",1,0,2010,924,579,345,132,32,100,0.173,0.143,0.093,13452,60.938667,197,9,0.00974025974025974
"1651",132903,"UNIVERSITY OF CENTRAL FLORIDA",1,0,1991,1577,813,764,332,89,243,0.299,0.211,0.116,1523,148.62821,597,1026,0.650602409638554
"1652",132903,"UNIVERSITY OF CENTRAL FLORIDA",1,0,1992,1405,745,660,330,92,238,0.32,0.235,0.139,1713,151.508648,585,995,0.708185053380783
"1653",132903,"UNIVERSITY OF CENTRAL FLORIDA",1,0,1993,1882,955,927,432,144,288,0.302,0.23,0.155,1756,158.277754,593,1365,0.72529224229543
"1654",132903,"UNIVERSITY OF CENTRAL FLORIDA",1,0,1995,2411,1295,1116,661,217,444,0.343,0.274,0.194,1840,187.902863,566,1900,0.788054749066777
"1655",132903,"UNIVERSITY OF CENTRAL FLORIDA",1,0,1996,2579,1316,1263,672,219,453,0.344,0.261,0.173,1924,202.769647,685,1966,0.762310973245444
"1656",132903,"UNIVERSITY OF CENTRAL FLORIDA",1,0,1997,2839,1510,1329,785,265,520,0.344,0.277,0.199,2024,219.510899,662,2171,0.764705882352941
"1657",132903,"UNIVERSITY OF CENTRAL FLORIDA",1,0,1998,3792,1932,1860,1097,387,710,0.368,0.289,0.208,2121,255.098347,777,2959,0.780327004219409
"1658",132903,"UNIVERSITY OF CENTRAL FLORIDA",1,0,1999,4267,2256,2011,1298,425,873,0.387,0.304,0.211,2296,286.61689,874,3177,0.744551206936958
"1659",132903,"UNIVERSITY OF CENTRAL FLORIDA",1,0,2000,4558,2436,2122,1384,436,948,0.389,0.304,0.205,1554,310.136223,903,3329,0.73036419482229
"1660",132903,"UNIVERSITY OF CENTRAL FLORIDA",1,0,2001,4913,2621,2292,1529,529,1000,0.382,0.311,0.231,1670,364.083698,932,3537,0.719926725015266
"1661",132903,"UNIVERSITY OF CENTRAL FLORIDA",1,0,2002,5330,2851,2479,1736,578,1158,0.406,0.326,0.233,1753,359.140562,1004,3824,0.717448405253283
"1662",132903,"UNIVERSITY OF CENTRAL FLORIDA",1,0,2003,5653,2956,2697,1923,673,1250,0.423,0.34,0.25,1902,434.622144,1068,3910,0.691668140810189
"1663",132903,"UNIVERSITY OF CENTRAL FLORIDA",1,0,2004,5710,3041,2669,1986,723,1263,0.415,0.348,0.271,2045,482.210908,1120,4020,0.704028021015762
"1664",132903,"University of Central Florida",1,0,2005,6041,3216,2825,2025,720,1305,0.406,0.335,0.255,2147,529.373343,1134,4096,0.678033438172488
"1665",132903,"University of Central Florida",1,0,2006,6389,3389,3000,2257,754,1503,0.444,0.353,0.251,2211,574.74022,1168,4542,0.710909375489122
"1666",132903,"University of Central Florida",1,0,2007,6350,3310,3040,2277,827,1450,0.438,0.359,0.272,2211,624.994652,1158,4398,0.69259842519685
"1667",132903,"University of Central Florida",1,0,2008,6139,3283,2856,2464,867,1597,0.486,0.401,0.304,2531,661.810938,1139,4150,0.676005864147255
"1668",132903,"University of Central Florida",1,0,2009,6251,3342,2909,2529,868,1661,0.497,0.405,0.298,2910,695.121732,1097,4258,0.681171012637978
"1669",132903,"University of Central Florida",1,0,2010,6028,3179,2849,2407,859,1548,0.487,0.399,0.302,3347,711.086355,1122,3805,0.63122096881221
"1670",133492,"ECKERD COLLEGE",1,0,1991,336,187,149,186,80,106,0.567,0.554,0.537,12900,29.2314,84,278,0.827380952380952
"1671",133492,"ECKERD COLLEGE",1,0,1992,348,182,166,187,92,95,0.522,0.537,0.554,13725,32.1892,86,279,0.801724137931034
"1672",133492,"ECKERD COLLEGE",1,0,1993,364,185,179,201,103,98,0.53,0.552,0.575,14770,36.5442,87,303,0.832417582417582
"1673",133492,"ECKERD COLLEGE",1,0,1995,334,184,150,199,83,116,0.63,0.596,0.553,15975,38.6276,92,278,0.832335329341317
"1674",133492,"ECKERD COLLEGE",1,0,1996,429,260,169,242,84,158,0.608,0.564,0.497,16625,39.4907,92,341,0.794871794871795
"1675",133492,"ECKERD COLLEGE",1,0,1997,386,230,156,230,88,142,0.617,0.596,0.564,17130,34.5735,96,310,0.803108808290155
"1676",133492,"ECKERD COLLEGE",1,0,1998,407,227,180,234,99,135,0.595,0.575,0.55,17685,38.2242,91,330,0.810810810810811
"1677",133492,"ECKERD COLLEGE",1,0,1999,403,210,193,232,101,131,0.624,0.576,0.523,18025,40.1158,96,326,0.80893300248139
"1678",133492,"ECKERD COLLEGE",1,0,2000,408,223,185,215,95,120,0.538,0.527,0.514,18565,44.2505,96.5,315,0.772058823529412
"1679",133492,"ECKERD COLLEGE",1,0,2001,424,241,183,225,83,142,0.589,0.531,0.454,19870,45.060183,97,345,0.813679245283019
"1680",133492,"ECKERD COLLEGE",1,0,2002,442,239,203,261,117,144,0.603,0.59,0.576,21262,45.427818,94,332,0.751131221719457
"1681",133492,"ECKERD COLLEGE",1,0,2003,434,248,186,250,101,149,0.601,0.576,0.543,22538,46.754664,103,338,0.778801843317972
"1682",133492,"ECKERD COLLEGE",1,0,2004,471,272,199,297,119,178,0.654,0.631,0.598,24116,49.623376,106,372,0.789808917197452
"1683",133492,"Eckerd College",1,0,2005,501,297,204,275,102,173,0.583,0.549,0.5,25804,55.41758,112,408,0.81437125748503
"1684",133492,"Eckerd College",1,0,2006,544,315,229,308,113,195,0.619,0.566,0.493,27352,58.152811,114,447,0.821691176470588
"1685",133492,"Eckerd College",1,0,2007,535,319,216,315,127,188,0.589,0.589,0.588,28860,62.188144,113,432,0.807476635514019
"1686",133492,"Eckerd College",1,0,2008,487,285,202,283,116,167,0.586,0.581,0.574,30304,64.533369,112,385,0.790554414784394
"1687",133492,"Eckerd College",1,0,2009,504,300,204,301,122,179,0.597,0.597,0.598,31818,63.633304,115,413,0.819444444444444
"1688",133492,"Eckerd College",1,0,2010,496,300,196,304,117,187,0.623,0.613,0.597,32932,63.524219,114,384,0.774193548387097
"1689",133553,"EMBRY-RIDDLE AERONAUTICAL UNIVERSITY",1,0,1991,875,134,741,190,158,32,0.239,0.217,0.213,6310,86.648269,312,730,0.834285714285714
"1690",133553,"EMBRY-RIDDLE AERONAUTICAL UNIVERSITY",1,0,1992,801,132,669,190,149,41,0.311,0.237,0.223,6810,93.150731,311,691,0.862671660424469
"1691",133553,"EMBRY-RIDDLE AERONAUTICAL UNIVERSITY",1,0,1993,799,128,671,154,122,32,0.25,0.193,0.182,7370,95.802626,299,688,0.86107634543179
"1692",133553,"EMBRY-RIDDLE AERONAUTICAL UNIVERSITY",1,0,1995,665,100,565,128,105,23,0.23,0.192,0.186,8280,98.554063,274,498,0.748872180451128
"1693",133553,"EMBRY-RIDDLE AERONAUTICAL UNIVERSITY",1,0,1996,711,95,616,132,119,13,0.137,0.186,0.193,8740,104.659523,252,476,0.669479606188467
"1694",133553,"EMBRY-RIDDLE AERONAUTICAL UNIVERSITY",1,0,1997,1020,136,884,213,184,29,0.213,0.209,0.208,9230,104.159,248,689,0.675490196078431
"1695",133553,"EMBRY-RIDDLE AERONAUTICAL UNIVERSITY",1,0,1998,934,128,806,279,230,49,0.383,0.299,0.285,9920,113.799,247,644,0.689507494646681
"1696",133553,"EMBRY RIDDLE AERONAUTICAL UNIVERSITY",1,0,1999,939,151,788,305,245,60,0.397,0.325,0.311,10100,122.652,247,685,0.729499467518637
"1697",133553,"EMBRY RIDDLE AERONAUTICAL UNIVERSITY",1,0,2000,797,124,673,280,225,55,0.444,0.351,0.334,14500,136.639,208.5,603,0.756587202007528
"1698",133553,"EMBRY RIDDLE AERONAUTICAL UNIVERSITY-DAYTONA BEACH",1,0,2001,1013,159,854,338,277,61,0.384,0.334,0.324,15370,154.991,170,753,0.743336623889437
"1699",133553,"EMBRY RIDDLE AERONAUTICAL UNIVERSITY-DAYTONA BEACH",1,0,2002,872,148,724,315,244,71,0.48,0.361,0.337,17850,170.053,183,633,0.725917431192661
"1700",133553,"EMBRY RIDDLE AERONAUTICAL UNIVERSITY-DAYTONA BEACH",1,0,2003,1012,164,848,292,238,54,0.329,0.289,0.281,20700,188.076,183,687,0.678853754940711
"1701",133553,"EMBRY RIDDLE AERONAUTICAL UNIVERSITY-DAYTONA BEACH",1,0,2004,933,139,794,282,231,51,0.367,0.302,0.291,21530,206.417,187,646,0.692390139335477
"1702",133553,"Embry Riddle Aeronautical University-Daytona Beach",1,0,2005,975,152,823,307,246,61,0.401,0.315,0.299,22820,217.057,191,656,0.672820512820513
"1703",133553,"Embry Riddle Aeronautical University-Daytona Beach",1,0,2006,1101,161,940,363,290,73,0.453,0.33,0.309,24420,234.425,198,713,0.647593097184378
"1704",133553,"Embry Riddle Aeronautical University-Daytona Beach",1,0,2007,1014,158,856,341,277,64,0.405,0.336,0.324,25400,240.198,210,650,0.641025641025641
"1705",133553,"Embry Riddle Aeronautical University-Daytona Beach",1,0,2008,1058,158,900,325,263,62,0.392,0.307,0.292,26420,250.665,214,667,0.630434782608696
"1706",133553,"Embry Riddle Aeronautical University-Daytona Beach",1,0,2009,853,134,719,265,203,62,0.463,0.311,0.282,27480,265.454,211,476,0.558030480656506
"1707",133553,"Embry Riddle Aeronautical University-Daytona Beach",1,0,2010,949,120,829,283,239,44,0.367,0.298,0.288,28560,260.447,222,574,0.604847207586934
"1708",133650,"FLORIDA AGRICULTURAL AND MECHANICAL UNIVERSITY",1,0,1991,1608,945,663,188,36,152,0.161,0.117,0.054,1545,94.541167,400,8,0.00497512437810945
"1709",133650,"FLORIDA AGRICULTURAL AND MECHANICAL UNIVERSITY",1,0,1992,1383,815,568,206,60,146,0.179,0.149,0.106,1749,102.597023,355,18,0.0130151843817787
"1710",133650,"FLORIDA AGRICULTURAL AND MECHANICAL UNIVERSITY",1,0,1993,1507,908,599,210,46,164,0.181,0.139,0.077,1829,110.952098,364,15,0.0099535500995355
"1711",133650,"FLORIDA AGRICULTURAL AND MECHANICAL UNIVERSITY",1,0,1995,1574,952,622,245,63,182,0.191,0.156,0.101,1848,135.948437,443,9,0.00571791613722999
"1712",133650,"FLORIDA AGRICULTURAL AND MECHANICAL UNIVERSITY",1,0,1996,1717,1017,700,281,83,198,0.195,0.164,0.119,1863,150.395571,446,16,0.0093185789167152
"1713",133650,"FLORIDA AGRICULTURAL AND MECHANICAL UNIVERSITY",1,0,1997,1947,1148,799,328,84,244,0.212,0.168,0.105,1970,189.715364,482,15,0.00770416024653313
"1714",133650,"FLORIDA AGRICULTURAL AND MECHANICAL UNIVERSITY",1,0,1998,2213,1294,919,385,120,265,0.205,0.174,0.131,2133,169.815703,435,7,0.00316312697695436
"1715",133650,"FLORIDA AGRICULTURAL AND MECHANICAL UNIVERSITY",1,0,1999,2205,1277,928,360,86,274,0.215,0.163,0.093,2325,191.754963,442,13,0.00589569160997732
"1716",133650,"FLORIDA AGRICULTURAL AND MECHANICAL UNIVERSITY",1,0,2000,2145,1263,882,415,99,316,0.25,0.193,0.112,1554,199.9037,465,17,0.00792540792540793
"1717",133650,"FLORIDA AGRICULTURAL AND MECHANICAL UNIVERSITY",1,0,2001,2243,1300,943,368,88,280,0.215,0.164,0.093,1670,215.531405,488,15,0.00668747213553277
"1718",133650,"FLORIDA AGRICULTURAL AND MECHANICAL UNIVERSITY",1,0,2002,2097,1249,848,280,77,203,0.162,0.134,0.091,1754,206.904316,490,14,0.00667620410109681
"1719",133650,"FLORIDA AGRICULTURAL AND MECHANICAL UNIVERSITY",1,0,2003,2403,1391,1012,289,79,210,0.151,0.12,0.078,1902,230.739,518,20,0.00832292967124428
"1720",133650,"FLORIDA AGRICULTURAL AND MECHANICAL UNIVERSITY",1,0,2004,2105,1242,863,268,73,195,0.157,0.127,0.085,2045,263.98403,548,49,0.0232779097387173
"1721",133650,"Florida Agricultural and Mechanical University",1,0,2005,1636,925,711,183,61,122,0.132,0.112,0.086,2148,270.573399,673,19,0.0116136919315403
"1722",133650,"Florida Agricultural and Mechanical University",1,0,2006,1614,925,689,156,36,120,0.13,0.097,0.052,2211,270.401329,658,27,0.016728624535316
"1723",133650,"Florida Agricultural and Mechanical University",1,0,2007,1853,1071,782,217,74,143,0.134,0.117,0.095,2211,267.848349,617,21,0.011332973556395
"1724",133650,"Florida Agricultural and Mechanical University",1,0,2008,2090,1196,894,254,79,175,0.146,0.122,0.088,2461,272.76917,637,31,0.0148325358851675
"1725",133650,"Florida Agricultural and Mechanical University",1,0,2009,2348,1421,927,267,88,179,0.126,0.114,0.095,2658,281.217819,623,23,0.00979557069846678
"1726",133650,"Florida Agricultural and Mechanical University",1,0,2010,2701,1636,1065,331,94,237,0.145,0.123,0.088,2870,284.306213,614,45,0.0166604961125509
"1727",133669,"FLORIDA ATLANTIC UNIVERSITY",1,0,1991,651,358,293,93,29,64,0.179,0.143,0.099,1350,112.311883,464,483,0.741935483870968
"1728",133669,"FLORIDA ATLANTIC UNIVERSITY",1,0,1992,795,417,378,115,43,72,0.173,0.145,0.114,1733,116.033074,530,607,0.763522012578616
"1729",133669,"FLORIDA ATLANTIC UNIVERSITY",1,0,1993,743,412,331,104,34,70,0.17,0.14,0.103,1791,124.391519,528,530,0.713324360699865
"1730",133669,"FLORIDA ATLANTIC UNIVERSITY",1,0,1995,901,504,397,162,51,111,0.22,0.18,0.128,1446,136.502085,535,581,0.644839067702553
"1731",133669,"FLORIDA ATLANTIC UNIVERSITY",1,0,1996,1001,551,450,155,57,98,0.178,0.155,0.127,1512,163.542156,538,693,0.692307692307692
"1732",133669,"FLORIDA ATLANTIC UNIVERSITY-BOCA RATON",1,0,1997,1174,669,505,161,54,107,0.16,0.137,0.107,1618,186.772567,575,777,0.661839863713799
"1733",133669,"FLORIDA ATLANTIC UNIVERSITY-BOCA RATON",1,0,1998,1309,773,536,196,56,140,0.181,0.15,0.104,1695,208.496801,618,847,0.647058823529412
"1734",133669,"FLORIDA ATLANTIC UNIVERSITY-BOCA RATON",1,0,1999,1423,860,563,201,56,145,0.169,0.141,0.099,2253,237.761107,657,928,0.652143359100492
"1735",133669,"FLORIDA ATLANTIC UNIVERSITY-BOCA RATON",1,0,2000,1818,988,830,254,89,165,0.167,0.14,0.107,1554,246.1541,669,1179,0.648514851485149
"1736",133669,"FLORIDA ATLANTIC UNIVERSITY-BOCA RATON",1,0,2001,1937,1120,817,292,85,207,0.185,0.151,0.104,1670,270.488842,681,1211,0.625193598347961
"1737",133669,"FLORIDA ATLANTIC UNIVERSITY-BOCA RATON",1,0,2002,1994,1102,892,323,115,208,0.189,0.162,0.129,1402,291.23382,689,1229,0.616349047141424
"1738",133669,"FLORIDA ATLANTIC UNIVERSITY-BOCA RATON",1,0,2003,2038,1143,895,335,109,226,0.198,0.164,0.122,1522,320.757203,731,1268,0.622178606476938
"1739",133669,"FLORIDA ATLANTIC UNIVERSITY-BOCA RATON",1,0,2004,2278,1231,1047,364,122,242,0.197,0.16,0.117,1636,343.691979,740,1397,0.613257243195786
"1740",133669,"Florida Atlantic University",1,0,2005,2080,1111,969,363,126,237,0.213,0.175,0.13,1717,399.393389,767,1324,0.636538461538461
"1741",133669,"Florida Atlantic University",1,0,2006,2193,1208,985,339,115,224,0.185,0.155,0.117,1769,358.391623,777,1328,0.605563155494756
"1742",133669,"Florida Atlantic University",1,0,2007,2563,1326,1237,388,150,238,0.18,0.151,0.121,1769,364.266868,797,1482,0.578228638314475
"1743",133669,"Florida Atlantic University",1,0,2008,2677,1407,1270,457,149,308,0.219,0.171,0.117,1968,394.77435,788,1533,0.572655958162122
"1744",133669,"Florida Atlantic University",1,0,2009,2447,1314,1133,487,156,331,0.252,0.199,0.138,2126,402.663152,779,1418,0.579485083776052
"1745",133669,"Florida Atlantic University",1,0,2010,2616,1359,1257,501,169,332,0.244,0.192,0.134,2296,416.626339,774,1425,0.544724770642202
"1746",133711,"FLAGLER COLLEGE",1,0,1991,290,169,121,133,50,83,0.491,0.459,0.413,4550,9.924229,59,273,0.941379310344828
"1747",133711,"FLAGLER COLLEGE",1,0,1992,299,169,130,125,43,82,0.485,0.418,0.331,4710,10.485905,74,273,0.91304347826087
"1748",133711,"FLAGLER COLLEGE",1,0,1993,338,193,145,147,59,88,0.456,0.435,0.407,4920,9.491341,44,309,0.914201183431953
"1749",133711,"FLAGLER COLLEGE",1,0,1995,355,217,138,143,45,98,0.452,0.403,0.326,5375,12.412258,51,334,0.940845070422535
"1750",133711,"FLAGLER COLLEGE",1,0,1996,355,217,138,143,45,98,0.452,0.403,0.326,5530,12.795854,52,334,0.940845070422535
"1751",133711,"FLAGLER COLLEGE",1,0,1997,424,272,152,176,55,121,0.445,0.415,0.362,5760,14.513937,53,403,0.950471698113208
"1752",133711,"FLAGLER COLLEGE",1,0,1998,418,285,133,182,58,124,0.435,0.435,0.436,5950,14.863592,59,391,0.935406698564593
"1753",133711,"FLAGLER COLLEGE",1,0,1999,419,267,152,186,61,125,0.468,0.444,0.401,6130,16.140968,60,394,0.940334128878282
"1754",133711,"FLAGLER COLLEGE",1,0,2000,496,315,181,206,72,134,0.425,0.415,0.398,6320,18.287966,62,453,0.913306451612903
"1755",133711,"FLAGLER COLLEGE",1,0,2001,407,253,154,185,59,126,0.498,0.455,0.383,6550,21.236217,64,377,0.926289926289926
"1756",133711,"FLAGLER COLLEGE",1,0,2002,481,308,173,231,70,161,0.523,0.48,0.405,6870,23.42346,73,441,0.916839916839917
"1757",133711,"FLAGLER COLLEGE",1,0,2003,556,318,238,220,84,136,0.428,0.396,0.353,7410,25.017525,79,495,0.890287769784173
"1758",133711,"FLAGLER COLLEGE",1,0,2004,500,296,204,250,98,152,0.514,0.5,0.48,8000,27.103093,69,454,0.908
"1759",133711,"Flagler College",1,0,2005,459,283,176,216,77,139,0.491,0.471,0.438,8600,26.667664,73,426,0.928104575163399
"1760",133711,"Flagler College",1,0,2006,463,284,179,235,77,158,0.556,0.508,0.43,9450,30.507675,76,208,0.449244060475162
"1761",133711,"Flagler College",1,0,2007,531,333,198,246,85,161,0.484,0.463,0.429,11810,34.366384,87,290,0.546139359698682
"1762",133711,"Flagler College",1,0,2008,645,365,280,312,116,196,0.537,0.484,0.414,12520,41.942325,91,550,0.852713178294574
"1763",133711,"Flagler College",1,0,2009,564,337,227,281,94,187,0.555,0.498,0.414,13300,45.954558,94,480,0.851063829787234
"1764",133711,"Flagler College-St Augustine",1,0,2010,612,347,265,281,98,183,0.527,0.459,0.37,13860,48.494465,96,490,0.800653594771242
"1765",133881,"FLORIDA INSTITUTE OF TECHNOLOGY",0,1,1991,350,78,272,98,67,31,0.397,0.28,0.246,10752,49.743997,232,256,0.731428571428571
"1766",133881,"FLORIDA INSTITUTE OF TECHNOLOGY",0,1,1992,457,121,336,147,99,48,0.397,0.322,0.295,11817,52.821214,224,321,0.702407002188184
"1767",133881,"FLORIDA INSTITUTE OF TECHNOLOGY",1,0,1993,358,109,249,93,65,28,0.257,0.26,0.261,13035,57.751728,232,247,0.689944134078212
"1768",133881,"FLORIDA INSTITUTE OF TECHNOLOGY",1,0,1995,370,111,259,113,70,43,0.387,0.305,0.27,14111,60.248108,171,237,0.640540540540541
"1769",133881,"FLORIDA INSTITUTE OF TECHNOLOGY",1,0,1996,491,149,342,171,101,70,0.47,0.348,0.295,15060,62.405159,177,314,0.639511201629328
"1770",133881,"FLORIDA INSTITUTE OF TECHNOLOGY-MELBOURNE",1,0,1997,367,112,255,128,84,44,0.393,0.349,0.329,15510,59.386221,168,216,0.588555858310627
"1771",133881,"FLORIDA INSTITUTE OF TECHNOLOGY-MELBOURNE",1,0,1998,461,145,316,173,108,65,0.448,0.375,0.342,16500,53.660441,170,307,0.665943600867679
"1772",133881,"FLORIDA INSTITUTE OF TECHNOLOGY-MELBOURNE",1,0,1999,402,116,286,139,95,44,0.379,0.346,0.332,17300,54.416983,171,259,0.644278606965174
"1773",133881,"FLORIDA INSTITUTE OF TECHNOLOGY-MELBOURNE",1,0,2000,531,156,375,214,145,69,0.442,0.403,0.387,18450,58.889125,179.5,355,0.668549905838041
"1774",133881,"FLORIDA INSTITUTE OF TECHNOLOGY-MELBOURNE",1,0,2001,544,153,391,203,128,75,0.49,0.373,0.327,19700,81.020339,188,332,0.610294117647059
"1775",133881,"FLORIDA INSTITUTE OF TECHNOLOGY-MELBOURNE",1,0,2002,518,139,379,218,142,76,0.547,0.421,0.375,20900,88.049971,202,306,0.590733590733591
"1776",133881,"FLORIDA INSTITUTE OF TECHNOLOGY-MELBOURNE",1,0,2003,549,174,375,219,136,83,0.477,0.399,0.363,22600,93.358965,218,326,0.593806921675774
"1777",133881,"FLORIDA INSTITUTE OF TECHNOLOGY-MELBOURNE",1,0,2004,551,181,370,218,132,86,0.475,0.396,0.357,23730,93.698474,216,337,0.611615245009074
"1778",133881,"Florida Institute of Technology-Melbourne",1,0,2005,603,154,449,242,172,70,0.454,0.401,0.383,25150,105.17125,210,394,0.653399668325041
"1779",133881,"Florida Institute of Technology",1,0,2006,597,160,437,222,144,78,0.488,0.372,0.33,27540,90.184336,213,280,0.469011725293132
"1780",133881,"Florida Institute of Technology",1,0,2007,675,186,489,261,170,91,0.489,0.387,0.348,28920,94.085294,226,305,0.451851851851852
"1781",133881,"Florida Institute of Technology",1,0,2008,635,194,441,247,152,95,0.49,0.389,0.345,29940,102.877319,232,384,0.604724409448819
"1782",133881,"Florida Institute of Technology",1,0,2009,538,145,393,222,144,78,0.538,0.413,0.366,31020,115.339646,240,304,0.565055762081784
"1783",133881,"Florida Institute of Technology",1,0,2010,489,138,351,220,142,78,0.565,0.45,0.405,31734,125.400988,238,298,0.609406952965235
"1784",133951,"FLORIDA INTERNATIONAL UNIVERSITY",1,0,1991,1021,600,421,198,62,136,0.227,0.194,0.147,1478,141.265096,782,242,0.237022526934378
"1785",133951,"FLORIDA INTERNATIONAL UNIVERSITY",1,0,1992,1124,625,499,197,64,133,0.213,0.175,0.128,1701,146.086956,758,266,0.236654804270463
"1786",133951,"FLORIDA INTERNATIONAL UNIVERSITY",1,0,1993,1306,751,555,216,65,151,0.201,0.165,0.117,1757,163.429754,767,223,0.170750382848392
"1787",133951,"FLORIDA INTERNATIONAL UNIVERSITY",1,0,1995,1752,1003,749,270,74,196,0.195,0.154,0.099,1791,194.301454,806,324,0.184931506849315
"1788",133951,"FLORIDA INTERNATIONAL UNIVERSITY",1,0,1996,1846,1067,779,314,87,227,0.213,0.17,0.112,1875,214.890568,813,298,0.161430119176598
"1789",133951,"FLORIDA INTERNATIONAL UNIVERSITY",1,0,1997,1987,1144,843,352,91,261,0.228,0.177,0.108,2035,238.101745,831,371,0.186713638651233
"1790",133951,"FLORIDA INTERNATIONAL UNIVERSITY",1,0,1998,2227,1298,929,430,117,313,0.241,0.193,0.126,2154,266.211766,864,423,0.189941625505164
"1791",133951,"FLORIDA INTERNATIONAL UNIVERSITY",1,0,1999,2482,1460,1022,525,141,384,0.263,0.212,0.138,2272,290.073995,863,451,0.181708299758259
"1792",133951,"FLORIDA INTERNATIONAL UNIVERSITY",1,0,2000,2582,1511,1071,507,148,359,0.238,0.196,0.138,1554,311.314151,827.5,523,0.202556158017041
"1793",133951,"FLORIDA INTERNATIONAL UNIVERSITY",1,0,2001,2457,1364,1093,527,145,382,0.28,0.214,0.133,1670,354.523168,792,490,0.199430199430199
"1794",133951,"FLORIDA INTERNATIONAL UNIVERSITY",1,0,2002,2801,1617,1184,566,176,390,0.241,0.202,0.149,1754,385.7671,714,535,0.191003213138165
"1795",133951,"FLORIDA INTERNATIONAL UNIVERSITY",1,0,2003,3038,1756,1282,597,185,412,0.235,0.197,0.144,1902,411.724271,745,570,0.187623436471363
"1796",133951,"FLORIDA INTERNATIONAL UNIVERSITY",1,0,2004,3370,1906,1464,647,198,449,0.236,0.192,0.135,2045,443.419642,769,551,0.163501483679525
"1797",133951,"Florida International University",1,0,2005,3967,2261,1706,634,188,446,0.197,0.16,0.11,2147,465.435,757,641,0.161583060247038
"1798",133951,"Florida International University",1,0,2006,3889,2099,1790,736,243,493,0.235,0.189,0.136,2211,506.644879,759,626,0.160966829519157
"1799",133951,"Florida International University",1,0,2007,3230,1707,1523,661,209,452,0.265,0.205,0.137,2211,532.179535,852,512,0.158513931888545
"1800",133951,"Florida International University",1,0,2008,3106,1642,1464,732,234,498,0.303,0.236,0.16,2565,571.39945,854,459,0.147778493238892
"1801",133951,"Florida International University",1,0,2009,2946,1615,1331,828,278,550,0.341,0.281,0.209,2864,599.354536,871,403,0.136795655125594
"1802",133951,"Florida International University",1,0,2010,3752,2079,1673,931,280,651,0.313,0.248,0.167,3200,631.006253,857,424,0.113006396588486
"1803",134079,"FLORIDA SOUTHERN COLLEGE",1,0,1991,378,210,168,147,53,94,0.448,0.389,0.315,6080,24.49916,99,346,0.915343915343915
"1804",134079,"FLORIDA SOUTHERN COLLEGE",1,0,1992,343,200,143,147,45,102,0.51,0.429,0.315,7080,25.559905,96,311,0.906705539358601
"1805",134079,"FLORIDA SOUTHERN COLLEGE",1,0,1993,375,207,168,138,58,80,0.386,0.368,0.345,7660,25.320721,96,330,0.88
"1806",134079,"FLORIDA SOUTHERN COLLEGE",1,0,1995,527,302,225,230,76,154,0.51,0.436,0.338,8630,28.523792,90,438,0.83111954459203
"1807",134079,"FLORIDA SOUTHERN COLLEGE",1,0,1996,458,287,171,224,67,157,0.547,0.489,0.392,9970,32.866152,92,384,0.838427947598253
"1808",134079,"FLORIDA SOUTHERN COLLEGE",1,0,1997,428,270,158,196,67,129,0.478,0.458,0.424,10604,29.331773,94,364,0.850467289719626
"1809",134079,"FLORIDA SOUTHERN COLLEGE",1,0,1998,440,286,154,199,55,144,0.504,0.452,0.357,11274,30.356835,98,380,0.863636363636364
"1810",134079,"FLORIDA SOUTHERN COLLEGE",1,0,1999,425,267,158,173,55,118,0.442,0.407,0.348,11650,32.689457,101,383,0.901176470588235
"1811",134079,"FLORIDA SOUTHERN COLLEGE",1,0,2000,506,306,200,209,62,147,0.48,0.413,0.31,12750,36.015103,104,419,0.828063241106719
"1812",134079,"FLORIDA SOUTHERN COLLEGE",1,0,2001,515,323,192,205,66,139,0.43,0.398,0.344,13700,38.654787,107,434,0.842718446601942
"1813",134079,"FLORIDA SOUTHERN COLLEGE",1,0,2002,491,322,169,184,41,143,0.444,0.375,0.243,15778,39.899215,107,414,0.843177189409369
"1814",134079,"FLORIDA SOUTHERN COLLEGE",1,0,2003,436,250,186,163,51,112,0.448,0.374,0.274,17192,40.782876,109,354,0.811926605504587
"1815",134079,"FLORIDA SOUTHERN COLLEGE",1,0,2004,553,342,211,227,70,157,0.459,0.41,0.332,17860,41.93105,114,468,0.84629294755877
"1816",134079,"Florida Southern College",1,0,2005,462,274,188,190,60,130,0.475,0.411,0.319,18765,44.926193,112,386,0.835497835497836
"1817",134079,"Florida Southern College",1,0,2006,420,267,153,198,59,139,0.521,0.471,0.386,19700,43.665351,110,342,0.814285714285714
"1818",134079,"Florida Southern College",1,0,2007,423,259,164,199,77,122,0.471,0.47,0.47,20690,46.830703,106,333,0.787234042553192
"1819",134079,"Florida Southern College",1,0,2008,497,304,193,277,102,175,0.576,0.557,0.528,21620,46.879481,107,414,0.832997987927565
"1820",134079,"Florida Southern College",1,0,2009,557,319,238,257,91,166,0.52,0.461,0.382,22270,51.165303,100,430,0.771992818671454
"1821",134079,"Florida Southern College",1,0,2010,602,357,245,314,119,195,0.546,0.522,0.486,23578,52.434809,102,452,0.750830564784053
"1822",134097,"FLORIDA STATE UNIVERSITY",1,0,1991,2899,1702,1197,1131,410,721,0.424,0.39,0.343,1492,322.394422,1065,2346,0.809244567092101
"1823",134097,"FLORIDA STATE UNIVERSITY",1,0,1992,3313,1949,1364,1259,378,881,0.452,0.38,0.277,1679,327.816428,1047,2730,0.824026562028373
"1824",134097,"FLORIDA STATE UNIVERSITY",1,0,1993,3603,2132,1471,1424,480,944,0.443,0.395,0.326,1780,345.014235,1038,2914,0.808770469053566
"1825",134097,"FLORIDA STATE UNIVERSITY",1,0,1995,3826,2210,1616,1534,530,1004,0.454,0.401,0.328,1798,398.115442,1011,2983,0.779665446941976
"1826",134097,"FLORIDA STATE UNIVERSITY",1,0,1996,3999,2329,1670,1583,536,1047,0.45,0.396,0.321,1882,411.486095,982,3023,0.755938984746187
"1827",134097,"FLORIDA STATE UNIVERSITY",1,0,1997,4491,2525,1966,1822,606,1216,0.482,0.406,0.308,1988,429.783221,971,3408,0.758851035404142
"1828",134097,"FLORIDA STATE UNIVERSITY",1,0,1998,5066,2932,2134,2143,705,1438,0.49,0.423,0.33,2084,446.582774,981,3862,0.762337149624951
"1829",134097,"FLORIDA STATE UNIVERSITY",1,0,1999,5078,2934,2144,2244,793,1451,0.495,0.442,0.37,2195,493.5209,1007,3892,0.766443481685703
"1830",134097,"FLORIDA STATE UNIVERSITY",1,0,2000,5557,3294,2263,2481,811,1670,0.507,0.446,0.358,1554,520.718227,1045.5,4188,0.753644052546338
"1831",134097,"FLORIDA STATE UNIVERSITY",1,0,2001,5681,3318,2363,2702,928,1774,0.535,0.476,0.393,1670,586.596702,1084,4014,0.706565745467347
"1832",134097,"FLORIDA STATE UNIVERSITY",1,0,2002,6258,3742,2516,2927,959,1968,0.526,0.468,0.381,1754,571.405731,1124,4531,0.724033237456056
"1833",134097,"FLORIDA STATE UNIVERSITY",1,0,2003,6059,3522,2537,2847,987,1860,0.528,0.47,0.389,1902,620.863,1116,4543,0.749793695329262
"1834",134097,"FLORIDA STATE UNIVERSITY",1,0,2004,6198,3727,2471,3112,1029,2083,0.559,0.502,0.416,2045,682.88384,1124,4545,0.733301064859632
"1835",134097,"Florida State University",1,0,2005,6052,3554,2498,2995,1066,1929,0.543,0.495,0.427,2147,742.366156,1283,4419,0.730171844018506
"1836",134097,"Florida State University",1,0,2006,6191,3597,2594,3310,1201,2109,0.586,0.535,0.463,2211,780.044957,1330,4564,0.737199160071071
"1837",134097,"Florida State University",1,0,2007,6104,3436,2668,3458,1266,2192,0.638,0.567,0.475,2211,848.859388,1367,4426,0.725098296199214
"1838",134097,"Florida State University",1,0,2008,4993,2928,2065,3066,1093,1973,0.674,0.614,0.529,2461,882.403405,1314,3523,0.705587822952133
"1839",134097,"Florida State University",1,0,2009,5925,3476,2449,3650,1245,2405,0.692,0.616,0.508,2658,908.011174,1312,4079,0.688438818565401
"1840",134097,"Florida State University",1,0,2010,5957,3515,2442,3620,1249,2371,0.674,0.608,0.511,2870,911.787861,1257,4073,0.683733422863858
"1841",134130,"UNIVERSITY OF FLORIDA",1,0,1991,4364,2116,2248,1284,490,794,0.375,0.294,0.218,1420,777.328149,3083,3388,0.776351970669111
"1842",134130,"UNIVERSITY OF FLORIDA",1,0,1992,4471,2097,2374,1377,568,809,0.386,0.308,0.239,1650,790.970391,2271,3308,0.739879221650637
"1843",134130,"UNIVERSITY OF FLORIDA",1,0,1993,5074,2520,2554,1728,701,1027,0.408,0.341,0.274,1770,822.790749,2261,3823,0.753448955459204
"1844",134130,"UNIVERSITY OF FLORIDA",1,0,1995,5655,3023,2632,2443,903,1540,0.509,0.432,0.343,1705,889.57149,2225,4121,0.728735632183908
"1845",134130,"UNIVERSITY OF FLORIDA",1,0,1996,5171,2899,2272,2599,929,1670,0.576,0.503,0.409,1793,934.329132,2229,3823,0.73931541287952
"1846",134130,"UNIVERSITY OF FLORIDA",1,0,1997,5959,3307,2652,2950,1073,1877,0.568,0.495,0.405,1926,974.607575,1575,4397,0.737875482463501
"1847",134130,"UNIVERSITY OF FLORIDA",1,0,1998,5629,3171,2458,2886,1037,1849,0.583,0.513,0.422,2052,1030.298,1447,4123,0.732456919523894
"1848",134130,"UNIVERSITY OF FLORIDA",1,0,1999,6065,3388,2677,3191,1111,2080,0.614,0.526,0.415,2141,1102.119966,1536,4292,0.707666941467436
"1849",134130,"UNIVERSITY OF FLORIDA",1,0,2000,6864,3874,2990,3692,1285,2407,0.621,0.538,0.43,1554,1164.348,1568.5,4553,0.663315850815851
"1850",134130,"UNIVERSITY OF FLORIDA",1,0,2001,6178,3348,2830,3304,1208,2096,0.626,0.535,0.427,1670,1252.251,1601,4518,0.73130462932988
"1851",134130,"UNIVERSITY OF FLORIDA",1,0,2002,6406,3674,2732,3586,1215,2371,0.645,0.56,0.445,1754,1280.576,1686,4405,0.687636590696222
"1852",134130,"UNIVERSITY OF FLORIDA",1,0,2003,6499,3790,2709,3779,1253,2526,0.667,0.581,0.463,1902,1390.376,1679,4452,0.685028465917834
"1853",134130,"UNIVERSITY OF FLORIDA",1,0,2004,6621,3706,2915,3933,1418,2515,0.679,0.594,0.486,2045,1479.158,1622,4481,0.676785983990334
"1854",134130,"University of Florida",1,0,2005,7217,4080,3137,4230,1533,2697,0.661,0.586,0.489,2147,1655.523,1663,4673,0.647498960787031
"1855",134130,"University of Florida",1,0,2006,6674,3783,2891,4294,1572,2722,0.72,0.643,0.544,2211,1745.853,2007,3961,0.593497153131555
"1856",134130,"University of Florida",1,0,2007,6440,3792,2648,4197,1467,2730,0.72,0.652,0.554,2211,1826.855,2009,3758,0.583540372670807
"1857",134130,"University of Florida",1,0,2008,6382,3787,2595,4289,1442,2847,0.752,0.672,0.556,2670,1860.279,2314,3837,0.601222187402068
"1858",134130,"University of Florida",1,0,2009,6253,3728,2525,4149,1367,2782,0.746,0.664,0.541,3070,2157.318,2249,3575,0.571725571725572
"1859",134130,"University of Florida",1,0,2010,6345,3661,2684,4275,1469,2806,0.767,0.674,0.547,3530,2226.809,2180,3693,0.582033096926714
"1860",134945,"JACKSONVILLE UNIVERSITY",1,0,1991,388,147,241,102,56,46,0.313,0.263,0.232,8450,25.971557,105,307,0.791237113402062
"1861",134945,"JACKSONVILLE UNIVERSITY",1,0,1992,304,128,176,81,33,48,0.375,0.266,0.188,9320,27.590311,111,227,0.746710526315789
"1862",134945,"JACKSONVILLE UNIVERSITY",1,0,1993,310,139,171,92,47,45,0.324,0.297,0.275,10080,28.392044,107,249,0.803225806451613
"1863",134945,"JACKSONVILLE UNIVERSITY",1,0,1995,356,197,159,129,51,78,0.396,0.362,0.321,10580,31.109817,109,267,0.75
"1864",134945,"JACKSONVILLE UNIVERSITY",1,0,1996,365,197,168,113,44,69,0.35,0.31,0.262,12510,33.546845,114,273,0.747945205479452
"1865",134945,"JACKSONVILLE UNIVERSITY",1,0,1997,290,125,165,65,19,46,0.368,0.224,0.115,13900,36.875629,118,197,0.679310344827586
"1866",134945,"JACKSONVILLE UNIVERSITY",1,0,1998,307,112,195,75,40,35,0.312,0.244,0.205,14420,34.841859,119,192,0.625407166123778
"1867",134945,"JACKSONVILLE UNIVERSITY",1,0,1999,309,122,187,98,49,49,0.402,0.317,0.262,14390,36.267084,110,180,0.58252427184466
"1868",134945,"JACKSONVILLE UNIVERSITY",1,0,2000,406,163,243,155,80,75,0.46,0.382,0.329,15270,36.946318,111,277,0.682266009852217
"1869",134945,"JACKSONVILLE UNIVERSITY",1,0,2001,428,186,242,219,140,79,0.425,0.512,0.579,15990,35.110199,112,289,0.675233644859813
"1870",134945,"JACKSONVILLE UNIVERSITY",1,0,2002,389,165,224,105,52,53,0.321,0.27,0.232,16540,39.019676,121,274,0.704370179948586
"1871",134945,"JACKSONVILLE UNIVERSITY",1,0,2003,430,192,238,137,57,80,0.417,0.319,0.239,17700,43.390576,125,299,0.695348837209302
"1872",134945,"JACKSONVILLE UNIVERSITY",1,0,2004,462,197,265,118,59,59,0.3,0.255,0.223,18590,44.39894,121,283,0.612554112554113
"1873",134945,"Jacksonville University",1,0,2005,544,252,292,127,59,68,0.27,0.233,0.202,19970,46.979918,130,272,0.5
"1874",134945,"Jacksonville University",1,0,2006,493,213,280,134,62,72,0.338,0.272,0.221,21200,44.65256,138,275,0.557809330628803
"1875",134945,"Jacksonville University",1,0,2007,581,274,307,141,60,81,0.296,0.243,0.195,22500,47.986662,137,326,0.561101549053356
"1876",134945,"Jacksonville University",1,0,2008,539,249,290,151,67,84,0.337,0.28,0.231,23900,66.193702,160,321,0.595547309833024
"1877",134945,"Jacksonville University",1,0,2009,665,337,328,187,78,109,0.323,0.281,0.238,25300,72.744904,161,445,0.669172932330827
"1878",134945,"Jacksonville University",1,0,2010,624,313,311,197,87,110,0.351,0.316,0.28,26600,64.536962,172,324,0.519230769230769
"1879",135726,"UNIVERSITY OF MIAMI",1,0,1991,1832,826,1006,775,383,392,0.475,0.423,0.381,14080,612.877697,748,1074,0.586244541484716
"1880",135726,"UNIVERSITY OF MIAMI",1,0,1992,1770,841,929,798,395,403,0.479,0.451,0.425,15050,673.533346,752,1007,0.568926553672316
"1881",135726,"UNIVERSITY OF MIAMI",1,0,1993,1612,791,821,741,338,403,0.51,0.46,0.412,15880,729.416459,769,836,0.518610421836228
"1882",135726,"UNIVERSITY OF MIAMI",1,0,1995,1684,913,771,832,348,484,0.53,0.494,0.451,17699,799.261343,748,871,0.517220902612827
"1883",135726,"UNIVERSITY OF MIAMI",1,0,1996,1678,893,785,887,381,506,0.567,0.529,0.485,18582,849.400617,770,798,0.475566150178784
"1884",135726,"UNIVERSITY OF MIAMI",1,0,1997,1814,960,854,962,421,541,0.564,0.53,0.493,19512,790.705012,735,921,0.507717750826902
"1885",135726,"UNIVERSITY OF MIAMI",1,0,1998,1831,980,851,975,389,586,0.598,0.532,0.457,20424,800.098828,731,940,0.513380666302567
"1886",135726,"UNIVERSITY OF MIAMI",1,0,1999,1845,998,847,1031,439,592,0.593,0.559,0.518,20960,829.860449,752,982,0.532249322493225
"1887",135726,"UNIVERSITY OF MIAMI",1,0,2000,1964,1081,883,1140,469,671,0.621,0.58,0.531,22124,873.46946,809.5,1091,0.555498981670061
"1888",135726,"UNIVERSITY OF MIAMI",1,0,2001,2152,1277,875,1349,503,846,0.662,0.627,0.575,23228,951.23888,867,1215,0.564591078066915
"1889",135726,"UNIVERSITY OF MIAMI",1,0,2002,2046,1197,849,1311,497,814,0.68,0.641,0.585,24378,1048.155261,865,1177,0.575268817204301
"1890",135726,"UNIVERSITY OF MIAMI",1,0,2003,2066,1142,924,1374,582,792,0.694,0.665,0.63,25838,1148.999705,897,1192,0.576960309777348
"1891",135726,"UNIVERSITY OF MIAMI",1,0,2004,2025,1157,868,1381,551,830,0.717,0.682,0.635,27384,1259.3757,910,1163,0.574320987654321
"1892",135726,"University of Miami",1,0,2005,2258,1168,1090,1480,670,810,0.694,0.655,0.615,29020,1289.254237,908,1249,0.553144375553587
"1893",135726,"University of Miami",1,0,2006,2046,1055,991,1421,644,777,0.737,0.695,0.65,30732,1360.000435,955,1087,0.53128054740958
"1894",135726,"University of Miami",1,0,2007,1977,1049,928,1400,606,794,0.757,0.708,0.653,32422,1552.580264,970,968,0.489630753667172
"1895",135726,"University of Miami",1,0,2008,1983,987,996,1358,647,711,0.72,0.685,0.65,34206,1846.231509,1003,932,0.469994957135653
"1896",135726,"University of Miami",1,0,2009,1903,924,979,1297,599,698,0.755,0.682,0.612,35540,2141.466289,998,948,0.498160798738833
"1897",135726,"University of Miami",1,0,2010,2105,1072,1033,1465,646,819,0.764,0.696,0.625,36962,2203.927038,1018,1104,0.524465558194774
"1898",136172,"UNIVERSITY OF NORTH FLORIDA",1,0,1991,406,240,166,71,24,47,0.196,0.175,0.145,1413,48.059897,243,315,0.775862068965517
"1899",136172,"UNIVERSITY OF NORTH FLORIDA",1,0,1992,487,277,210,68,27,41,0.148,0.14,0.129,1534,48.572049,225,366,0.751540041067762
"1900",136172,"UNIVERSITY OF NORTH FLORIDA",1,0,1993,545,289,256,94,25,69,0.239,0.172,0.098,1732,53.973128,230,432,0.792660550458716
"1901",136172,"UNIVERSITY OF NORTH FLORIDA",1,0,1995,762,463,299,145,26,119,0.257,0.19,0.087,1747,63.733139,334,592,0.776902887139108
"1902",136172,"UNIVERSITY OF NORTH FLORIDA",1,0,1996,987,583,404,213,62,151,0.259,0.216,0.153,1884,69.545238,278,766,0.776089159067882
"1903",136172,"UNIVERSITY OF NORTH FLORIDA",1,0,1997,1105,646,459,269,77,192,0.297,0.243,0.168,2006,75.651469,294,861,0.779185520361991
"1904",136172,"UNIVERSITY OF NORTH FLORIDA",1,0,1998,1371,842,529,353,105,248,0.294,0.257,0.198,2157,85.570526,342,1127,0.822027716994894
"1905",136172,"UNIVERSITY OF NORTH FLORIDA",1,0,1999,1501,886,615,375,97,278,0.314,0.25,0.158,2274,99.515589,359,1228,0.818121252498334
"1906",136172,"UNIVERSITY OF NORTH FLORIDA",1,0,2000,1664,963,701,335,100,235,0.244,0.201,0.143,1554,105.860922,360.5,1321,0.793870192307692
"1907",136172,"UNIVERSITY OF NORTH FLORIDA",1,0,2001,1672,979,693,392,126,266,0.272,0.234,0.182,1670,119.986416,362,1303,0.779306220095694
"1908",136172,"UNIVERSITY OF NORTH FLORIDA",1,0,2002,1865,1067,798,395,129,266,0.249,0.212,0.162,1754,128.294835,375,1508,0.80857908847185
"1909",136172,"UNIVERSITY OF NORTH FLORIDA",1,0,2003,1919,1115,804,444,120,324,0.291,0.231,0.149,1902,132.981941,409,1566,0.816050026055237
"1910",136172,"UNIVERSITY OF NORTH FLORIDA",1,0,2004,2199,1252,947,447,116,331,0.264,0.203,0.122,2045,137.883501,427,1714,0.779445202364711
"1911",136172,"University of North Florida",1,0,2005,2288,1296,992,518,179,339,0.262,0.226,0.18,2147,148.431714,449,1742,0.761363636363636
"1912",136172,"University of North Florida",1,0,2006,2304,1301,1003,462,131,331,0.254,0.201,0.131,2211,162.981837,482,1756,0.762152777777778
"1913",136172,"University of North Florida",1,0,2007,2048,1185,863,435,151,284,0.24,0.212,0.175,2211,181.038225,512,1539,0.75146484375
"1914",136172,"University of North Florida",1,0,2008,1694,1013,681,444,115,329,0.325,0.262,0.169,2461,192.276737,481,1273,0.751475796930342
"1915",136172,"University of North Florida",1,0,2009,2025,1129,896,536,155,381,0.338,0.265,0.173,2547,205.948371,487,1506,0.743703703703704
"1916",136172,"University of North Florida",1,0,2010,1926,1078,848,504,137,367,0.34,0.262,0.162,2930,215.871416,491,1480,0.768431983385254
"1917",136950,"ROLLINS COLLEGE",1,0,1991,401,227,174,233,92,141,0.621,0.581,0.529,13900,38.718947,149,328,0.817955112219451
"1918",136950,"ROLLINS COLLEGE",1,0,1992,394,215,179,194,71,123,0.572,0.492,0.397,14974,41.84673,156,327,0.82994923857868
"1919",136950,"ROLLINS COLLEGE",1,0,1993,377,210,167,195,82,113,0.538,0.517,0.491,15950,47.514514,154,315,0.835543766578249
"1920",136950,"ROLLINS COLLEGE",1,0,1995,412,248,164,250,88,162,0.653,0.607,0.537,17995,48.103039,146,331,0.803398058252427
"1921",136950,"ROLLINS COLLEGE",1,0,1996,418,240,178,194,69,125,0.521,0.464,0.388,19075,52.618867,147,292,0.698564593301435
"1922",136950,"ROLLINS COLLEGE",1,0,1997,415,253,162,192,65,127,0.502,0.463,0.401,20010,45.315549,149,287,0.691566265060241
"1923",136950,"ROLLINS COLLEGE",1,0,1998,458,278,180,232,80,152,0.547,0.507,0.444,20915,47.547643,148,364,0.794759825327511
"1924",136950,"ROLLINS COLLEGE",1,0,1999,448,267,181,220,87,133,0.498,0.491,0.481,21250,50.697939,143,338,0.754464285714286
"1925",136950,"ROLLINS COLLEGE",1,0,2000,425,256,169,252,87,165,0.645,0.593,0.515,22206,57.084528,147.5,300,0.705882352941177
"1926",136950,"ROLLINS COLLEGE",1,0,2001,473,300,173,278,90,188,0.627,0.588,0.52,23205,61.441137,152,360,0.761099365750529
"1927",136950,"ROLLINS COLLEGE",1,0,2002,466,280,186,278,97,181,0.646,0.597,0.522,24250,63.529,177,369,0.791845493562232
"1928",136950,"ROLLINS COLLEGE",1,0,2003,496,298,198,291,102,189,0.634,0.587,0.515,25500,67.753,179,368,0.741935483870968
"1929",136950,"ROLLINS COLLEGE",1,0,2004,486,284,202,285,116,169,0.595,0.586,0.574,26910,71.032,179,341,0.701646090534979
"1930",136950,"Rollins College",1,0,2005,463,275,188,284,105,179,0.651,0.613,0.559,28390,75.006,185,346,0.747300215982721
"1931",136950,"Rollins College",1,0,2006,501,287,214,312,119,193,0.672,0.623,0.556,30420,79.54,188,367,0.732534930139721
"1932",136950,"Rollins College",1,0,2007,525,305,220,319,124,195,0.639,0.608,0.564,32640,84.726,193,407,0.775238095238095
"1933",136950,"Rollins College",1,0,2008,464,262,202,293,118,175,0.668,0.631,0.584,34520,92.37,194,332,0.71551724137931
"1934",136950,"Rollins College",1,0,2009,464,287,177,299,103,196,0.683,0.644,0.582,36220,97.082,196,328,0.706896551724138
"1935",136950,"Rollins College",1,0,2010,465,286,179,298,100,198,0.692,0.641,0.559,37640,99.941,200,308,0.662365591397849
"1936",137546,"STETSON UNIVERSITY",1,0,1991,460,256,204,237,89,148,0.578,0.515,0.436,10020,44.552126,174,410,0.891304347826087
"1937",137546,"STETSON UNIVERSITY",1,0,1992,501,282,219,232,87,145,0.514,0.463,0.397,11110,47.789559,176,419,0.836327345309381
"1938",137546,"STETSON UNIVERSITY",1,0,1993,481,292,189,238,87,151,0.517,0.495,0.46,11995,61.826839,185,403,0.837837837837838
"1939",137546,"STETSON UNIVERSITY",1,0,1995,464,253,211,228,89,139,0.549,0.491,0.422,13700,61.023,183,397,0.855603448275862
"1940",137546,"STETSON UNIVERSITY",1,0,1996,416,229,187,211,83,128,0.559,0.507,0.444,14735,61.038,193,351,0.84375
"1941",137546,"STETSON UNIVERSITY",1,0,1997,504,289,215,283,104,179,0.619,0.562,0.484,15765,51.242,192,442,0.876984126984127
"1942",137546,"STETSON UNIVERSITY",1,0,1998,539,311,228,279,113,166,0.534,0.518,0.496,16650,55.192,203,461,0.855287569573284
"1943",137546,"STETSON UNIVERSITY",1,0,1999,548,325,223,312,119,193,0.594,0.569,0.534,16640,60.362,220,461,0.841240875912409
"1944",137546,"STETSON UNIVERSITY",1,0,2000,502,262,240,265,108,157,0.599,0.528,0.45,17475,67.854362,227.5,424,0.844621513944223
"1945",137546,"STETSON UNIVERSITY",1,0,2001,527,298,229,289,117,172,0.577,0.548,0.511,18350,74.27275,235,421,0.798861480075901
"1946",137546,"STETSON UNIVERSITY",1,0,2002,542,325,217,299,104,195,0.6,0.552,0.479,19450,79.486104,239,448,0.826568265682657
"1947",137546,"STETSON UNIVERSITY",1,0,2003,523,284,239,260,109,151,0.532,0.497,0.456,20425,79.142945,236,456,0.87189292543021
"1948",137546,"STETSON UNIVERSITY",1,0,2004,598,354,244,303,100,203,0.573,0.507,0.41,22350,83.051374,231,474,0.792642140468227
"1949",137546,"Stetson University",1,0,2005,547,312,235,308,135,173,0.554,0.563,0.574,23750,89.043219,243,396,0.723948811700183
"1950",137546,"Stetson University",1,0,2006,565,338,227,317,113,204,0.604,0.561,0.498,25350,94.453934,237,402,0.711504424778761
"1951",137546,"Stetson University",1,0,2007,557,322,235,314,121,193,0.599,0.564,0.515,27100,97.790949,235,430,0.771992818671454
"1952",137546,"Stetson University",1,0,2008,617,360,257,344,133,211,0.586,0.558,0.518,28456,101.143354,231,440,0.713128038897893
"1953",137546,"Stetson University",1,0,2009,502,273,229,287,124,163,0.597,0.572,0.541,29880,107.849442,229,350,0.697211155378486
"1954",137546,"Stetson University",1,0,2010,545,331,214,305,109,196,0.592,0.56,0.509,31374,109.371966,227,375,0.688073394495413
"1955",138354,"THE UNIVERSITY OF WEST FLORIDA",1,0,1991,380,215,165,40,16,24,0.112,0.105,0.097,1463,61.996751,241,315,0.828947368421053
"1956",138354,"THE UNIVERSITY OF WEST FLORIDA",1,0,1992,396,208,188,70,28,42,0.202,0.177,0.149,1654,64.444173,230,335,0.845959595959596
"1957",138354,"THE UNIVERSITY OF WEST FLORIDA",1,0,1993,438,252,186,68,17,51,0.202,0.155,0.091,1702,66.454197,221,347,0.792237442922374
"1958",138354,"THE UNIVERSITY OF WEST FLORIDA",1,0,1995,509,279,230,101,30,71,0.254,0.198,0.13,1723,75.041697,212,393,0.772102161100196
"1959",138354,"THE UNIVERSITY OF WEST FLORIDA",1,0,1996,459,261,198,107,39,68,0.26,0.233,0.197,1819,77.883096,210,369,0.803921568627451
"1960",138354,"THE UNIVERSITY OF WEST FLORIDA",1,0,1997,620,372,248,101,28,73,0.196,0.163,0.113,1985,77.445263,206,500,0.806451612903226
"1961",138354,"THE UNIVERSITY OF WEST FLORIDA",1,0,1998,647,365,282,136,40,96,0.263,0.21,0.142,2143,83.192724,210,515,0.795981452859351
"1962",138354,"THE UNIVERSITY OF WEST FLORIDA",1,0,1999,637,335,302,132,54,78,0.233,0.207,0.179,2293,89.245116,225,515,0.808477237048666
"1963",138354,"THE UNIVERSITY OF WEST FLORIDA",1,0,2000,629,355,274,117,30,87,0.245,0.186,0.109,1554,97.118466,236.5,513,0.815580286168522
"1964",138354,"THE UNIVERSITY OF WEST FLORIDA",1,0,2001,695,406,289,167,59,108,0.266,0.24,0.204,1670,105.880837,248,543,0.781294964028777
"1965",138354,"THE UNIVERSITY OF WEST FLORIDA",1,0,2002,760,443,317,172,52,120,0.271,0.226,0.164,1754,110.965256,245,614,0.807894736842105
"1966",138354,"THE UNIVERSITY OF WEST FLORIDA",1,0,2003,816,469,347,169,48,121,0.258,0.207,0.138,1902,122.163282,247,652,0.799019607843137
"1967",138354,"THE UNIVERSITY OF WEST FLORIDA",1,0,2004,859,475,384,168,57,111,0.234,0.196,0.148,2045,131.004565,257,690,0.80325960419092
"1968",138354,"The University of West Florida",1,0,2005,830,490,340,194,65,129,0.263,0.234,0.191,2147,135.306506,332,676,0.814457831325301
"1969",138354,"The University of West Florida",1,0,2006,861,495,366,209,65,144,0.291,0.243,0.178,2211,145.499252,343,648,0.752613240418119
"1970",138354,"The University of West Florida",1,0,2007,912,511,401,184,57,127,0.249,0.202,0.142,2211,144.440146,332,699,0.766447368421053
"1971",138354,"The University of West Florida",1,0,2008,1030,605,425,277,94,183,0.302,0.269,0.221,2460,146.900467,324,764,0.741747572815534
"1972",138354,"The University of West Florida",1,0,2009,1154,643,511,313,91,222,0.345,0.271,0.178,2743,143.373373,312,852,0.738301559792028
"1973",138354,"The University of West Florida",1,0,2010,1211,661,550,325,118,207,0.313,0.268,0.215,3062,159.71406,303,878,0.725020644095789
"1974",138716,"ALBANY STATE COLLEGE",0,1,1991,541,292,249,39,7,32,0.11,0.072,0.028,1794,22.396126,138,8,0.0147874306839187
"1975",138716,"ALBANY STATE COLLEGE",0,1,1992,645,364,281,50,14,36,0.099,0.078,0.05,1731,23.681949,142,11,0.0170542635658915
"1976",138716,"ALBANY STATE COLLEGE",0,1,1993,649,367,282,47,8,39,0.106,0.072,0.028,1771,27.103232,138,7,0.0107858243451464
"1977",138716,"ALBANY STATE COLLEGE",0,1,1995,530,291,239,37,10,27,0.093,0.07,0.042,2034,36.194748,136,7,0.0132075471698113
"1978",138716,"ALBANY STATE UNIVERSITY",0,1,1996,503,281,222,34,10,24,0.085,0.068,0.045,2139,34.755175,147,4,0.00795228628230616
"1979",138716,"ALBANY STATE UNIVERSITY",0,1,1997,575,359,216,35,9,26,0.072,0.061,0.042,2244,36.632235,149,4,0.00695652173913044
"1980",138716,"ALBANY STATE UNIVERSITY",1,0,1998,493,313,180,30,10,20,0.064,0.061,0.056,2176,40.867235,127,4,0.00811359026369168
"1981",138716,"ALBANY STATE UNIVERSITY",1,0,1999,648,424,224,92,23,69,0.163,0.142,0.103,1808,46.497783,138,9,0.0138888888888889
"1982",138716,"ALBANY STATE UNIVERSITY",1,0,2000,643,431,212,79,14,65,0.151,0.123,0.066,1876,44.668319,142,1,0.0015552099533437
"1983",138716,"ALBANY STATE UNIVERSITY",1,0,2001,420,266,154,79,17,62,0.233,0.188,0.11,1932,50.256305,146,9,0.0214285714285714
"1984",138716,"ALBANY STATE UNIVERSITY",1,0,2002,470,300,170,88,22,66,0.22,0.187,0.129,2010,52.659817,164,9,0.0191489361702128
"1985",138716,"ALBANY STATE UNIVERSITY",1,0,2003,537,322,215,78,21,57,0.177,0.145,0.098,2212,65.821834,148,9,0.0167597765363128
"1986",138716,"ALBANY STATE UNIVERSITY",1,0,2004,602,399,203,98,22,76,0.19,0.163,0.108,2322,54.753769,142,4,0.00664451827242525
"1987",138716,"Albany State University",1,0,2005,596,388,208,93,16,77,0.198,0.156,0.077,2438,60.354502,145,3,0.00503355704697987
"1988",138716,"Albany State University",1,0,2006,702,467,235,74,14,60,0.128,0.105,0.06,2548,54.585767,142,5,0.00712250712250712
"1989",138716,"Albany State University",1,0,2007,626,401,225,100,17,83,0.207,0.16,0.076,2706,57.633061,148,9,0.0143769968051118
"1990",138716,"Albany State University",1,0,2008,626,392,234,65,9,56,0.143,0.104,0.038,2838,65.268718,142,7,0.0111821086261981
"1991",138716,"Albany State University",1,0,2009,745,468,277,66,15,51,0.109,0.089,0.054,3100,64.347246,141,6,0.00805369127516779
"1992",138716,"Albany State University",1,0,2010,883,542,341,47,13,34,0.063,0.053,0.038,3132,66.186892,145,6,0.00679501698754247
"1993",138789,"ARMSTRONG STATE COLLEGE",0,1,1991,567,340,227,50,14,36,0.106,0.088,0.062,1467,20.168402,161,450,0.793650793650794
"1994",138789,"ARMSTRONG STATE COLLEGE",0,1,1992,496,292,204,25,10,15,0.051,0.05,0.049,1521,21.569178,187,381,0.768145161290323
"1995",138789,"ARMSTRONG STATE COLLEGE",0,1,1993,577,353,224,39,7,32,0.091,0.068,0.031,1568,26.000218,202,448,0.776429809358752
"1996",138789,"ARMSTRONG STATE COLLEGE",0,1,1995,773,497,276,50,13,37,0.074,0.065,0.047,1719,33.564123,210,582,0.752910737386805
"1997",138789,"ARMSTRONG ATLANTIC STATE UNIVERSITY",0,1,1996,805,519,286,60,14,46,0.089,0.075,0.049,1836,37.221025,209,575,0.714285714285714
"1998",138789,"ARMSTRONG ATLANTIC STATE UNIVERSITY",0,1,1997,690,470,220,50,7,43,0.092,0.072,0.032,1962,39.16519,211,517,0.749275362318841
"1999",138789,"ARMSTRONG ATLANTIC STATE UNIVERSITY",1,0,1998,550,378,172,26,8,18,0.048,0.047,0.047,2020,42.933241,212,389,0.707272727272727
"2000",138789,"ARMSTRONG ATLANTIC STATE UNIVERSITY",1,0,1999,602,386,216,35,10,25,0.065,0.058,0.046,1808,48.799135,213,449,0.745847176079734
"2001",138789,"ARMSTRONG ATLANTIC STATE UNIVERSITY",1,0,2000,568,327,241,27,9,18,0.055,0.048,0.037,1876,51.639592,210.5,440,0.774647887323944
"2002",138789,"ARMSTRONG ATLANTIC STATE UNIVERSITY",1,0,2001,551,328,223,39,7,32,0.098,0.071,0.031,1932,52.61317,208,424,0.76950998185118
"2003",138789,"ARMSTRONG ATLANTIC STATE UNIVERSITY",1,0,2002,581,350,231,48,13,35,0.1,0.083,0.056,2010,50.082239,241,422,0.726333907056799
"2004",138789,"ARMSTRONG ATLANTIC STATE UNIVERSITY",1,0,2003,719,433,286,47,8,39,0.09,0.065,0.028,2212,58.011492,217,556,0.773296244784423
"2005",138789,"ARMSTRONG ATLANTIC STATE UNIVERSITY",1,0,2004,776,449,327,70,21,49,0.109,0.09,0.064,2212,54.725815,223,577,0.743556701030928
"2006",138789,"Armstrong Atlantic State University",1,0,2005,700,453,247,70,14,56,0.124,0.1,0.057,2438,58.433277,234,465,0.664285714285714
"2007",138789,"Armstrong Atlantic State University",1,0,2006,757,472,285,63,14,49,0.104,0.083,0.049,2548,67.419112,240,490,0.647291941875826
"2008",138789,"Armstrong Atlantic State University",1,0,2007,793,477,316,77,16,61,0.128,0.097,0.051,2706,74.764829,245,501,0.631778058007566
"2009",138789,"Armstrong Atlantic State University",1,0,2008,864,511,353,87,23,64,0.125,0.101,0.065,2838,75.241825,237,543,0.628472222222222
"2010",138789,"Armstrong Atlantic State University",1,0,2009,1063,611,452,110,20,90,0.147,0.103,0.044,3120,80.151201,239,699,0.657572906867357
"2011",138789,"Armstrong Atlantic State University",1,0,2010,1161,685,476,141,41,100,0.146,0.121,0.086,3432,82.326049,254,678,0.583979328165375
"2012",139144,"BERRY COLLEGE",1,0,1991,429,253,176,220,85,135,0.534,0.513,0.483,6990,29.317585,95,409,0.953379953379953
"2013",139144,"BERRY COLLEGE",1,0,1992,425,286,139,191,64,127,0.444,0.449,0.46,7500,29.500969,95,402,0.945882352941177
"2014",139144,"BERRY COLLEGE",1,0,1993,484,306,178,183,57,126,0.412,0.378,0.32,8050,31.282567,92,453,0.935950413223141
"2015",139144,"BERRY COLLEGE",1,0,1995,522,316,206,184,68,116,0.367,0.352,0.33,9216,35.548723,97,479,0.917624521072797
"2016",139144,"BERRY COLLEGE",1,0,1996,539,339,200,252,79,173,0.51,0.468,0.395,9678,38.981842,103,510,0.946196660482375
"2017",139144,"BERRY COLLEGE",1,0,1997,504,332,172,295,99,196,0.59,0.585,0.576,10210,41.20335,111,472,0.936507936507937
"2018",139144,"BERRY COLLEGE",1,0,1998,525,336,189,297,106,191,0.569,0.566,0.561,10900,44.330089,124,492,0.937142857142857
"2019",139144,"BERRY COLLEGE",1,0,1999,401,243,158,197,69,128,0.527,0.491,0.437,11550,47.626032,136,385,0.960099750623441
"2020",139144,"BERRY COLLEGE",1,0,2000,486,321,165,258,84,174,0.542,0.531,0.509,12500,51.019465,142,457,0.940329218106996
"2021",139144,"BERRY COLLEGE",1,0,2001,536,357,179,262,74,188,0.527,0.489,0.413,13450,54.757633,148,497,0.927238805970149
"2022",139144,"BERRY COLLEGE",1,0,2002,565,353,212,276,94,182,0.516,0.488,0.443,14260,60.146659,149,516,0.913274336283186
"2023",139144,"BERRY COLLEGE",1,0,2003,504,321,183,240,76,164,0.511,0.476,0.415,15220,65.235324,148,455,0.902777777777778
"2024",139144,"BERRY COLLEGE",1,0,2004,514,349,165,261,76,185,0.53,0.508,0.461,16240,65.908938,146,462,0.898832684824903
"2025",139144,"Berry College",1,0,2005,513,316,197,226,65,161,0.51,0.441,0.33,17570,68.105352,137,456,0.888888888888889
"2026",139144,"Berry College",1,0,2006,427,302,125,221,56,165,0.546,0.518,0.448,18950,57.296797,139,385,0.901639344262295
"2027",139144,"Berry College",1,0,2007,537,373,164,269,75,194,0.52,0.501,0.457,20570,58.811252,143,469,0.873370577281192
"2028",139144,"Berry College",1,0,2008,448,311,137,243,70,173,0.556,0.542,0.511,22170,61.085372,141,371,0.828125
"2029",139144,"Berry College",1,0,2009,569,402,167,315,85,230,0.572,0.554,0.509,23160,68.051672,144,455,0.799648506151142
"2030",139144,"Berry College",1,0,2010,653,431,222,386,126,260,0.603,0.591,0.568,24420,73.576941,146,562,0.860643185298622
"2031",139366,"COLUMBUS COLLEGE",0,1,1991,509,312,197,30,9,21,0.067,0.059,0.046,1482,25.129821,180,352,0.691552062868369
"2032",139366,"COLUMBUS COLLEGE",0,1,1992,589,365,224,42,14,28,0.077,0.071,0.062,1545,25.841395,198,407,0.691001697792869
"2033",139366,"COLUMBUS COLLEGE",0,1,1993,650,401,249,59,20,39,0.097,0.091,0.08,1600,28.7072,178,416,0.64
"2034",139366,"COLUMBUS STATE UNIVERSITY",0,1,1995,633,390,243,54,17,37,0.095,0.085,0.07,1740,38.154466,190,435,0.687203791469194
"2035",139366,"COLUMBUS STATE UNIVERSITY",0,1,1996,616,383,233,43,10,33,0.086,0.07,0.043,1845,43.162612,201,386,0.626623376623377
"2036",139366,"COLUMBUS STATE UNIVERSITY",0,1,1997,612,354,258,53,14,39,0.11,0.087,0.054,1941,47.752637,218,420,0.686274509803922
"2037",139366,"COLUMBUS STATE UNIVERSITY",1,0,1998,723,450,273,63,17,46,0.102,0.087,0.062,2020,60.516912,215,493,0.681881051175657
"2038",139366,"COLUMBUS STATE UNIVERSITY",1,0,1999,672,412,260,54,13,41,0.099,0.08,0.05,1808,48.285626,216,495,0.736607142857143
"2039",139366,"COLUMBUS STATE UNIVERSITY",1,0,2000,759,468,291,87,24,63,0.135,0.115,0.082,1876,63.476812,211,492,0.648221343873518
"2040",139366,"COLUMBUS STATE UNIVERSITY",1,0,2001,761,468,293,84,20,64,0.137,0.11,0.068,1932,52.274134,206,518,0.680683311432326
"2041",139366,"COLUMBUS STATE UNIVERSITY",1,0,2002,943,548,395,91,18,73,0.133,0.097,0.046,2010,52.96242,207,611,0.647932131495228
"2042",139366,"COLUMBUS STATE UNIVERSITY",1,0,2003,1037,619,418,114,32,82,0.132,0.11,0.077,2212,53.690479,198,631,0.608486017357763
"2043",139366,"COLUMBUS STATE UNIVERSITY",1,0,2004,972,584,388,116,31,85,0.146,0.119,0.08,2322,55.216877,201,606,0.623456790123457
"2044",139366,"Columbus State University",1,0,2005,1067,641,426,129,33,96,0.15,0.121,0.077,2438,62.803548,217,657,0.615745079662605
"2045",139366,"Columbus State University",1,0,2006,1054,640,414,139,37,102,0.159,0.132,0.089,2548,69.444986,245,611,0.579696394686907
"2046",139366,"Columbus State University",1,0,2007,996,568,428,117,29,88,0.155,0.117,0.068,2706,78.534936,246,599,0.60140562248996
"2047",139366,"Columbus State University",1,0,2008,1114,642,472,131,38,93,0.145,0.118,0.081,2838,83.345525,252,627,0.562836624775583
"2048",139366,"Columbus State University",1,0,2009,1231,734,497,138,43,95,0.129,0.112,0.087,3100,83.115895,261,653,0.530463038180341
"2049",139366,"Columbus State University",1,0,2010,1154,718,436,130,43,87,0.121,0.113,0.099,3281,93.359287,267,606,0.525129982668977
"2050",139393,"COVENANT COLLEGE",1,0,1991,136,73,63,56,21,35,0.48,0.412,0.333,7900,8.195649,37,133,0.977941176470588
"2051",139393,"COVENANT COLLEGE",1,0,1992,155,98,57,56,18,38,0.388,0.361,0.316,8550,9.87474,37,147,0.948387096774194
"2052",139393,"COVENANT COLLEGE",1,0,1993,168,93,75,75,31,44,0.473,0.446,0.413,9200,11.191437,39,159,0.946428571428571
"2053",139393,"COVENANT COLLEGE",1,0,1995,155,90,65,75,33,42,0.467,0.484,0.508,10920,12.588074,39,142,0.916129032258065
"2054",139393,"COVENANT COLLEGE",1,0,1996,206,119,87,109,43,66,0.555,0.529,0.494,11780,12.966311,37,192,0.932038834951456
"2055",139393,"COVENANT COLLEGE",1,0,1997,197,112,85,89,31,58,0.518,0.452,0.365,12900,13.603456,46,183,0.928934010152284
"2056",139393,"COVENANT COLLEGE",1,0,1998,211,134,77,112,36,76,0.567,0.531,0.468,13750,14.376184,43,196,0.928909952606635
"2057",139393,"COVENANT COLLEGE",1,0,1999,228,144,84,124,45,79,0.549,0.544,0.536,14400,16.493311,44,208,0.912280701754386
"2058",139393,"COVENANT COLLEGE",1,0,2000,206,117,89,107,47,60,0.513,0.519,0.528,15600,18.575071,45,191,0.927184466019418
"2059",139393,"COVENANT COLLEGE",1,0,2001,238,151,87,120,41,79,0.523,0.504,0.471,16590,19.871537,46,216,0.907563025210084
"2060",139393,"COVENANT COLLEGE",1,0,2002,231,141,90,129,44,85,0.603,0.558,0.489,17750,21.063842,58,209,0.904761904761905
"2061",139393,"COVENANT COLLEGE",1,0,2003,236,146,90,108,32,76,0.52,0.458,0.356,17750,21.114885,56,214,0.906779661016949
"2062",139393,"COVENANT COLLEGE",1,0,2004,260,156,104,123,41,82,0.526,0.473,0.394,18750,22.14934,59,243,0.934615384615385
"2063",139393,"Covenant College",1,0,2005,270,138,132,122,48,74,0.536,0.452,0.364,20100,23.143585,61,241,0.892592592592593
"2064",139393,"Covenant College",1,0,2006,297,166,131,163,62,101,0.608,0.549,0.473,21100,23.636324,65,265,0.892255892255892
"2065",139393,"Covenant College",1,0,2007,291,163,128,139,51,88,0.54,0.478,0.398,22160,25.727421,70,258,0.88659793814433
"2066",139393,"Covenant College",1,0,2008,267,149,118,129,51,78,0.524,0.483,0.432,23600,27.829832,66,240,0.898876404494382
"2067",139393,"Covenant College",1,0,2009,277,158,119,139,48,91,0.576,0.502,0.403,24520,31.508612,60,252,0.909747292418773
"2068",139393,"Covenant College",1,0,2010,269,131,138,160,66,94,0.718,0.595,0.478,25476,29.777903,63,233,0.866171003717472
"2069",139658,"EMORY UNIVERSITY",1,0,1991,1415,772,643,950,430,520,0.674,0.671,0.669,14580,747.481775,492,1110,0.784452296819788
"2070",139658,"EMORY UNIVERSITY",1,0,1992,1478,872,606,1010,406,604,0.693,0.683,0.67,15600,801.383663,507,1078,0.72936400541272
"2071",139658,"EMORY UNIVERSITY",1,0,1993,1406,762,644,999,458,541,0.71,0.711,0.711,16820,885.669317,549,1037,0.737553342816501
"2072",139658,"EMORY UNIVERSITY",1,0,1995,1587,896,691,1093,441,652,0.728,0.689,0.638,19000,1061.150602,569,1146,0.722117202268431
"2073",139658,"EMORY UNIVERSITY",1,0,1996,1508,867,641,1076,438,638,0.736,0.714,0.683,19870,1106.292747,592,1058,0.70159151193634
"2074",139658,"EMORY UNIVERSITY",1,0,1997,1477,762,715,1120,525,595,0.781,0.758,0.734,21110,1154.808485,581,1011,0.684495599187542
"2075",139658,"EMORY UNIVERSITY",1,0,1998,1692,908,784,1227,548,679,0.748,0.725,0.699,21870,1427.635967,587,1152,0.680851063829787
"2076",139658,"EMORY UNIVERSITY",1,0,1999,1515,870,645,1148,486,662,0.761,0.758,0.753,22870,1581.26798,579,1018,0.671947194719472
"2077",139658,"EMORY UNIVERSITY",1,0,2000,1532,831,701,936,420,516,0.621,0.611,0.599,24240,1664.259022,589.5,1021,0.66644908616188
"2078",139658,"EMORY UNIVERSITY",1,0,2001,1547,817,730,1013,486,527,0.645,0.655,0.666,25240,1772.315101,600,979,0.632837750484809
"2079",139658,"EMORY UNIVERSITY",1,0,2002,1558,903,655,1061,444,617,0.683,0.681,0.678,26600,1854.805411,613,995,0.638639281129653
"2080",139658,"EMORY UNIVERSITY",1,0,2003,1595,895,700,1060,453,607,0.678,0.665,0.647,27600,2043.568872,645,950,0.595611285266458
"2081",139658,"EMORY UNIVERSITY",1,0,2004,1587,911,676,1044,436,608,0.667,0.658,0.645,28940,2214.257,666,959,0.604284814114682
"2082",139658,"Emory University",1,0,2005,1631,933,698,1032,450,582,0.624,0.633,0.645,30400,2350.209,685,931,0.570815450643777
"2083",139658,"Emory University",1,0,2006,1648,938,710,1108,477,631,0.673,0.672,0.672,32100,2550.026,697,882,0.535194174757282
"2084",139658,"Emory University",1,0,2007,1597,863,734,1027,477,550,0.637,0.643,0.65,33900,2672.681,992,791,0.495303694427051
"2085",139658,"Emory University",1,0,2008,1661,893,768,1064,501,563,0.63,0.641,0.652,35800,2832.473,1003,785,0.47260686333534
"2086",139658,"Emory University",1,0,2009,1287,712,575,1067,448,619,0.869,0.829,0.779,37500,3022.079,995,537,0.417249417249417
"2087",139658,"Emory University",1,0,2010,1321,748,573,1125,462,663,0.886,0.852,0.806,38600,3133.354,1003,593,0.44890234670704
"2088",139719,"FORT VALLEY STATE COLLEGE",0,1,1991,464,276,188,48,22,26,0.094,0.103,0.117,1650,26.016798,148,7,0.0150862068965517
"2089",139719,"FORT VALLEY STATE COLLEGE",0,1,1992,497,264,233,52,18,34,0.129,0.105,0.077,1650,27.190422,147,1,0.00201207243460765
"2090",139719,"FORT VALLEY STATE COLLEGE",0,1,1993,539,290,249,27,3,24,0.083,0.05,0.012,1775,30.696842,142,7,0.012987012987013
"2091",139719,"FORT VALLEY STATE UNIVERSITY",0,1,1995,522,261,261,38,8,30,0.115,0.073,0.031,1920,36.694496,143,5,0.00957854406130268
"2092",139719,"FORT VALLEY STATE UNIVERSITY",0,1,1996,573,307,266,48,6,42,0.137,0.084,0.023,2040,38.800271,149,4,0.00698080279232112
"2093",139719,"FORT VALLEY STATE UNIVERSITY",0,1,1997,502,270,232,75,19,56,0.207,0.149,0.082,2157,43.013789,139,5,0.0099601593625498
"2094",139719,"FORT VALLEY STATE UNIVERSITY",1,0,1998,432,240,192,40,11,29,0.121,0.093,0.057,2216,45.125017,152,4,0.00925925925925926
"2095",139719,"FORT VALLEY STATE UNIVERSITY",1,0,1999,406,206,200,36,9,27,0.131,0.089,0.045,1808,47.048933,146,2,0.00492610837438424
"2096",139719,"FORT VALLEY STATE UNIVERSITY",1,0,2000,360,195,165,48,14,34,0.174,0.133,0.085,1876,49.036556,143.5,7,0.0194444444444444
"2097",139719,"FORT VALLEY STATE UNIVERSITY",1,0,2001,425,225,200,60,16,44,0.196,0.141,0.08,1932,51.175405,141,3,0.00705882352941176
"2098",139719,"FORT VALLEY STATE UNIVERSITY",1,0,2002,386,192,194,59,12,47,0.245,0.153,0.062,2580,113.477563,135,3,0.0077720207253886
"2099",139719,"FORT VALLEY STATE UNIVERSITY",1,0,2003,496,260,236,64,17,47,0.181,0.129,0.072,2212,59.477177,107,2,0.00403225806451613
"2100",139719,"FORT VALLEY STATE UNIVERSITY",1,0,2004,456,227,229,66,18,48,0.212,0.145,0.079,2322,50.296193,126,7,0.0153508771929825
"2101",139719,"Fort Valley State University",1,0,2005,317,169,148,48,11,37,0.219,0.151,0.074,2438,47.618504,101,2,0.00630914826498423
"2102",139719,"Fort Valley State University",1,0,2006,486,253,233,51,9,42,0.166,0.105,0.039,2548,50.190816,107,2,0.00411522633744856
"2103",139719,"Fort Valley State University",1,0,2007,716,386,330,56,12,44,0.114,0.078,0.036,2706,54.320413,110,2,0.00279329608938547
"2104",139719,"Fort Valley State University",1,0,2008,1074,568,506,117,32,85,0.15,0.109,0.063,2868,62.806433,117,9,0.00837988826815642
"2105",139719,"Fort Valley State University",1,0,2009,984,550,434,118,26,92,0.167,0.12,0.06,3874,67.348281,103,7,0.00711382113821138
"2106",139719,"Fort Valley State University",1,0,2010,840,487,353,69,26,43,0.088,0.082,0.074,4274,76.558683,144,6,0.00714285714285714
"2107",139755,"GEORGIA INSTITUTE OF TECHNOLOGY MAIN CAMPUS",0,1,1991,1750,415,1335,484,335,149,0.359,0.277,0.251,2118,311.743882,608,1383,0.790285714285714
"2108",139755,"GEORGIA INSTITUTE OF TECHNOLOGY MAIN CAMPUS",0,1,1992,1691,467,1224,472,298,174,0.373,0.279,0.243,2205,326.970397,587,1363,0.806031933767002
"2109",139755,"GEORGIA INSTITUTE OF TECHNOLOGY MAIN CAMPUS",0,1,1993,1963,484,1479,398,252,146,0.302,0.203,0.17,2277,343.587415,626,1529,0.778909831889964
"2110",139755,"GEORGIA INSTITUTE OF TECHNOLOGY MAIN CAMPUS",0,1,1995,2120,600,1520,451,271,180,0.3,0.213,0.178,2457,404.504924,640,1612,0.760377358490566
"2111",139755,"GEORGIA INSTITUTE OF TECHNOLOGY MAIN CAMPUS",0,1,1996,2120,596,1524,484,288,196,0.329,0.228,0.189,2685,448.229336,670,1667,0.786320754716981
"2112",139755,"GEORGIA INSTITUTE OF TECHNOLOGY-MAIN CAMPUS",0,1,1997,2069,565,1504,487,305,182,0.322,0.235,0.203,2901,487.300638,688,1600,0.773320444659256
"2113",139755,"GEORGIA INSTITUTE OF TECHNOLOGY-MAIN CAMPUS",0,1,1998,2487,721,1766,644,371,273,0.379,0.259,0.21,2991,525.655933,686,1799,0.723361479694411
"2114",139755,"GEORGIA INSTITUTE OF TECHNOLOGY-MAIN CAMPUS",1,0,1999,2293,654,1639,657,431,226,0.346,0.287,0.263,2414,573.238846,721,1683,0.733972961186219
"2115",139755,"GEORGIA INSTITUTE OF TECHNOLOGY-MAIN CAMPUS",1,0,2000,2242,640,1602,760,470,290,0.453,0.339,0.293,2506,625.803014,737.5,1633,0.728367528991971
"2116",139755,"GEORGIA INSTITUTE OF TECHNOLOGY-MAIN CAMPUS",1,0,2001,2223,634,1589,736,441,295,0.465,0.331,0.278,2632,653.738318,754,1625,0.730994152046784
"2117",139755,"GEORGIA INSTITUTE OF TECHNOLOGY-MAIN CAMPUS",1,0,2002,2275,636,1639,711,445,266,0.418,0.313,0.272,2790,658.557586,879,1662,0.730549450549451
"2118",139755,"GEORGIA INSTITUTE OF TECHNOLOGY-MAIN CAMPUS",1,0,2003,2224,607,1617,683,427,256,0.422,0.307,0.264,3208,758.455038,852,1579,0.709982014388489
"2119",139755,"GEORGIA INSTITUTE OF TECHNOLOGY-MAIN CAMPUS",1,0,2004,2572,766,1806,845,514,331,0.432,0.329,0.285,3368,792.229885,834,1812,0.704510108864697
"2120",139755,"Georgia Institute of Technology-Main Campus",1,0,2005,2415,714,1701,756,431,325,0.455,0.313,0.253,3638,819.2405,879,1716,0.71055900621118
"2121",139755,"Georgia Institute of Technology-Main Campus",1,0,2006,2838,890,1948,953,548,405,0.455,0.336,0.281,3892,859.740592,907,1912,0.673713883016209
"2122",139755,"Georgia Institute of Technology-Main Campus",1,0,2007,2622,854,1768,1072,645,427,0.5,0.409,0.365,4159,936.375463,909,1702,0.649122807017544
"2123",139755,"Georgia Institute of Technology-Main Campus",1,0,2008,2633,838,1795,974,604,370,0.442,0.37,0.336,4395,1006.807755,964,1674,0.63577668059248
"2124",139755,"Georgia Institute of Technology-Main Campus",1,0,2009,2654,887,1767,1064,638,426,0.48,0.401,0.361,4829,1051.641194,978,1558,0.587038432554635
"2125",139755,"Georgia Institute of Technology-Main Campus",1,0,2010,2706,976,1730,1111,648,463,0.474,0.411,0.375,5873,1093.918233,990,1625,0.600517368810052
"2126",139764,"GEORGIA SOUTHWESTERN COLLEGE",0,1,1991,322,190,132,70,35,35,0.184,0.217,0.265,1578,16.136682,111,241,0.748447204968944
"2127",139764,"GEORGIA SOUTHWESTERN COLLEGE",0,1,1992,375,243,132,75,28,47,0.193,0.2,0.212,1650,16.820867,114,283,0.754666666666667
"2128",139764,"GEORGIA SOUTHWESTERN COLLEGE",0,1,1993,349,226,123,38,6,32,0.142,0.109,0.049,1680,19.471783,113,271,0.776504297994269
"2129",139764,"GEORGIA SOUTHWESTERN STATE UNIVERSITY",0,1,1995,328,211,117,26,3,23,0.109,0.079,0.026,1898,22.299201,104,200,0.609756097560976
"2130",139764,"GEORGIA SOUTHWESTERN STATE UNIVERSITY",0,1,1996,315,199,116,43,10,33,0.166,0.137,0.086,2067,23.428673,110,206,0.653968253968254
"2131",139764,"GEORGIA SOUTHWESTERN STATE UNIVERSITY",0,1,1997,449,283,166,85,29,56,0.198,0.189,0.175,2145,25.316984,107,306,0.681514476614699
"2132",139764,"GEORGIA SOUTHWESTERN STATE UNIVERSITY",1,0,1998,335,215,120,41,5,36,0.167,0.122,0.042,2199,27.739775,95,242,0.722388059701493
"2133",139764,"GEORGIA SOUTHWESTERN STATE UNIVERSITY",1,0,1999,259,161,98,42,14,28,0.174,0.162,0.143,1808,28.866142,98,175,0.675675675675676
"2134",139764,"GEORGIA SOUTHWESTERN STATE UNIVERSITY",1,0,2000,308,202,106,44,15,29,0.144,0.143,0.142,1876,29.773788,99.5,228,0.74025974025974
"2135",139764,"GEORGIA SOUTHWESTERN STATE UNIVERSITY",1,0,2001,266,173,93,31,8,23,0.133,0.117,0.086,1932,32.716383,101,193,0.725563909774436
"2136",139764,"GEORGIA SOUTHWESTERN STATE UNIVERSITY",1,0,2002,331,216,115,46,15,31,0.144,0.139,0.13,2010,31.873243,107,215,0.649546827794562
"2137",139764,"GEORGIA SOUTHWESTERN STATE UNIVERSITY",1,0,2003,326,222,104,48,13,35,0.158,0.147,0.125,2212,30.435301,100,166,0.50920245398773
"2138",139764,"GEORGIA SOUTHWESTERN STATE UNIVERSITY",1,0,2004,359,247,112,40,6,34,0.138,0.111,0.054,2322,29.86269,90,210,0.584958217270195
"2139",139764,"Georgia Southwestern State University",1,0,2005,358,200,158,36,9,27,0.135,0.101,0.057,2438,30.520716,83,213,0.594972067039106
"2140",139764,"Georgia Southwestern State University",1,0,2006,399,236,163,52,11,41,0.174,0.13,0.067,2548,31.475186,90,222,0.556390977443609
"2141",139764,"Georgia Southwestern State University",1,0,2007,388,252,136,59,16,43,0.171,0.152,0.118,2706,33.735259,92,244,0.628865979381443
"2142",139764,"Georgia Southwestern State University",1,0,2008,418,240,178,42,16,26,0.108,0.1,0.09,2838,34.306119,99,237,0.566985645933014
"2143",139764,"Georgia Southwestern State University",1,0,2009,435,251,184,49,16,33,0.132,0.113,0.087,2907,37.371929,96,257,0.590804597701149
"2144",139764,"Georgia Southwestern State University",1,0,2010,473,284,189,64,13,51,0.18,0.135,0.069,3133,41.238333,102,298,0.630021141649049
"2145",139861,"GEORGIA COLLEGE",0,1,1991,770,476,294,126,35,91,0.191,0.164,0.119,1563,26.678054,155,605,0.785714285714286
"2146",139861,"GEORGIA COLLEGE",0,1,1992,754,451,303,112,23,89,0.197,0.149,0.076,1632,28.551448,172,582,0.771883289124668
"2147",139861,"GEORGIA COLLEGE",0,1,1993,809,520,289,122,18,104,0.2,0.151,0.062,1693,32.008913,177,589,0.728059332509271
"2148",139861,"GEORGIA COLLEGE",0,1,1995,754,467,287,123,28,95,0.203,0.163,0.098,1820,39.107837,189,624,0.827586206896552
"2149",139861,"GEORGIA COLLEGE AND STATE UNIVERSITY",0,1,1996,715,483,232,119,23,96,0.199,0.166,0.099,1923,49.798584,196,603,0.843356643356643
"2150",139861,"GEORGIA COLLEGE AND STATE UNIVERSITY",0,1,1997,818,528,290,130,31,99,0.188,0.159,0.107,2064,53.084508,186,702,0.858190709046455
"2151",139861,"GEORGIA COLLEGE AND STATE UNIVERSITY",1,0,1998,750,470,280,127,22,105,0.223,0.169,0.079,2136,49.636677,198,654,0.872
"2152",139861,"GEORGIA COLLEGE AND STATE UNIVERSITY",1,0,1999,786,486,300,164,36,128,0.263,0.209,0.12,1808,50.166046,200,709,0.902035623409669
"2153",139861,"GEORGIA COLLEGE AND STATE UNIVERSITY",1,0,2000,820,506,314,189,41,148,0.292,0.23,0.131,1876,52.990558,224.5,707,0.86219512195122
"2154",139861,"GEORGIA COLLEGE AND STATE UNIVERSITY",1,0,2001,879,556,323,203,52,151,0.272,0.231,0.161,2532,55.246775,249,791,0.899886234357224
"2155",139861,"GEORGIA COLLEGE AND STATE UNIVERSITY",1,0,2002,984,612,372,199,45,154,0.252,0.202,0.121,2610,64.727452,276,903,0.917682926829268
"2156",139861,"GEORGIA COLLEGE AND STATE UNIVERSITY",1,0,2003,1027,611,416,254,69,185,0.303,0.247,0.166,3002,72.408162,276,944,0.919182083739046
"2157",139861,"GEORGIA COLLEGE AND STATE UNIVERSITY",1,0,2004,918,582,336,322,90,232,0.399,0.351,0.268,3152,74.506053,280,841,0.916122004357299
"2158",139861,"Georgia College and State University",1,0,2005,1032,631,401,342,101,241,0.382,0.331,0.252,3404,69.619601,268,941,0.911821705426357
"2159",139861,"Georgia College & State University",1,0,2006,1137,707,430,403,101,302,0.427,0.354,0.235,3608,77.099606,276,1009,0.887423043095866
"2160",139861,"Georgia College & State University",1,0,2007,1197,778,419,464,124,340,0.437,0.388,0.296,3892,81.982305,262,1077,0.899749373433584
"2161",139861,"Georgia College & State University",1,0,2008,1177,751,426,470,136,334,0.445,0.399,0.319,4113,102.222813,280,1015,0.862361937128292
"2162",139861,"Georgia College & State University",1,0,2009,1206,741,465,476,138,338,0.456,0.395,0.297,4520,99.542327,301,1047,0.868159203980099
"2163",139861,"Georgia College & State University",1,0,2010,1202,767,435,505,138,367,0.479,0.42,0.317,5013,98.450927,316,1001,0.832778702163062
"2164",139931,"GEORGIA SOUTHERN UNIVERSITY",0,1,1991,2737,1457,1280,508,172,336,0.231,0.186,0.134,1620,77.854395,555,2145,0.783704786262331
"2165",139931,"GEORGIA SOUTHERN UNIVERSITY",0,1,1992,2828,1530,1298,506,174,332,0.217,0.179,0.134,1638,84.559324,575,2046,0.723479490806223
"2166",139931,"GEORGIA SOUTHERN UNIVERSITY",0,1,1993,2955,1602,1353,540,158,382,0.239,0.183,0.117,1807,100.591366,621,2032,0.687648054145516
"2167",139931,"GEORGIA SOUTHERN UNIVERSITY",0,1,1995,3193,1825,1368,407,112,295,0.162,0.127,0.082,1965,118.565567,627,2175,0.681177575947385
"2168",139931,"GEORGIA SOUTHERN UNIVERSITY",0,1,1996,3159,1699,1460,385,115,270,0.159,0.122,0.079,2055,125.892346,632,2196,0.695156695156695
"2169",139931,"GEORGIA SOUTHERN UNIVERSITY",0,1,1997,2596,1387,1209,306,81,225,0.162,0.118,0.067,2256,134.306359,639,1883,0.725346687211094
"2170",139931,"GEORGIA SOUTHERN UNIVERSITY",1,0,1998,2897,1549,1348,335,87,248,0.16,0.116,0.065,2349,144.42565,641,1973,0.681049361408353
"2171",139931,"GEORGIA SOUTHERN UNIVERSITY",1,0,1999,3266,1729,1537,384,98,286,0.165,0.118,0.064,1808,153.40787,651,2218,0.679118187385181
"2172",139931,"GEORGIA SOUTHERN UNIVERSITY",1,0,2000,2859,1481,1378,379,105,274,0.185,0.133,0.076,1876,159.551681,638,2004,0.700944386149003
"2173",139931,"GEORGIA SOUTHERN UNIVERSITY",1,0,2001,2632,1278,1354,435,110,325,0.254,0.165,0.081,1932,164.75407,625,1939,0.736702127659574
"2174",139931,"GEORGIA SOUTHERN UNIVERSITY",1,0,2002,2597,1232,1365,434,138,296,0.24,0.167,0.101,2010,153.340933,604,1976,0.760877936080092
"2175",139931,"GEORGIA SOUTHERN UNIVERSITY",1,0,2003,2735,1305,1430,466,145,321,0.246,0.17,0.101,2212,158.350497,640,2090,0.764168190127971
"2176",139931,"GEORGIA SOUTHERN UNIVERSITY",1,0,2004,2982,1393,1589,546,158,388,0.278,0.183,0.099,2322,160.96016,664,2248,0.753856472166331
"2177",139931,"Georgia Southern University",1,0,2005,3123,1472,1651,623,195,428,0.291,0.199,0.118,2438,168.879312,645,2303,0.737431956452129
"2178",139931,"Georgia Southern University",1,0,2006,2731,1294,1437,617,214,403,0.311,0.226,0.149,2548,185.086091,673,2084,0.76309044306115
"2179",139931,"Georgia Southern University",1,0,2007,3028,1402,1626,773,287,486,0.347,0.255,0.177,2744,203.9072,714,1317,0.434940554821664
"2180",139931,"Georgia Southern University",1,0,2008,3106,1453,1653,828,300,528,0.363,0.267,0.181,2898,220.942431,741,2175,0.700257566001288
"2181",139931,"Georgia Southern University",1,0,2009,3490,1683,1807,854,292,562,0.334,0.245,0.162,3178,241.160856,751,2416,0.692263610315186
"2182",139931,"Georgia Southern University",1,0,2010,3597,1785,1812,950,305,645,0.361,0.264,0.168,3283,257.714225,761,2339,0.650264108979705
"2183",139940,"GEORGIA STATE UNIVERSITY",0,1,1991,1007,598,409,103,34,69,0.115,0.102,0.083,1884,148.132609,759,652,0.64746772591857
"2184",139940,"GEORGIA STATE UNIVERSITY",0,1,1992,998,574,424,96,36,60,0.104,0.096,0.085,1952,152.277623,769,639,0.640280561122245
"2185",139940,"GEORGIA STATE UNIVERSITY",0,1,1993,1072,613,459,119,33,86,0.14,0.111,0.072,2019,168.410574,793,622,0.580223880597015
"2186",139940,"GEORGIA STATE UNIVERSITY",0,1,1995,1276,750,526,127,51,76,0.101,0.1,0.097,2249,206.749347,800,626,0.490595611285266
"2187",139940,"GEORGIA STATE UNIVERSITY",0,1,1996,1551,985,566,211,58,153,0.155,0.136,0.102,2385,220.962918,814,779,0.502256608639587
"2188",139940,"GEORGIA STATE UNIVERSITY",0,1,1997,1906,1172,734,211,60,151,0.129,0.111,0.082,2673,259.304925,845,979,0.513641133263379
"2189",139940,"GEORGIA STATE UNIVERSITY",1,0,1998,1491,924,567,208,63,145,0.157,0.14,0.111,2778,292.831154,864,831,0.557344064386318
"2190",139940,"GEORGIA STATE UNIVERSITY",1,0,1999,1772,1082,690,242,69,173,0.16,0.137,0.1,2414,316.171116,943,1002,0.565462753950339
"2191",139940,"GEORGIA STATE UNIVERSITY",1,0,2000,2061,1233,828,303,85,218,0.177,0.147,0.103,2506,319.378301,940.5,1048,0.508491023774867
"2192",139940,"GEORGIA STATE UNIVERSITY",1,0,2001,2136,1305,831,357,99,258,0.198,0.167,0.119,2632,357.34066,938,1006,0.470973782771536
"2193",139940,"GEORGIA STATE UNIVERSITY",1,0,2002,2469,1419,1050,423,107,316,0.223,0.171,0.102,2790,378.826376,1000,1208,0.489266909680032
"2194",139940,"GEORGIA STATE UNIVERSITY",1,0,2003,1920,1159,761,349,114,235,0.203,0.182,0.15,3208,389.396091,944,956,0.497916666666667
"2195",139940,"GEORGIA STATE UNIVERSITY",1,0,2004,2272,1338,934,389,132,257,0.192,0.171,0.141,3368,400.738734,981,1111,0.488996478873239
"2196",139940,"Georgia State University",1,0,2005,2325,1322,1003,408,164,244,0.185,0.175,0.164,3638,402.610596,998,1018,0.437849462365591
"2197",139940,"Georgia State University",1,0,2006,2174,1313,861,439,135,304,0.231,0.202,0.157,3856,432.928448,994,940,0.432382704691812
"2198",139940,"Georgia State University",1,0,2007,2521,1486,1035,540,154,386,0.26,0.214,0.149,4159,428.173736,1046,1005,0.398651328837763
"2199",139940,"Georgia State University",1,0,2008,2743,1609,1134,614,206,408,0.254,0.224,0.182,4856,513.552094,1064,732,0.266861100984324
"2200",139940,"Georgia State University",1,0,2009,2937,1745,1192,702,233,469,0.269,0.239,0.195,6070,522.91678,1052,1095,0.372829417773238
"2201",139940,"Georgia State University",1,0,2010,2853,1540,1313,669,240,429,0.279,0.234,0.183,7070,531.620006,1067,998,0.349807220469681
"2202",139959,"UNIVERSITY OF GEORGIA",0,1,1991,3408,1927,1481,1191,429,762,0.395,0.349,0.29,2076,497.490574,1728,2931,0.860035211267606
"2203",139959,"UNIVERSITY OF GEORGIA",0,1,1992,3147,1823,1324,1456,521,935,0.513,0.463,0.394,2175,491.605846,1668,2697,0.857006673021926
"2204",139959,"UNIVERSITY OF GEORGIA",0,1,1993,3808,2115,1693,1617,630,987,0.467,0.425,0.372,2250,532.743588,1658,3324,0.872899159663866
"2205",139959,"UNIVERSITY OF GEORGIA",0,1,1995,3996,2376,1620,1702,570,1132,0.476,0.426,0.352,2542,644.748056,1689,3379,0.845595595595596
"2206",139959,"UNIVERSITY OF GEORGIA",0,1,1996,3671,2184,1487,1546,494,1052,0.482,0.421,0.332,2694,689.914153,1708,3239,0.882320893489512
"2207",139959,"UNIVERSITY OF GEORGIA",0,1,1997,4348,2544,1804,1729,569,1160,0.456,0.398,0.315,2838,735.012941,1700,3856,0.886844526218951
"2208",139959,"UNIVERSITY OF GEORGIA",1,0,1998,4384,2588,1796,1771,535,1236,0.478,0.404,0.298,2930,769.256438,1705,3855,0.879333941605839
"2209",139959,"UNIVERSITY OF GEORGIA",1,0,1999,4375,2586,1789,1860,592,1268,0.49,0.425,0.331,2414,793.657179,1719,3842,0.878171428571429
"2210",139959,"UNIVERSITY OF GEORGIA",1,0,2000,4207,2556,1651,1911,584,1327,0.519,0.454,0.354,2506,883.661895,1723,3669,0.872117898740195
"2211",139959,"UNIVERSITY OF GEORGIA",1,0,2001,4459,2646,1813,2137,677,1460,0.552,0.479,0.373,2632,926.951047,1727,3950,0.885848845032518
"2212",139959,"UNIVERSITY OF GEORGIA",1,0,2002,4282,2570,1712,2155,713,1442,0.561,0.503,0.416,2790,854.93174,1705,3752,0.876226062587576
"2213",139959,"UNIVERSITY OF GEORGIA",1,0,2003,5157,3146,2011,2535,807,1728,0.549,0.492,0.401,3208,934.305212,1690,4469,0.866589102191196
"2214",139959,"UNIVERSITY OF GEORGIA",1,0,2004,4500,2724,1776,2335,774,1561,0.573,0.519,0.436,3368,942.532849,1661,3918,0.870666666666667
"2215",139959,"University of Georgia",1,0,2005,4654,2812,1842,2505,845,1660,0.59,0.538,0.459,3638,931.59988,1691,3697,0.794370434035239
"2216",139959,"University of Georgia",1,0,2006,5059,3161,1898,2732,900,1832,0.58,0.54,0.474,3856,1017.933224,1735,4018,0.794228108321803
"2217",139959,"University of Georgia",1,0,2007,4675,2942,1733,2655,853,1802,0.613,0.568,0.492,4159,1055.795456,1733,3741,0.800213903743315
"2218",139959,"University of Georgia",1,0,2008,4778,3013,1765,2853,924,1929,0.64,0.597,0.524,4395,1123.218995,1761,3759,0.78673084972792
"2219",139959,"University of Georgia",1,0,2009,4675,2862,1813,2881,951,1930,0.674,0.616,0.525,4828,1138.522399,1775,3610,0.772192513368984
"2220",139959,"University of Georgia",1,0,2010,4667,2886,1781,2903,961,1942,0.673,0.622,0.54,5873,1123.921055,1749,3345,0.716734518962931
"2221",140447,"MERCER UNIVERSITY",0,1,1991,670,347,323,230,100,130,0.375,0.343,0.31,9450,81.443751,234,544,0.811940298507463
"2222",140447,"MERCER UNIVERSITY",0,1,1992,579,349,230,158,45,113,0.324,0.273,0.196,10287,83.419406,238,428,0.739205526770294
"2223",140447,"MERCER UNIVERSITY",0,1,1993,639,378,261,243,85,158,0.418,0.38,0.326,11160,88.389029,246,480,0.751173708920188
"2224",140447,"MERCER UNIVERSITY",0,1,1995,630,381,249,199,65,134,0.352,0.316,0.261,12987,107.790755,255,439,0.696825396825397
"2225",140447,"MERCER UNIVERSITY",0,1,1996,681,432,249,228,63,165,0.382,0.335,0.253,13896,113.803823,253,487,0.715124816446402
"2226",140447,"MERCER UNIVERSITY",0,1,1997,679,428,251,215,70,145,0.339,0.317,0.279,14656,109.961904,313,456,0.671575846833579
"2227",140447,"MERCER UNIVERSITY",1,0,1998,706,428,278,221,74,147,0.344,0.313,0.266,15465,118.759028,307,490,0.694050991501416
"2228",140447,"MERCER UNIVERSITY",1,0,1999,730,449,281,254,79,175,0.39,0.348,0.281,16290,124.711601,314,457,0.626027397260274
"2229",140447,"MERCER UNIVERSITY",1,0,2000,733,438,295,223,71,152,0.347,0.304,0.241,17028,135.802884,316,444,0.605729877216917
"2230",140447,"MERCER UNIVERSITY",1,0,2001,767,472,295,257,73,184,0.39,0.335,0.247,18290,142.032357,318,567,0.739243807040417
"2231",140447,"MERCER UNIVERSITY",1,0,2002,687,387,300,275,93,182,0.47,0.4,0.31,19728,159.750978,320,500,0.727802037845706
"2232",140447,"MERCER UNIVERSITY",1,0,2003,663,381,282,292,88,204,0.535,0.44,0.312,20796,160.636557,320,478,0.720965309200603
"2233",140447,"MERCER UNIVERSITY",1,0,2004,632,373,259,270,90,180,0.483,0.427,0.347,22050,166.443525,318,447,0.707278481012658
"2234",140447,"Mercer University",1,0,2005,666,408,258,267,86,181,0.444,0.401,0.333,23460,171.569345,343,461,0.692192192192192
"2235",140447,"Mercer University",1,0,2006,582,300,282,253,98,155,0.517,0.435,0.348,25056,186.883217,349,391,0.671821305841924
"2236",140447,"Mercer University",1,0,2007,602,337,265,265,87,178,0.528,0.44,0.328,26760,175.376311,349,352,0.584717607973422
"2237",140447,"Mercer University",1,0,2008,615,365,250,298,94,204,0.559,0.485,0.376,28500,182.648217,348,387,0.629268292682927
"2238",140447,"Mercer University",1,0,2009,628,349,279,294,108,186,0.533,0.468,0.387,29340,195.632274,359,374,0.595541401273885
"2239",140447,"Mercer University",1,0,2010,596,301,295,293,116,177,0.588,0.492,0.393,30360,205.642103,380,368,0.61744966442953
"2240",140960,"SAVANNAH STATE COLLEGE",0,1,1991,737,394,343,75,28,47,0.119,0.102,0.082,1635,22.276385,121,7,0.00949796472184532
"2241",140960,"SAVANNAH STATE COLLEGE",0,1,1992,636,346,290,50,15,35,0.101,0.079,0.052,1686,23.92359,130,10,0.0157232704402516
"2242",140960,"SAVANNAH STATE COLLEGE",0,1,1993,760,391,369,48,15,33,0.084,0.063,0.041,1741,26.909869,145,9,0.0118421052631579
"2243",140960,"SAVANNAH STATE UNIVERSITY",0,1,1995,676,358,318,25,2,23,0.064,0.037,0.006,1965,31.865901,137,13,0.0192307692307692
"2244",140960,"SAVANNAH STATE UNIVERSITY",0,1,1996,483,268,215,13,3,10,0.037,0.027,0.014,2130,32.827942,146,6,0.0124223602484472
"2245",140960,"SAVANNAH STATE UNIVERSITY",0,1,1997,455,240,215,19,4,15,0.062,0.042,0.019,2226,43.86031,147,8,0.0175824175824176
"2246",140960,"SAVANNAH STATE UNIVERSITY",1,0,1998,321,179,142,23,5,18,0.101,0.072,0.035,2278,47.443791,143,6,0.0186915887850467
"2247",140960,"SAVANNAH STATE UNIVERSITY",1,0,1999,281,150,131,18,4,14,0.093,0.064,0.031,1808,48.674112,142,10,0.0355871886120996
"2248",140960,"SAVANNAH STATE UNIVERSITY",1,0,2000,370,195,175,35,7,28,0.144,0.095,0.04,1826,49.420892,130,16,0.0432432432432432
"2249",140960,"SAVANNAH STATE UNIVERSITY",1,0,2001,440,238,202,58,13,45,0.189,0.132,0.064,1932,54.951306,118,10,0.0227272727272727
"2250",140960,"SAVANNAH STATE UNIVERSITY",1,0,2002,496,269,227,52,7,45,0.167,0.105,0.031,2010,39.821557,122,3,0.00604838709677419
"2251",140960,"SAVANNAH STATE UNIVERSITY",1,0,2003,607,354,253,76,12,64,0.181,0.125,0.047,2212,40.94207,114,7,0.0115321252059308
"2252",140960,"SAVANNAH STATE UNIVERSITY",1,0,2004,568,316,252,73,22,51,0.161,0.129,0.087,2322,42.839104,123,12,0.0211267605633803
"2253",140960,"Savannah State University",1,0,2005,806,427,379,73,16,57,0.134,0.091,0.042,2438,44.370963,123,14,0.0173697270471464
"2254",140960,"Savannah State University",1,0,2006,697,377,320,60,12,48,0.127,0.086,0.038,2548,45.560682,114,9,0.0129124820659971
"2255",140960,"Savannah State University",1,0,2007,612,343,269,51,10,41,0.12,0.083,0.037,2706,47.275338,116,8,0.0130718954248366
"2256",140960,"Savannah State University",1,0,2008,905,490,415,71,22,49,0.1,0.078,0.053,3098,52.342957,149,8,0.00883977900552486
"2257",140960,"Savannah State University",1,0,2009,866,448,418,68,18,50,0.112,0.079,0.043,3100,63.56044,151,16,0.0184757505773672
"2258",140960,"Savannah State University",1,0,2010,953,504,449,81,19,62,0.123,0.085,0.042,4274,69.837897,157,35,0.0367261280167891
"2259",140988,"SHORTER COLLEGE",1,0,1991,139,96,43,59,18,41,0.427,0.424,0.419,5810,8.543026,61,130,0.935251798561151
"2260",140988,"SHORTER COLLEGE",1,0,1992,175,118,57,65,20,45,0.381,0.371,0.351,6220,9.427774,58,157,0.897142857142857
"2261",140988,"SHORTER COLLEGE",1,0,1993,165,112,53,60,15,45,0.402,0.364,0.283,6670,10.207097,55,156,0.945454545454545
"2262",140988,"SHORTER COLLEGE",1,0,1995,167,118,49,76,24,52,0.441,0.455,0.49,7610,12.403241,63,150,0.898203592814371
"2263",140988,"SHORTER COLLEGE",1,0,1996,204,134,70,75,22,53,0.395,0.368,0.314,7860,13.590423,62,181,0.887254901960784
"2264",140988,"SHORTER COLLEGE",1,0,1997,242,162,80,90,26,64,0.395,0.372,0.325,8260,13.520945,60,222,0.917355371900826
"2265",140988,"SHORTER COLLEGE",1,0,1998,247,167,80,86,22,64,0.383,0.348,0.275,8770,12.495862,57,221,0.894736842105263
"2266",140988,"SHORTER COLLEGE",1,0,1999,259,171,88,103,32,71,0.415,0.398,0.364,9050,13.870712,61,227,0.876447876447876
"2267",140988,"SHORTER COLLEGE",1,0,2000,299,205,94,105,23,82,0.4,0.351,0.245,9350,14.859364,62.5,268,0.896321070234114
"2268",140988,"SHORTER COLLEGE",1,0,2001,258,186,72,92,20,72,0.387,0.357,0.278,9800,16.024006,64,228,0.883720930232558
"2269",140988,"SHORTER COLLEGE",1,0,2002,218,144,74,80,23,57,0.396,0.367,0.311,10400,17.891243,64,191,0.876146788990826
"2270",140988,"SHORTER COLLEGE",1,0,2003,184,96,88,80,33,47,0.49,0.435,0.375,11440,18.020294,65,155,0.842391304347826
"2271",140988,"SHORTER COLLEGE",1,0,2004,226,128,98,95,31,64,0.5,0.42,0.316,12500,18.158053,67,194,0.858407079646018
"2272",140988,"Shorter College",1,0,2005,291,133,158,101,40,61,0.459,0.347,0.253,13200,19.93552,72,222,0.762886597938144
"2273",140988,"Shorter College",1,0,2006,311,138,173,104,42,62,0.449,0.334,0.243,14000,17.663892,67,237,0.762057877813505
"2274",140988,"Shorter College",1,0,2007,276,131,145,91,35,56,0.428,0.33,0.241,14850,19.117167,69,215,0.778985507246377
"2275",140988,"Shorter College",1,0,2008,330,163,167,117,46,71,0.436,0.355,0.275,15440,21.098852,77,247,0.748484848484849
"2276",140988,"Shorter College",1,0,2009,333,175,158,105,32,73,0.417,0.315,0.203,15950,23.00122,83,253,0.75975975975976
"2277",140988,"Shorter University",1,0,2010,446,216,230,121,48,73,0.338,0.271,0.209,16700,26.107102,85,311,0.697309417040359
"2278",141185,"TOCCOA FALLS COLLEGE",1,0,1991,218,113,105,51,25,26,0.23,0.234,0.238,5208,7.396549,41,201,0.922018348623853
"2279",141185,"TOCCOA FALLS COLLEGE",1,0,1992,201,114,87,53,19,34,0.298,0.264,0.218,5486,8.10709,39,186,0.925373134328358
"2280",141185,"TOCCOA FALLS COLLEGE",1,0,1993,165,105,60,47,15,32,0.305,0.285,0.25,6104,8.782683,40,161,0.975757575757576
"2281",141185,"TOCCOA FALLS COLLEGE",1,0,1995,210,124,86,8,2,6,0.048,0.038,0.023,6628,10.535165,45,188,0.895238095238095
"2282",141185,"TOCCOA FALLS COLLEGE",1,0,1996,187,120,67,66,22,44,0.367,0.353,0.328,7005,11.594617,45,171,0.914438502673797
"2283",141185,"TOCCOA FALLS COLLEGE",1,0,1997,263,157,106,79,29,50,0.318,0.3,0.274,7395,12.469112,47,244,0.927756653992395
"2284",141185,"TOCCOA FALLS COLLEGE",1,0,1998,229,141,88,76,24,52,0.369,0.332,0.273,7763,13.914466,50,204,0.890829694323144
"2285",141185,"TOCCOA FALLS COLLEGE",1,0,1999,216,135,81,65,19,46,0.341,0.301,0.235,8384,13.589641,47,201,0.930555555555556
"2286",141185,"TOCCOA FALLS COLLEGE",1,0,2000,192,105,87,51,13,38,0.362,0.266,0.149,8888,15.125682,50,173,0.901041666666667
"2287",141185,"TOCCOA FALLS COLLEGE",1,0,2001,198,124,74,71,25,46,0.371,0.359,0.338,9600,15.005635,53,171,0.863636363636364
"2288",141185,"TOCCOA FALLS COLLEGE",1,0,2002,175,106,69,88,37,51,0.481,0.503,0.536,9900,15.414944,47,157,0.897142857142857
"2289",141185,"TOCCOA FALLS COLLEGE",1,0,2003,165,107,58,83,22,61,0.57,0.503,0.379,10850,14.608669,45,149,0.903030303030303
"2290",141185,"TOCCOA FALLS COLLEGE",1,0,2004,161,98,63,67,20,47,0.48,0.416,0.317,11450,15.111937,42,140,0.869565217391304
"2291",141185,"Toccoa Falls College",1,0,2005,223,135,88,84,27,57,0.422,0.377,0.307,12050,15.062195,43,199,0.89237668161435
"2292",141185,"Toccoa Falls College",1,0,2006,190,104,86,62,18,44,0.423,0.326,0.209,12900,16.970901,48,165,0.868421052631579
"2293",141185,"Toccoa Falls College",1,0,2007,218,128,90,75,28,47,0.367,0.344,0.311,13700,17.405521,49,190,0.871559633027523
"2294",141185,"Toccoa Falls College",1,0,2008,155,93,62,63,20,43,0.462,0.406,0.323,14500,19.001936,50,135,0.870967741935484
"2295",141185,"Toccoa Falls College",1,0,2009,168,109,59,59,21,38,0.349,0.351,0.356,15450,19.331027,50,140,0.833333333333333
"2296",141185,"Toccoa Falls College",1,0,2010,153,78,75,54,16,38,0.487,0.353,0.213,15760,18.351699,43,124,0.810457516339869
"2297",141264,"VALDOSTA STATE COLLEGE",0,1,1991,994,614,380,225,78,147,0.239,0.226,0.205,1638,42.782269,286,804,0.808853118712274
"2298",141264,"VALDOSTA STATE COLLEGE",0,1,1992,1057,608,449,146,43,103,0.169,0.138,0.096,1689,44.824172,280,778,0.7360454115421
"2299",141264,"VALDOSTA STATE UNIVERSITY",0,1,1993,1357,807,550,211,50,161,0.2,0.155,0.091,1729,53.086757,311,986,0.726602800294768
"2300",141264,"VALDOSTA STATE UNIVERSITY",0,1,1995,1665,985,680,247,71,176,0.179,0.148,0.104,1887,69.940716,375,1154,0.693093093093093
"2301",141264,"VALDOSTA STATE UNIVERSITY",0,1,1996,1838,1030,808,227,65,162,0.157,0.124,0.08,2043,82.108039,392,1281,0.696953210010881
"2302",141264,"VALDOSTA STATE UNIVERSITY",0,1,1997,1594,947,647,179,50,129,0.136,0.112,0.077,2139,87.243174,409,1118,0.70138017565872
"2303",141264,"VALDOSTA STATE UNIVERSITY",1,0,1998,1301,755,546,158,44,114,0.151,0.121,0.081,2202,94.835256,431,973,0.747886241352806
"2304",141264,"VALDOSTA STATE UNIVERSITY",1,0,1999,1177,735,442,211,52,159,0.216,0.179,0.118,1808,99.93351,461,876,0.744265080713679
"2305",141264,"VALDOSTA STATE UNIVERSITY",1,0,2000,788,512,276,141,49,92,0.18,0.179,0.178,1876,98.534106,436,568,0.720812182741117
"2306",141264,"VALDOSTA STATE UNIVERSITY",1,0,2001,1534,937,597,266,67,199,0.212,0.173,0.112,1932,102.304707,411,1123,0.732073011734029
"2307",141264,"VALDOSTA STATE UNIVERSITY",1,0,2002,1584,973,611,239,54,185,0.19,0.151,0.088,2010,89.419998,438,1183,0.746843434343434
"2308",141264,"VALDOSTA STATE UNIVERSITY",1,0,2003,1756,1007,749,262,73,189,0.188,0.149,0.097,2212,100.796516,423,1334,0.759681093394077
"2309",141264,"VALDOSTA STATE UNIVERSITY",1,0,2004,1690,969,721,279,78,201,0.207,0.165,0.108,2322,101.507171,420,1281,0.757988165680473
"2310",141264,"Valdosta State University",1,0,2005,1775,1072,703,299,69,230,0.215,0.168,0.098,2438,105.308416,435,1227,0.691267605633803
"2311",141264,"Valdosta State University",1,0,2006,2015,1195,820,300,78,222,0.186,0.149,0.095,2548,112.487349,438,1327,0.658560794044665
"2312",141264,"Valdosta State University",1,0,2007,2029,1233,796,316,86,230,0.186,0.156,0.108,2744,123.941775,441,1286,0.633809758501725
"2313",141264,"Valdosta State University",1,0,2008,2106,1223,883,344,93,251,0.205,0.163,0.105,2898,133.896934,469,1245,0.591168091168091
"2314",141264,"Valdosta State University",1,0,2009,2416,1421,995,365,85,280,0.197,0.151,0.085,2978,148.485247,472,1271,0.526076158940397
"2315",141264,"Valdosta State University",1,0,2010,2528,1554,974,401,100,301,0.194,0.159,0.103,3283,157.477266,499,1278,0.505537974683544
"2316",141334,"WEST GEORGIA COLLEGE",0,1,1991,1178,664,514,157,43,114,0.172,0.133,0.084,1653,38.168033,246,901,0.764855687606112
"2317",141334,"WEST GEORGIA COLLEGE",0,1,1992,1182,657,525,141,39,102,0.155,0.119,0.074,2067,39.992769,255,896,0.758037225042301
"2318",141334,"WEST GEORGIA COLLEGE",0,1,1993,1263,738,525,97,19,78,0.106,0.077,0.036,1766,45.204785,272,904,0.71575613618369
"2319",141334,"STATE UNIVERSITY OF WEST GEORGIA",0,1,1995,1430,841,589,128,32,96,0.114,0.09,0.054,2274,53.814116,283,1102,0.770629370629371
"2320",141334,"STATE UNIVERSITY OF WEST GEORGIA",0,1,1996,1296,801,495,141,28,113,0.141,0.109,0.057,2364,60.47179,289,1034,0.797839506172839
"2321",141334,"STATE UNIVERSITY OF WEST GEORGIA",0,1,1997,1208,718,490,135,29,106,0.148,0.112,0.059,2088,65.138221,286,924,0.764900662251656
"2322",141334,"STATE UNIVERSITY OF WEST GEORGIA",1,0,1998,1670,1042,628,166,34,132,0.127,0.099,0.054,2158,71.176193,271,1168,0.69940119760479
"2323",141334,"STATE UNIVERSITY OF WEST GEORGIA",1,0,1999,1604,1005,599,144,34,110,0.11,0.09,0.057,1808,76.048797,318,1151,0.717581047381546
"2324",141334,"STATE UNIVERSITY OF WEST GEORGIA",1,0,2000,1661,987,674,187,34,153,0.155,0.113,0.05,1876,81.072377,331.5,1220,0.734497290788682
"2325",141334,"STATE UNIVERSITY OF WEST GEORGIA",1,0,2001,1551,931,620,194,34,160,0.172,0.125,0.055,2468,88.222709,345,1177,0.75886524822695
"2326",141334,"STATE UNIVERSITY OF WEST GEORGIA",1,0,2002,1617,921,696,181,41,140,0.152,0.112,0.059,2010,92.611703,356,1190,0.735930735930736
"2327",141334,"STATE UNIVERSITY OF WEST GEORGIA",1,0,2003,1738,1020,718,215,47,168,0.165,0.124,0.065,2212,99.979087,308,1249,0.718642117376295
"2328",141334,"STATE UNIVERSITY OF WEST GEORGIA",1,0,2004,1702,976,726,202,67,135,0.138,0.119,0.092,2322,109.311261,383,1198,0.703877790834313
"2329",141334,"University of West Georgia",1,0,2005,1640,966,674,212,47,165,0.171,0.129,0.07,2438,89.042683,383,1124,0.685365853658537
"2330",141334,"University of West Georgia",1,0,2006,1694,1002,692,254,67,187,0.187,0.15,0.097,2548,101.38694,390,1096,0.646989374262102
"2331",141334,"University of West Georgia",1,0,2007,1803,1051,752,311,93,218,0.207,0.172,0.124,2744,109.542911,396,1121,0.621741541874653
"2332",141334,"University of West Georgia",1,0,2008,2008,1216,792,321,88,233,0.192,0.16,0.111,2898,118.242391,412,1284,0.639442231075697
"2333",141334,"University of West Georgia",1,0,2009,1911,1095,816,298,81,217,0.198,0.156,0.099,3996,124.758173,430,885,0.463108320251177
"2334",141334,"University of West Georgia",1,0,2010,1844,1124,720,309,79,230,0.205,0.168,0.11,3696,135.502006,448,747,0.405097613882863
"2335",141486,"CHAMINADE UNIVERSITY OF HONOLULU",1,0,1991,122,73,49,23,9,14,0.192,0.189,0.184,6800,13.502894,56,31,0.254098360655738
"2336",141486,"CHAMINADE UNIVERSITY OF HONOLULU",1,0,1992,127,73,54,23,8,15,0.206,0.181,0.148,7600,13.7375,56,37,0.291338582677165
"2337",141486,"CHAMINADE UNIVERSITY OF HONOLULU",1,0,1993,84,50,34,17,5,12,0.24,0.202,0.147,9990,13.231195,59,25,0.297619047619048
"2338",141486,"CHAMINADE UNIVERSITY OF HONOLULU",1,0,1995,123,72,51,31,12,19,0.264,0.252,0.235,10600,15.261173,57,41,0.333333333333333
"2339",141486,"CHAMINADE UNIVERSITY OF HONOLULU",1,0,1996,152,100,52,31,10,21,0.21,0.204,0.192,10600,17.38635,45,45,0.296052631578947
"2340",141486,"CHAMINADE UNIVERSITY OF HONOLULU",1,0,1997,146,105,41,30,9,21,0.2,0.205,0.22,10800,15.278924,50,47,0.321917808219178
"2341",141486,"CHAMINADE UNIVERSITY OF HONOLULU",1,0,1998,186,122,64,40,12,28,0.23,0.215,0.188,11180,15.837203,50,51,0.274193548387097
"2342",141486,"CHAMINADE UNIVERSITY OF HONOLULU",1,0,1999,231,159,72,49,12,37,0.233,0.212,0.167,11600,17.040571,54,54,0.233766233766234
"2343",141486,"CHAMINADE UNIVERSITY OF HONOLULU",1,0,2000,237,163,74,45,13,32,0.196,0.19,0.176,12040,18.973611,56,59,0.248945147679325
"2344",141486,"CHAMINADE UNIVERSITY OF HONOLULU",1,0,2001,223,160,63,39,11,28,0.175,0.175,0.175,12500,19.083322,58,53,0.237668161434978
"2345",141486,"CHAMINADE UNIVERSITY OF HONOLULU",1,0,2002,212,154,58,23,8,15,0.097,0.108,0.138,12950,21.344619,57,48,0.226415094339623
"2346",141486,"CHAMINADE UNIVERSITY OF HONOLULU",1,0,2003,254,174,80,54,18,36,0.207,0.213,0.225,13380,23.614722,63,72,0.283464566929134
"2347",141486,"CHAMINADE UNIVERSITY OF HONOLULU",1,0,2004,247,167,80,62,21,41,0.246,0.251,0.262,13850,25.527738,67,64,0.259109311740891
"2348",141486,"Chaminade University of Honolulu",1,0,2005,260,182,78,57,12,45,0.247,0.219,0.154,14330,26.863055,69,64,0.246153846153846
"2349",141486,"Chaminade University of Honolulu",1,0,2006,264,185,79,54,17,37,0.2,0.205,0.215,14820,29.235735,74,53,0.200757575757576
"2350",141486,"Chaminade University of Honolulu",1,0,2007,242,156,86,65,18,47,0.301,0.269,0.209,15330,30.765853,74,61,0.252066115702479
"2351",141486,"Chaminade University of Honolulu",1,0,2008,236,161,75,69,18,51,0.317,0.292,0.24,16000,32.990589,61,29,0.122881355932203
"2352",141486,"Chaminade University of Honolulu",1,0,2009,262,164,98,73,25,48,0.293,0.279,0.255,16900,34.584509,62,50,0.190839694656489
"2353",141486,"Chaminade University of Honolulu",1,0,2010,287,203,84,101,29,72,0.355,0.352,0.345,17600,35.082443,71,43,0.149825783972125
"2354",141565,"UNIVERSITY OF HAWAII AT HILO",1,0,1991,198,100,98,10,2,8,0.08,0.051,0.02,1240,36.20684,129,44,0.222222222222222
"2355",141565,"UNIVERSITY OF HAWAII AT HILO",1,0,1992,286,173,113,23,10,13,0.075,0.08,0.088,1280,30.211413,142,51,0.178321678321678
"2356",141565,"UNIVERSITY OF HAWAII AT HILO",1,0,1993,310,190,120,20,4,16,0.084,0.065,0.033,1320,34.308954,141,71,0.229032258064516
"2357",141565,"UNIVERSITY OF HAWAII AT HILO",1,0,1995,359,216,143,32,5,27,0.125,0.089,0.035,1426,38.492387,132,73,0.203342618384401
"2358",141565,"UNIVERSITY OF HAWAII AT HILO",1,0,1996,333,207,126,35,11,24,0.116,0.105,0.087,1826,35.360182,132,62,0.186186186186186
"2359",141565,"UNIVERSITY OF HAWAII AT HILO",1,0,1997,335,202,133,36,11,25,0.124,0.107,0.083,2186,38.34824,142,74,0.22089552238806
"2360",141565,"UNIVERSITY OF HAWAII AT HILO",1,0,1998,351,194,157,24,11,13,0.067,0.068,0.07,2258,37.925322,150,86,0.245014245014245
"2361",141565,"UNIVERSITY OF HAWAII AT HILO",1,0,1999,366,207,159,39,11,28,0.135,0.107,0.069,2280,41.846386,152,98,0.26775956284153
"2362",141565,"UNIVERSITY OF HAWAII AT HILO",1,0,2000,362,223,139,39,13,26,0.117,0.108,0.094,2280,41.507169,157,117,0.323204419889503
"2363",141565,"UNIVERSITY OF HAWAII AT HILO",1,0,2001,400,231,169,53,17,36,0.156,0.132,0.101,2304,46.304247,162,170,0.425
"2364",141565,"UNIVERSITY OF HAWAII AT HILO",1,0,2002,404,238,166,57,17,40,0.168,0.141,0.102,2328,50.086349,161,144,0.356435643564356
"2365",141565,"UNIVERSITY OF HAWAII AT HILO",1,0,2003,423,274,149,54,17,37,0.135,0.128,0.114,2376,52.43117,167,197,0.465721040189125
"2366",141565,"UNIVERSITY OF HAWAII AT HILO",1,0,2004,412,225,187,50,18,32,0.142,0.121,0.096,2424,55.266232,169,146,0.354368932038835
"2367",141565,"University of Hawaii at Hilo",1,0,2005,409,215,194,50,15,35,0.163,0.122,0.077,2472,61.164939,185,133,0.32518337408313
"2368",141565,"University of Hawaii at Hilo",1,0,2006,448,267,181,48,9,39,0.146,0.107,0.05,3000,70.972216,194,123,0.274553571428571
"2369",141565,"University of Hawaii at Hilo",1,0,2007,497,299,198,41,11,30,0.1,0.082,0.056,3528,76.379077,205,122,0.245472837022133
"2370",141565,"University of Hawaii at Hilo",1,0,2008,536,326,210,61,16,45,0.138,0.114,0.076,4056,90.602042,216,125,0.233208955223881
"2371",141565,"University of Hawaii at Hilo",1,0,2009,460,269,191,54,17,37,0.138,0.117,0.089,4584,99.739715,217,93,0.202173913043478
"2372",141565,"University of Hawaii at Hilo",1,0,2010,392,230,162,43,13,30,0.13,0.11,0.08,5112,100.821134,226,71,0.181122448979592
"2373",141574,"UNIVERSITY OF HAWAII AT MANOA",1,0,1991,1462,794,668,117,35,82,0.103,0.08,0.052,1387,376.849761,1080,182,0.124487004103967
"2374",141574,"UNIVERSITY OF HAWAII AT MANOA",1,0,1992,1485,823,662,158,46,112,0.136,0.106,0.069,1437,413.830325,1104,147,0.098989898989899
"2375",141574,"UNIVERSITY OF HAWAII AT MANOA",1,0,1993,1551,899,652,141,44,97,0.108,0.091,0.067,1497,428.136401,1099,196,0.126370083816892
"2376",141574,"UNIVERSITY OF HAWAII AT MANOA",1,0,1995,1671,967,704,184,57,127,0.131,0.11,0.081,1631,466.611193,1039,164,0.0981448234590066
"2377",141574,"UNIVERSITY OF HAWAII AT MANOA",1,0,1996,1357,769,588,154,45,109,0.142,0.113,0.077,2421,449.161192,1090,168,0.123802505526898
"2378",141574,"UNIVERSITY OF HAWAII AT MANOA",1,0,1997,1439,807,632,174,50,124,0.154,0.121,0.079,2949,445.502639,1088,169,0.117442668519805
"2379",141574,"UNIVERSITY OF HAWAII AT MANOA",1,0,1998,1388,795,593,162,55,107,0.135,0.117,0.093,3046,483.988676,1054,149,0.107348703170029
"2380",141574,"UNIVERSITY OF HAWAII AT MANOA",1,0,1999,1421,793,628,164,56,108,0.136,0.115,0.089,3024,481.339849,1044,217,0.152709359605911
"2381",141574,"UNIVERSITY OF HAWAII AT MANOA",1,0,2000,1499,846,653,168,48,120,0.142,0.112,0.074,3024,478.764372,1016.5,294,0.196130753835891
"2382",141574,"UNIVERSITY OF HAWAII AT MANOA",1,0,2001,1521,883,638,224,61,163,0.185,0.147,0.096,3120,484.149346,989,330,0.216962524654832
"2383",141574,"UNIVERSITY OF HAWAII AT MANOA",1,0,2002,1726,970,756,251,74,177,0.182,0.145,0.098,3216,599.3001,1039,435,0.252027809965238
"2384",141574,"UNIVERSITY OF HAWAII AT MANOA",1,0,2003,1878,1035,843,307,92,215,0.208,0.163,0.109,3312,606.846378,1069,545,0.290202342917998
"2385",141574,"UNIVERSITY OF HAWAII AT MANOA",1,0,2004,1892,1039,853,325,109,216,0.208,0.172,0.128,3408,639.514404,1078,578,0.305496828752643
"2386",141574,"University of Hawaii at Manoa",1,0,2005,1923,1060,863,354,128,226,0.213,0.184,0.148,3504,669.00639,1083,413,0.21476859074363
"2387",141574,"University of Hawaii at Manoa",1,0,2006,1679,922,757,293,107,186,0.202,0.175,0.141,4320,728.327568,1119,402,0.239428231089934
"2388",141574,"University of Hawaii at Manoa",1,0,2007,1727,946,781,322,111,211,0.223,0.186,0.142,5136,774.959102,1136,401,0.232194557035321
"2389",141574,"University of Hawaii at Manoa",1,0,2008,1808,1027,781,358,114,244,0.238,0.198,0.146,5952,838.226522,1163,413,0.228429203539823
"2390",141574,"University of Hawaii at Manoa",1,0,2009,1847,984,863,392,155,237,0.241,0.212,0.18,6768,908.664404,1138,406,0.219815917704385
"2391",141574,"University of Hawaii at Manoa",1,0,2010,1776,984,792,439,164,275,0.28,0.247,0.207,7584,826.217,1084,349,0.196509009009009
"2392",142276,"IDAHO STATE UNIVERSITY",1,0,1991,1091,569,522,47,14,33,0.058,0.043,0.027,1230,76.951782,421,972,0.890925756186984
"2393",142276,"IDAHO STATE UNIVERSITY",1,0,1992,1091,556,535,66,22,44,0.079,0.06,0.041,1454,86.37766,439,982,0.900091659028414
"2394",142276,"IDAHO STATE UNIVERSITY",1,0,1993,1165,626,539,44,12,32,0.051,0.038,0.022,1602,93.994182,460,1043,0.895278969957082
"2395",142276,"IDAHO STATE UNIVERSITY",1,0,1995,1363,783,580,37,6,31,0.04,0.027,0.01,1570,106.85874,481,1256,0.921496698459281
"2396",142276,"IDAHO STATE UNIVERSITY",1,0,1996,1378,789,589,49,15,34,0.043,0.036,0.025,2125,119.239115,484,1274,0.924528301886792
"2397",142276,"IDAHO STATE UNIVERSITY",1,0,1997,1400,793,607,44,11,33,0.042,0.031,0.018,2424,122.853638,496,1281,0.915
"2398",142276,"IDAHO STATE UNIVERSITY",1,0,1998,1442,787,655,52,15,37,0.047,0.036,0.023,2590,130.287279,509,1282,0.889042995839112
"2399",142276,"IDAHO STATE UNIVERSITY",1,0,1999,1345,740,605,45,10,35,0.047,0.033,0.017,0,143.395715,536,1205,0.895910780669145
"2400",142276,"IDAHO STATE UNIVERSITY",1,0,2000,1345,781,564,51,9,42,0.054,0.038,0.016,0,146.104691,564,1183,0.879553903345725
"2401",142276,"IDAHO STATE UNIVERSITY",1,0,2001,1485,783,702,53,9,44,0.056,0.036,0.013,0,154.665596,592,1313,0.884175084175084
"2402",142276,"IDAHO STATE UNIVERSITY",1,0,2002,704,474,230,59,5,54,0.114,0.084,0.022,0,157.03908,555,615,0.873579545454545
"2403",142276,"IDAHO STATE UNIVERSITY",1,0,2003,787,499,288,53,10,43,0.086,0.067,0.035,0,158.180499,547,692,0.879288437102922
"2404",142276,"IDAHO STATE UNIVERSITY",1,0,2004,983,522,461,63,18,45,0.086,0.064,0.039,0,171.185489,599,820,0.834181078331638
"2405",142276,"Idaho State University",1,0,2005,909,519,390,74,22,52,0.1,0.081,0.056,0,188.019028,644,762,0.838283828382838
"2406",142276,"Idaho State University",1,0,2006,994,525,469,85,23,62,0.118,0.086,0.049,2689,195.727594,615,804,0.808853118712274
"2407",142276,"Idaho State University",1,0,2007,998,526,472,88,26,62,0.118,0.088,0.055,2882,200.689245,617,803,0.804609218436874
"2408",142276,"Idaho State University",1,0,2008,1031,525,506,94,35,59,0.112,0.091,0.069,3114,216.629911,618,827,0.802133850630456
"2409",142276,"Idaho State University",1,0,2009,1189,599,590,122,47,75,0.125,0.103,0.08,3318,214.709047,581,976,0.820857863751051
"2410",142276,"Idaho State University",1,0,2010,1432,749,683,121,34,87,0.116,0.084,0.05,3800,211.393246,593,650,0.45391061452514
"2411",142285,"UNIVERSITY OF IDAHO",1,0,1991,1273,524,749,140,72,68,0.13,0.11,0.096,1236,151.495672,527,1154,0.906520031421838
"2412",142285,"UNIVERSITY OF IDAHO",1,0,1992,1290,574,716,173,77,96,0.167,0.134,0.108,1296,165.752216,520,1164,0.902325581395349
"2413",142285,"UNIVERSITY OF IDAHO",1,0,1993,1323,613,710,214,71,143,0.233,0.162,0.1,1426,173.035943,546,1167,0.882086167800454
"2414",142285,"UNIVERSITY OF IDAHO",1,0,1995,1242,602,640,225,78,147,0.244,0.181,0.122,1620,195.428084,555,1113,0.896135265700483
"2415",142285,"UNIVERSITY OF IDAHO",1,0,1996,1201,574,627,222,85,137,0.239,0.185,0.136,1768,198.75906,637,1093,0.91007493755204
"2416",142285,"UNIVERSITY OF IDAHO",1,0,1997,1360,687,673,240,82,158,0.23,0.176,0.122,1942,204.26562,638,1220,0.897058823529412
"2417",142285,"UNIVERSITY OF IDAHO",1,0,1998,1481,732,749,297,112,185,0.253,0.201,0.15,2136,209.491418,611,1319,0.890614449696151
"2418",142285,"UNIVERSITY OF IDAHO",1,0,1999,1457,736,721,318,123,195,0.265,0.218,0.171,0,220.869718,585,1295,0.888812628689087
"2419",142285,"UNIVERSITY OF IDAHO",1,0,2000,1560,722,838,311,127,184,0.255,0.199,0.152,0,235.342254,595,1346,0.862820512820513
"2420",142285,"UNIVERSITY OF IDAHO",1,0,2001,1642,791,851,340,122,218,0.276,0.207,0.143,0,265.261846,605,1455,0.886114494518879
"2421",142285,"UNIVERSITY OF IDAHO",1,0,2002,1619,784,835,371,153,218,0.278,0.229,0.183,0,287.864433,560,1384,0.854848672019765
"2422",142285,"UNIVERSITY OF IDAHO",1,0,2003,1590,748,842,393,163,230,0.308,0.247,0.194,0,276.08144,544,1370,0.861635220125786
"2423",142285,"UNIVERSITY OF IDAHO",1,0,2004,1602,755,847,383,147,236,0.313,0.239,0.174,0,277.676742,516,1346,0.84019975031211
"2424",142285,"University of Idaho",1,0,2005,1673,823,850,386,156,230,0.28,0.231,0.184,0,302.110577,525,1416,0.846383741781231
"2425",142285,"University of Idaho",1,0,2006,1582,749,833,369,150,219,0.292,0.233,0.18,0,308.345442,550,1339,0.846396965865992
"2426",142285,"University of Idaho",1,0,2007,1615,764,851,402,173,229,0.3,0.249,0.203,0,317.588762,564,1356,0.839628482972136
"2427",142285,"University of Idaho",1,0,2008,1663,777,886,460,202,258,0.332,0.277,0.228,0,334.568883,591,1401,0.842453397474444
"2428",142285,"University of Idaho",1,0,2009,1754,841,913,512,180,332,0.395,0.292,0.197,0,346.579566,572,1417,0.807867730900798
"2429",142285,"University of Idaho",1,0,2010,1709,799,910,511,226,285,0.357,0.299,0.248,0,349.067948,538,1430,0.836746635459333
"2430",142461,"NORTHWEST NAZARENE COLLEGE",0,1,1991,237,129,108,51,17,34,0.264,0.215,0.157,6966,12.149618,67,220,0.928270042194093
"2431",142461,"NORTHWEST NAZARENE COLLEGE",0,1,1992,284,162,122,82,31,51,0.315,0.289,0.254,8160,13.587047,65,253,0.890845070422535
"2432",142461,"NORTHWEST NAZARENE COLLEGE",0,1,1993,319,180,139,110,42,68,0.378,0.345,0.302,8766,15.356008,71,269,0.843260188087774
"2433",142461,"NORTHWEST NAZARENE COLLEGE",0,1,1995,320,183,137,86,27,59,0.322,0.269,0.197,11145,17.25169,85,37,0.115625
"2434",142461,"NORTHWEST NAZARENE COLLEGE",0,1,1996,264,156,108,18,4,14,0.09,0.068,0.037,11685,17.199652,84,248,0.939393939393939
"2435",142461,"NORTHWEST NAZARENE COLLEGE",0,1,1997,277,148,129,91,37,54,0.365,0.329,0.287,11823,16.395924,81,263,0.949458483754513
"2436",142461,"NORTHWEST NAZARENE COLLEGE",0,1,1998,310,193,117,101,27,74,0.383,0.326,0.231,12456,16.985467,81,299,0.964516129032258
"2437",142461,"NORTHWEST NAZARENE UNIVERSITY",0,1,1999,295,165,130,88,31,57,0.346,0.298,0.238,12510,18.741365,83,275,0.932203389830508
"2438",142461,"NORTHWEST NAZARENE UNIVERSITY",1,0,2000,240,137,103,74,24,50,0.365,0.308,0.233,12990,19.643109,85.5,228,0.95
"2439",142461,"NORTHWEST NAZARENE UNIVERSITY",1,0,2001,265,150,115,83,31,52,0.347,0.313,0.27,13700,22.011776,88,236,0.890566037735849
"2440",142461,"NORTHWEST NAZARENE UNIVERSITY",1,0,2002,276,169,107,87,38,49,0.29,0.315,0.355,14520,23.367983,90,227,0.822463768115942
"2441",142461,"NORTHWEST NAZARENE UNIVERSITY",1,0,2003,241,153,88,89,22,67,0.438,0.369,0.25,15330,25.945527,89,206,0.854771784232365
"2442",142461,"NORTHWEST NAZARENE UNIVERSITY",1,0,2004,247,159,88,99,28,71,0.446,0.401,0.318,15980,26.49978,95,205,0.82995951417004
"2443",142461,"Northwest Nazarene University",1,0,2005,249,168,81,88,24,64,0.381,0.353,0.296,17280,27.144323,98,208,0.835341365461847
"2444",142461,"Northwest Nazarene University",1,0,2006,247,128,119,86,37,49,0.383,0.348,0.311,18430,28.266434,89,199,0.805668016194332
"2445",142461,"Northwest Nazarene University",1,0,2007,220,139,81,70,22,48,0.345,0.318,0.272,19700,29.732802,98,166,0.754545454545455
"2446",142461,"Northwest Nazarene University",1,0,2008,301,169,132,96,34,62,0.367,0.319,0.258,20900,33.062421,101,236,0.784053156146179
"2447",142461,"Northwest Nazarene University",1,0,2009,263,151,112,95,33,62,0.411,0.361,0.295,21930,35.728363,102,204,0.775665399239544
"2448",142461,"Northwest Nazarene University",1,0,2010,253,151,102,78,30,48,0.318,0.308,0.294,22810,35.986947,108,166,0.656126482213439
"2449",143084,"AUGUSTANA COLLEGE",0,1,1991,526,296,230,337,145,192,0.649,0.641,0.63,11175,33.118552,141,455,0.865019011406844
"2450",143084,"AUGUSTANA COLLEGE",0,1,1992,538,309,229,318,119,199,0.644,0.591,0.52,12009,34.016851,137,496,0.921933085501859
"2451",143084,"AUGUSTANA COLLEGE",0,1,1993,498,290,208,309,121,188,0.648,0.62,0.582,12942,35.534631,137,446,0.895582329317269
"2452",143084,"AUGUSTANA COLLEGE",0,1,1995,605,352,253,394,151,243,0.69,0.651,0.597,14064,40.756228,131,549,0.907438016528926
"2453",143084,"AUGUSTANA COLLEGE",0,1,1996,574,345,229,397,153,244,0.707,0.692,0.668,14700,43.662838,135,521,0.907665505226481
"2454",143084,"AUGUSTANA COLLEGE",0,1,1997,564,328,236,400,146,254,0.774,0.709,0.619,15300,38.515836,145,507,0.898936170212766
"2455",143084,"AUGUSTANA COLLEGE",0,1,1998,567,321,246,389,148,241,0.751,0.686,0.602,16323,39.999652,147,527,0.929453262786596
"2456",143084,"AUGUSTANA COLLEGE",0,1,1999,565,338,227,402,161,241,0.713,0.712,0.709,16866,43.336878,139,517,0.915044247787611
"2457",143084,"AUGUSTANA COLLEGE",0,1,2000,610,359,251,443,172,271,0.755,0.726,0.685,17541,44.115997,140.5,564,0.924590163934426
"2458",143084,"AUGUSTANA COLLEGE",0,1,2001,550,310,240,392,167,225,0.726,0.713,0.696,18330,45.902267,142,511,0.929090909090909
"2459",143084,"AUGUSTANA COLLEGE",0,1,2002,601,349,252,417,158,259,0.742,0.694,0.627,19200,47.774239,142,565,0.940099833610649
"2460",143084,"AUGUSTANA COLLEGE",0,1,2003,614,369,245,443,153,290,0.786,0.721,0.624,20397,50.382449,145,558,0.908794788273616
"2461",143084,"AUGUSTANA COLLEGE",0,1,2004,599,321,278,426,178,248,0.773,0.711,0.64,21672,51.93733,144,547,0.913188647746244
"2462",143084,"Augustana College",0,1,2005,679,383,296,474,193,281,0.734,0.698,0.652,22971,54.32142,149,614,0.904270986745214
"2463",143084,"Augustana College",0,1,2006,692,392,300,505,216,289,0.737,0.73,0.72,24408,58.561121,164,625,0.903179190751445
"2464",143084,"Augustana College",0,1,2007,713,418,295,525,199,326,0.78,0.736,0.675,25935,61.74849,173,576,0.807854137447405
"2465",143084,"Augustana College",0,1,2008,640,369,271,454,179,275,0.745,0.709,0.661,30150,66.426258,180,468,0.73125
"2466",143084,"Augustana College",0,1,2009,616,342,274,434,168,266,0.778,0.705,0.613,31326,75.359417,174,512,0.831168831168831
"2467",143084,"Augustana College",0,1,2010,753,432,321,532,206,326,0.755,0.707,0.642,32235,66.418619,184,616,0.818061088977424
"2468",143288,"BLACKBURN COLLEGE",1,0,1991,116,44,72,23,6,17,0.386,0.198,0.083,7750,6.084678,35,91,0.78448275862069
"2469",143288,"BLACKBURN COLLEGE",1,0,1992,148,74,74,52,17,35,0.473,0.351,0.23,7750,5.817705,32,122,0.824324324324324
"2470",143288,"BLACKBURN COLLEGE",1,0,1993,156,76,80,42,15,27,0.355,0.269,0.188,7820,5.299439,25,132,0.846153846153846
"2471",143288,"BLACKBURN COLLEGE",1,0,1995,157,66,91,37,17,20,0.303,0.236,0.187,6500,5.699062,27,142,0.904458598726115
"2472",143288,"BLACKBURN COLLEGE",1,0,1996,142,72,70,35,13,22,0.306,0.246,0.186,6850,6.406186,28,120,0.845070422535211
"2473",143288,"BLACKBURN COLLEGE",1,0,1997,155,81,74,39,11,28,0.346,0.252,0.149,7425,52.110738,29,135,0.870967741935484
"2474",143288,"BLACKBURN COLLEGE",1,0,1998,144,66,78,37,16,21,0.318,0.257,0.205,7880,5.451649,27,123,0.854166666666667
"2475",143288,"BLACKBURN COLLEGE",1,0,1999,145,76,69,44,21,23,0.303,0.303,0.304,7950,4.247773,31,130,0.896551724137931
"2476",143288,"BLACKBURN COLLEGE",1,0,2000,191,107,84,56,18,38,0.355,0.293,0.214,8190,7.075803,32,158,0.827225130890052
"2477",143288,"BLACKBURN COLLEGE",1,0,2001,162,95,67,60,18,42,0.442,0.37,0.269,8600,9.449292,33,120,0.740740740740741
"2478",143288,"BLACKBURN COLLEGE",1,0,2002,147,75,72,44,16,28,0.373,0.299,0.222,9200,9.613474,35,115,0.782312925170068
"2479",143288,"BLACKBURN COLLEGE",1,0,2003,176,82,94,49,19,30,0.366,0.278,0.202,9890,9.326467,35,140,0.795454545454545
"2480",143288,"BLACKBURN COLLEGE",1,0,2004,176,87,89,55,23,32,0.368,0.312,0.258,14600,8.99158,35,146,0.829545454545455
"2481",143288,"Blackburn College",1,0,2005,183,92,91,66,30,36,0.391,0.361,0.33,15040,10.342611,34,164,0.896174863387978
"2482",143288,"Blackburn College",1,0,2006,177,111,66,63,17,46,0.414,0.356,0.258,15700,11.021087,35,148,0.836158192090395
"2483",143288,"Blackburn College",1,0,2007,175,93,82,59,23,36,0.387,0.337,0.28,15770,11.56445,33,148,0.845714285714286
"2484",143288,"Blackburn College",1,0,2008,171,94,77,52,18,34,0.362,0.304,0.234,13500,11.398929,32,149,0.871345029239766
"2485",143288,"Blackburn College",1,0,2009,146,93,53,46,18,28,0.301,0.315,0.34,14176,11.870047,36,128,0.876712328767123
"2486",143288,"Blackburn College",1,0,2010,150,105,45,46,9,37,0.352,0.307,0.2,14176,11.392574,36,119,0.793333333333333
"2487",144005,"CHICAGO STATE UNIVERSITY",1,0,1991,614,414,200,7,3,4,0.01,0.011,0.015,1784,47.923981,293,6,0.00977198697068404
"2488",144005,"CHICAGO STATE UNIVERSITY",1,0,1992,576,351,225,3,2,1,0.003,0.005,0.009,1868,49.315067,308,7,0.0121527777777778
"2489",144005,"CHICAGO STATE UNIVERSITY",1,0,1993,641,432,209,7,1,6,0.014,0.011,0.005,2198,54.696528,351,8,0.0124804992199688
"2490",144005,"CHICAGO STATE UNIVERSITY",1,0,1995,613,410,203,35,3,32,0.078,0.057,0.015,2336,62.264492,339,12,0.0195758564437194
"2491",144005,"CHICAGO STATE UNIVERSITY",1,0,1996,563,409,154,17,4,13,0.032,0.03,0.026,2420,71.093677,356,7,0.0124333925399645
"2492",144005,"CHICAGO STATE UNIVERSITY",1,0,1997,487,332,155,6,1,5,0.015,0.012,0.006,2496,75.284971,362,5,0.0102669404517454
"2493",144005,"CHICAGO STATE UNIVERSITY",1,0,1998,601,399,202,10,3,7,0.018,0.017,0.015,2868,83.282217,355,9,0.0149750415973378
"2494",144005,"CHICAGO STATE UNIVERSITY",1,0,1999,461,329,132,9,3,6,0.018,0.02,0.023,2290,86.601364,329,8,0.017353579175705
"2495",144005,"CHICAGO STATE UNIVERSITY",1,0,2000,345,232,113,10,5,5,0.022,0.029,0.044,2364,95.939812,329,12,0.0347826086956522
"2496",144005,"CHICAGO STATE UNIVERSITY",1,0,2001,395,280,115,16,3,13,0.046,0.041,0.026,2484,99.000079,329,9,0.0227848101265823
"2497",144005,"CHICAGO STATE UNIVERSITY",1,0,2002,438,302,136,11,2,9,0.03,0.025,0.015,2732,99.674052,322,12,0.0273972602739726
"2498",144005,"CHICAGO STATE UNIVERSITY",1,0,2003,476,336,140,12,4,8,0.024,0.025,0.029,3168,94.563271,309,13,0.0273109243697479
"2499",144005,"CHICAGO STATE UNIVERSITY",1,0,2004,563,367,196,17,13,4,0.011,0.03,0.066,4575,122.583667,305,12,0.0213143872113677
"2500",144005,"Chicago State University",1,0,2005,405,268,137,15,4,11,0.041,0.037,0.029,4890,101.817917,306,8,0.0197530864197531
"2501",144005,"Chicago State University",1,0,2006,359,254,105,16,2,14,0.055,0.045,0.019,5090,107.611929,301,9,0.0250696378830084
"2502",144005,"Chicago State University",1,0,2007,372,255,117,15,4,11,0.043,0.04,0.034,5440,117.131377,310,9,0.0241935483870968
"2503",144005,"Chicago State University",1,0,2008,402,279,123,10,4,6,0.021,0.025,0.033,5914,128.952212,303,6,0.0149253731343284
"2504",144005,"Chicago State University",1,0,2009,589,428,161,13,6,7,0.016,0.022,0.037,5976,131.26849,310,12,0.0203735144312394
"2505",144005,"Chicago State University",1,0,2010,523,354,169,14,2,12,0.034,0.027,0.012,6145,134.610114,289,9,0.017208413001912
"2506",144281,"COLUMBIA COLLEGE",1,0,1991,846,439,407,21,8,13,0.03,0.025,0.02,6296,46.142008,157,384,0.453900709219858
"2507",144281,"COLUMBIA COLLEGE",1,0,1992,760,373,387,90,42,48,0.129,0.118,0.109,6664,51.051466,165,378,0.497368421052632
"2508",144281,"COLUMBIA COLLEGE",1,0,1993,817,398,419,95,34,61,0.153,0.116,0.081,6928,54.11192,171,409,0.500611995104039
"2509",144281,"COLUMBIA COLLEGE",1,0,1995,939,464,475,131,67,64,0.138,0.14,0.141,7670,64.408935,191,489,0.520766773162939
"2510",144281,"COLUMBIA COLLEGE",1,0,1996,868,411,457,130,52,78,0.19,0.15,0.114,8030,69.976234,196,484,0.557603686635945
"2511",144281,"COLUMBIA COLLEGE CHICAGO",1,0,1997,1078,519,559,147,61,86,0.166,0.136,0.109,8498,59.4924,187,552,0.512059369202226
"2512",144281,"COLUMBIA COLLEGE CHICAGO",1,0,1998,1210,588,622,229,108,121,0.206,0.189,0.174,9544,67.200738,209,649,0.536363636363636
"2513",144281,"COLUMBIA COLLEGE CHICAGO",1,0,1999,1134,560,574,225,103,122,0.218,0.198,0.179,10690,74.006789,246,572,0.504409171075838
"2514",144281,"COLUMBIA COLLEGE CHICAGO",1,0,2000,1265,640,625,330,139,191,0.298,0.261,0.222,11600,86.101992,263.5,675,0.533596837944664
"2515",144281,"COLUMBIA COLLEGE CHICAGO",1,0,2001,1448,767,681,353,157,196,0.256,0.244,0.231,12524,97.441949,281,811,0.560082872928177
"2516",144281,"COLUMBIA COLLEGE CHICAGO",1,0,2002,1589,854,735,401,164,237,0.278,0.252,0.223,13714,107.88914,288,944,0.594084329767149
"2517",144281,"COLUMBIA COLLEGE CHICAGO",1,0,2003,1446,777,669,389,166,223,0.287,0.269,0.248,14880,123.671558,293,860,0.594744121715076
"2518",144281,"COLUMBIA COLLEGE CHICAGO",1,0,2004,1744,873,871,449,217,232,0.266,0.257,0.249,14880,129.410899,299,1030,0.590596330275229
"2519",144281,"Columbia College Chicago",1,0,2005,1795,933,862,504,219,285,0.306,0.281,0.254,15588,150.364266,302,1148,0.639554317548746
"2520",144281,"Columbia College Chicago",1,0,2006,1972,1025,947,547,247,300,0.293,0.277,0.261,16328,168.53313,316,1229,0.623225152129817
"2521",144281,"Columbia College Chicago",1,0,2007,2166,1148,1018,692,313,379,0.33,0.319,0.307,17104,185.619756,323,1344,0.620498614958449
"2522",144281,"Columbia College Chicago",1,0,2008,2329,1289,1040,690,277,413,0.32,0.296,0.266,17950,208.99151,342,1376,0.590811507084586
"2523",144281,"Columbia College Chicago",1,0,2009,2089,1170,919,616,241,375,0.32,0.295,0.262,18490,222.875929,354,1173,0.561512685495452
"2524",144281,"Columbia College-Chicago",1,0,2010,2209,1252,957,665,258,407,0.325,0.301,0.27,19140,228.147668,364,1278,0.578542326844726
"2525",144740,"DEPAUL UNIVERSITY",0,1,1991,1047,593,454,388,147,241,0.406,0.371,0.324,9342,128.804544,470,748,0.714422158548233
"2526",144740,"DEPAUL UNIVERSITY",0,1,1992,927,520,407,350,119,231,0.444,0.378,0.292,10014,142.220989,494,671,0.723840345199569
"2527",144740,"DEPAUL UNIVERSITY",0,1,1993,1182,701,481,416,159,257,0.367,0.352,0.331,10590,151.393145,500,832,0.703891708967851
"2528",144740,"DEPAUL UNIVERSITY",0,1,1995,1225,700,525,447,177,270,0.386,0.365,0.337,11856,169.629224,500,861,0.702857142857143
"2529",144740,"DEPAUL UNIVERSITY",0,1,1996,1122,668,454,483,184,299,0.448,0.43,0.405,12780,192.116596,515,752,0.670231729055259
"2530",144740,"DEPAUL UNIVERSITY",0,1,1997,1211,713,498,566,212,354,0.496,0.467,0.426,13490,187.929,519,777,0.641618497109827
"2531",144740,"DEPAUL UNIVERSITY",0,1,1998,1448,852,596,591,216,375,0.44,0.408,0.362,14100,201.463,532,903,0.623618784530387
"2532",144740,"DEPAUL UNIVERSITY",0,1,1999,1700,997,703,771,299,472,0.473,0.454,0.425,14670,218.058,581,1037,0.61
"2533",144740,"DEPAUL UNIVERSITY",0,1,2000,1897,1140,757,852,308,544,0.477,0.449,0.407,15390,242.485,647.5,1232,0.649446494464945
"2534",144740,"DEPAUL UNIVERSITY",0,1,2001,2042,1180,862,866,325,541,0.458,0.424,0.377,16500,272.705138,714,1242,0.60822722820764
"2535",144740,"DEPAUL UNIVERSITY",0,1,2002,2231,1323,908,985,346,639,0.483,0.442,0.381,17820,315.686,775,1271,0.569699686239355
"2536",144740,"DEPAUL UNIVERSITY",0,1,2003,2249,1351,898,966,341,625,0.463,0.43,0.38,20555,338.177,832,1381,0.614050689195198
"2537",144740,"DEPAUL UNIVERSITY",0,1,2004,2304,1367,937,1097,377,720,0.527,0.476,0.402,21669,354.129,839,1425,0.618489583333333
"2538",144740,"DePaul University",0,1,2005,2392,1411,981,1168,450,718,0.509,0.488,0.459,22789,343.253,834,1566,0.654682274247492
"2539",144740,"DePaul University",0,1,2006,2531,1428,1103,1280,482,798,0.559,0.506,0.437,22365,352.61,850,1652,0.652706440142236
"2540",144740,"DePaul University",0,1,2007,2513,1458,1055,1363,522,841,0.577,0.542,0.495,23820,367.955,870,1580,0.628730600875448
"2541",144740,"DePaul University",0,1,2008,2553,1502,1051,1430,537,893,0.595,0.56,0.511,25770,401.324,899,1574,0.616529573051312
"2542",144740,"DePaul University",0,1,2009,2523,1494,1029,1425,538,887,0.594,0.565,0.523,26765,434.34,919,1412,0.559651208878319
"2543",144740,"DePaul University",0,1,2010,2235,1307,928,1313,501,812,0.621,0.587,0.54,28240,462.184,938,1337,0.59821029082774
"2544",144892,"EASTERN ILLINOIS UNIVERSITY",1,0,1991,1493,911,582,577,185,392,0.43,0.386,0.318,2358,99.245217,555,1342,0.898861352980576
"2545",144892,"EASTERN ILLINOIS UNIVERSITY",1,0,1992,1463,893,570,464,132,332,0.372,0.317,0.232,2533,98.153506,564,1309,0.894736842105263
"2546",144892,"EASTERN ILLINOIS UNIVERSITY",1,0,1993,1612,969,643,471,112,359,0.37,0.292,0.174,2600,99.217939,562,1457,0.903846153846154
"2547",144892,"EASTERN ILLINOIS UNIVERSITY",1,0,1995,1538,973,565,468,117,351,0.361,0.304,0.207,2777,110.409371,578,1349,0.877113133940182
"2548",144892,"EASTERN ILLINOIS UNIVERSITY",1,0,1996,1640,1000,640,505,126,379,0.379,0.308,0.197,2905,113.795696,572,1451,0.884756097560976
"2549",144892,"EASTERN ILLINOIS UNIVERSITY",1,0,1997,1552,950,602,479,121,358,0.377,0.309,0.201,3078,121.7891,579,1373,0.884664948453608
"2550",144892,"EASTERN ILLINOIS UNIVERSITY",1,0,1998,1604,984,620,547,148,399,0.405,0.341,0.239,3232,128.816683,568,1418,0.884039900249377
"2551",144892,"EASTERN ILLINOIS UNIVERSITY",1,0,1999,1478,929,549,482,131,351,0.378,0.326,0.239,2254,136.363384,558,1277,0.864005412719892
"2552",144892,"EASTERN ILLINOIS UNIVERSITY",1,0,2000,1495,870,625,471,151,320,0.368,0.315,0.242,2910,144.944336,531.5,1294,0.865551839464883
"2553",144892,"EASTERN ILLINOIS UNIVERSITY",1,0,2001,1431,836,595,445,135,310,0.371,0.311,0.227,2993,153.746216,505,1216,0.849755415793152
"2554",144892,"EASTERN ILLINOIS UNIVERSITY",1,0,2002,1984,1143,841,582,183,399,0.349,0.293,0.218,3254,153.91178,554,1714,0.863911290322581
"2555",144892,"EASTERN ILLINOIS UNIVERSITY",1,0,2003,1892,1098,794,563,185,378,0.344,0.298,0.233,3563,154.469375,565,1682,0.889006342494715
"2556",144892,"EASTERN ILLINOIS UNIVERSITY",1,0,2004,1725,1032,693,594,177,417,0.404,0.344,0.255,3830,202.18929,599,1524,0.883478260869565
"2557",144892,"Eastern Illinois University",1,0,2005,1645,967,678,521,168,353,0.365,0.317,0.248,4629,178.398588,605,1286,0.781762917933131
"2558",144892,"Eastern Illinois University",1,0,2006,1760,1062,698,583,164,419,0.394,0.331,0.235,5207,183.290867,609,1399,0.794886363636364
"2559",144892,"Eastern Illinois University",1,0,2007,1641,988,653,551,171,380,0.385,0.336,0.262,5832,196.036538,622,1259,0.767215112736137
"2560",144892,"Eastern Illinois University",1,0,2008,1764,1029,735,582,196,386,0.375,0.33,0.267,6540,207.289294,643,1333,0.755668934240363
"2561",144892,"Eastern Illinois University",1,0,2009,1637,997,640,520,178,342,0.343,0.318,0.278,7170,220.640117,630,1181,0.721441661576054
"2562",144892,"Eastern Illinois University",1,0,2010,1446,892,554,492,157,335,0.376,0.34,0.283,6835,236.288982,617,1039,0.718533886583679
"2563",144962,"ELMHURST COLLEGE",1,0,1991,247,130,117,99,38,61,0.469,0.401,0.325,8460,24.304199,97,199,0.805668016194332
"2564",144962,"ELMHURST COLLEGE",1,0,1992,229,128,101,92,29,63,0.492,0.402,0.287,9050,25.121077,99,175,0.764192139737991
"2565",144962,"ELMHURST COLLEGE",1,0,1993,252,140,112,99,41,58,0.414,0.393,0.366,9676,25.453884,97,191,0.757936507936508
"2566",144962,"ELMHURST COLLEGE",1,0,1995,253,147,106,128,41,87,0.592,0.506,0.387,10264,29.577816,96,195,0.770750988142292
"2567",144962,"ELMHURST COLLEGE",1,0,1996,222,137,85,130,49,81,0.591,0.586,0.576,10976,32.23892,99,181,0.815315315315315
"2568",144962,"ELMHURST COLLEGE",1,0,1997,289,155,134,2,1,1,0.007,0.007,0.007,11900,28.528453,101,230,0.795847750865052
"2569",144962,"ELMHURST COLLEGE",1,0,1998,266,152,114,154,51,103,0.678,0.579,0.447,12870,31.448109,106,211,0.793233082706767
"2570",144962,"ELMHURST COLLEGE",1,0,1999,269,156,113,158,58,100,0.641,0.587,0.513,13900,32.472522,109,220,0.817843866171004
"2571",144962,"ELMHURST COLLEGE",1,0,2000,301,185,116,183,50,133,0.719,0.608,0.431,15000,36.098921,110.5,237,0.787375415282392
"2572",144962,"ELMHURST COLLEGE",1,0,2001,302,169,133,153,47,106,0.627,0.507,0.353,16200,37.034014,112,222,0.735099337748344
"2573",144962,"ELMHURST COLLEGE",1,0,2002,295,185,110,157,41,116,0.627,0.532,0.373,17500,38.308211,113,243,0.823728813559322
"2574",144962,"ELMHURST COLLEGE",1,0,2003,366,230,136,194,54,140,0.609,0.53,0.397,18600,39.466168,110,279,0.762295081967213
"2575",144962,"ELMHURST COLLEGE",1,0,2004,386,225,161,215,66,149,0.662,0.557,0.41,20090,40.536688,108,300,0.77720207253886
"2576",144962,"Elmhurst College",1,0,2005,466,282,184,252,84,168,0.596,0.541,0.457,21600,43.700544,121,364,0.781115879828326
"2577",144962,"Elmhurst College",1,0,2006,484,296,188,275,100,175,0.591,0.568,0.532,23100,49.87365,124,380,0.785123966942149
"2578",144962,"Elmhurst College",1,0,2007,508,304,204,300,99,201,0.661,0.591,0.485,24600,53.530904,129,394,0.775590551181102
"2579",144962,"Elmhurst College",1,0,2008,576,348,228,350,113,237,0.681,0.608,0.496,26000,57.249076,141,453,0.786458333333333
"2580",144962,"Elmhurst College",1,0,2009,584,341,243,317,106,211,0.619,0.543,0.436,27270,65.78402,144,435,0.74486301369863
"2581",144962,"Elmhurst College",1,0,2010,537,330,207,301,99,202,0.612,0.561,0.478,28600,66.456399,145,436,0.811918063314711
"2582",144971,"EUREKA COLLEGE",1,0,1991,129,70,59,54,21,33,0.471,0.419,0.356,9425,7.971528,39,112,0.868217054263566
"2583",144971,"EUREKA COLLEGE",1,0,1992,119,60,59,53,22,31,0.517,0.445,0.373,10325,9.372937,37,110,0.92436974789916
"2584",144971,"EUREKA COLLEGE",1,0,1993,109,45,64,50,26,24,0.533,0.459,0.406,11105,9.77588,37,96,0.880733944954128
"2585",144971,"EUREKA COLLEGE",1,0,1995,139,58,81,68,35,33,0.569,0.489,0.432,12505,9.858249,36,129,0.928057553956835
"2586",144971,"EUREKA COLLEGE",1,0,1996,128,67,61,55,19,36,0.537,0.43,0.311,13216,9.945163,37,118,0.921875
"2587",144971,"EUREKA COLLEGE",1,0,1997,141,50,91,54,25,29,0.58,0.383,0.275,13950,8.363892,40,135,0.957446808510638
"2588",144971,"EUREKA COLLEGE",1,0,1998,114,57,57,65,31,34,0.597,0.57,0.544,14790,9.055544,44,105,0.921052631578947
"2589",144971,"EUREKA COLLEGE",1,0,1999,130,76,54,60,19,41,0.54,0.462,0.352,15200,9.342022,43,119,0.915384615384615
"2590",144971,"EUREKA COLLEGE",1,0,2000,121,72,49,49,17,32,0.444,0.405,0.347,15850,9.946518,45,102,0.84297520661157
"2591",144971,"EUREKA COLLEGE",1,0,2001,146,75,71,60,26,34,0.453,0.411,0.366,16600,10.443157,47,125,0.856164383561644
"2592",144971,"EUREKA COLLEGE",1,0,2002,136,70,66,50,16,34,0.486,0.368,0.242,17430,10.609122,42,106,0.779411764705882
"2593",144971,"EUREKA COLLEGE",1,0,2003,92,44,48,15,5,10,0.227,0.163,0.104,18700,10.468631,43,79,0.858695652173913
"2594",144971,"EUREKA COLLEGE",1,0,2004,116,57,59,35,15,20,0.351,0.302,0.254,13000,10.051049,44,97,0.836206896551724
"2595",144971,"Eureka College",1,0,2005,138,74,64,66,29,37,0.5,0.478,0.453,13000,10.678181,42,120,0.869565217391304
"2596",144971,"Eureka College",1,0,2006,137,74,63,54,26,28,0.378,0.394,0.413,13760,11.757462,43,120,0.875912408759124
"2597",144971,"Eureka College",1,0,2007,122,73,49,53,15,38,0.52,0.434,0.306,14800,11.4401,36,112,0.918032786885246
"2598",144971,"Eureka College",1,0,2008,153,75,78,53,18,35,0.467,0.346,0.231,15675,12.287276,44,125,0.816993464052288
"2599",144971,"Eureka College",1,0,2009,143,75,68,55,23,32,0.427,0.385,0.338,16650,14.08954,42,125,0.874125874125874
"2600",144971,"Eureka College",1,0,2010,174,92,82,70,30,40,0.435,0.402,0.366,17275,14.059757,43,148,0.850574712643678
"2601",145600,"UNIVERSITY OF ILLINOIS AT CHICAGO",1,0,1991,2356,1233,1123,197,83,114,0.092,0.084,0.074,3077,698.517911,1126,960,0.407470288624788
"2602",145600,"UNIVERSITY OF ILLINOIS AT CHICAGO",1,0,1992,2475,1273,1202,240,95,145,0.114,0.097,0.079,3371,732.529072,1144,995,0.402020202020202
"2603",145600,"UNIVERSITY OF ILLINOIS AT CHICAGO",1,0,1993,2589,1360,1229,229,85,144,0.106,0.088,0.069,3439,817.999541,1135,1022,0.394747006566242
"2604",145600,"UNIVERSITY OF ILLINOIS AT CHICAGO",1,0,1995,2469,1401,1068,309,110,199,0.142,0.125,0.103,3974,931.100466,1152,1024,0.414742810854597
"2605",145600,"UNIVERSITY OF ILLINOIS AT CHICAGO",1,0,1996,2720,1505,1215,454,179,275,0.183,0.167,0.147,4188,955.364563,1163,1176,0.432352941176471
"2606",145600,"UNIVERSITY OF ILLINOIS AT CHICAGO",1,0,1997,2820,1560,1260,460,165,295,0.189,0.163,0.131,4358,983.575916,1087,1107,0.392553191489362
"2607",145600,"UNIVERSITY OF ILLINOIS AT CHICAGO",1,0,1998,2880,1629,1251,465,166,299,0.184,0.161,0.133,4498,1011.811671,1088,1143,0.396875
"2608",145600,"UNIVERSITY OF ILLINOIS AT CHICAGO",1,0,1999,2552,1381,1171,506,215,291,0.211,0.198,0.184,3138,1064.093134,1043,1039,0.407131661442006
"2609",145600,"UNIVERSITY OF ILLINOIS AT CHICAGO",1,0,2000,2762,1557,1205,588,203,385,0.247,0.213,0.168,3232,1153.833824,1169,1069,0.387038377986966
"2610",145600,"UNIVERSITY OF ILLINOIS AT CHICAGO",1,0,2001,2637,1470,1167,590,210,380,0.258,0.224,0.18,3830,1232.57335,1295,1084,0.411073189230186
"2611",145600,"UNIVERSITY OF ILLINOIS AT CHICAGO",1,0,2002,2952,1674,1278,607,248,359,0.214,0.206,0.194,4664,1430.240136,1271,1179,0.399390243902439
"2612",145600,"UNIVERSITY OF ILLINOIS AT CHICAGO",1,0,2003,2880,1573,1307,702,275,427,0.272,0.244,0.21,4898,1530.504423,1237,1095,0.380208333333333
"2613",145600,"UNIVERSITY OF ILLINOIS AT CHICAGO",1,0,2004,2671,1488,1183,681,278,403,0.271,0.255,0.235,5682,1818.701659,1236,983,0.368026956196181
"2614",145600,"University of Illinois at Chicago",1,0,2005,2759,1534,1225,742,294,448,0.292,0.269,0.24,6194,1682.972269,1182,1009,0.365712214570497
"2615",145600,"University of Illinois at Chicago",1,0,2006,2830,1554,1276,878,380,498,0.32,0.31,0.298,6780,1744.271713,1202,1153,0.407420494699647
"2616",145600,"University of Illinois at Chicago",1,0,2007,3272,1813,1459,978,390,588,0.324,0.299,0.267,7424,1827.433746,1212,1335,0.408007334963325
"2617",145600,"University of Illinois at Chicago",1,0,2008,2944,1659,1285,981,392,589,0.355,0.333,0.305,8130,1981.447266,1239,1178,0.400135869565217
"2618",145600,"University of Illinois at Chicago",1,0,2009,3126,1680,1446,1056,411,645,0.384,0.338,0.284,8342,2072.104886,1199,1209,0.386756238003839
"2619",145600,"University of Illinois at Chicago",1,0,2010,3185,1731,1454,984,387,597,0.345,0.309,0.266,9133,2111.921111,1185,1191,0.373940345368917
"2620",145619,"ILLINOIS BENEDICTINE COLLEGE",1,0,1991,246,117,129,87,37,50,0.427,0.354,0.287,8980,19.355513,88,165,0.670731707317073
"2621",145619,"ILLINOIS BENEDICTINE COLLEGE",1,0,1992,230,110,120,102,43,59,0.536,0.443,0.358,9300,22.415411,88,159,0.691304347826087
"2622",145619,"ILLINOIS BENEDICTINE COLLEGE",1,0,1993,270,125,145,104,43,61,0.488,0.385,0.297,9950,24.974753,91,205,0.759259259259259
"2623",145619,"BENEDICTINE UNIVERSITY",1,0,1995,245,123,122,95,38,57,0.463,0.388,0.311,11030,28.398152,85,160,0.653061224489796
"2624",145619,"BENEDICTINE UNIVERSITY",1,0,1996,231,112,119,82,30,52,0.464,0.355,0.252,11790,29.822977,87,141,0.61038961038961
"2625",145619,"BENEDICTINE UNIVERSITY",1,0,1997,300,129,171,117,56,61,0.473,0.39,0.327,11990,23.625476,85,191,0.636666666666667
"2626",145619,"BENEDICTINE UNIVERSITY",1,0,1998,299,160,139,93,35,58,0.362,0.311,0.252,12600,27.435386,84,173,0.578595317725752
"2627",145619,"BENEDICTINE UNIVERSITY",1,0,1999,259,127,132,74,30,44,0.346,0.286,0.227,13700,31.691384,84,145,0.55984555984556
"2628",145619,"BENEDICTINE UNIVERSITY",1,0,2000,278,156,122,114,45,69,0.442,0.41,0.369,14500,29.149461,90,103,0.370503597122302
"2629",145619,"BENEDICTINE UNIVERSITY",1,0,2001,262,159,103,120,41,79,0.497,0.458,0.398,15200,32.798742,96,125,0.477099236641221
"2630",145619,"BENEDICTINE UNIVERSITY",1,0,2002,303,165,138,150,56,94,0.57,0.495,0.406,16250,34.707189,96,161,0.531353135313531
"2631",145619,"BENEDICTINE UNIVERSITY",1,0,2003,302,169,133,116,49,67,0.396,0.384,0.368,16960,35.327263,96,137,0.45364238410596
"2632",145619,"BENEDICTINE UNIVERSITY",1,0,2004,301,151,150,121,53,68,0.45,0.402,0.353,17800,37.914346,91,125,0.415282392026578
"2633",145619,"Benedictine University",1,0,2005,308,163,145,97,42,55,0.337,0.315,0.29,18700,40.171769,88,98,0.318181818181818
"2634",145619,"Benedictine University",1,0,2006,379,189,190,139,57,82,0.434,0.367,0.3,19800,43.390665,89,167,0.440633245382586
"2635",145619,"Benedictine University",1,0,2007,385,185,200,146,68,78,0.422,0.379,0.34,20800,47.170224,93,159,0.412987012987013
"2636",145619,"Benedictine University",1,0,2008,434,227,207,141,57,84,0.37,0.325,0.275,21600,51.72381,101,142,0.327188940092166
"2637",145619,"Benedictine University",1,0,2009,451,215,236,156,68,88,0.409,0.346,0.288,21600,58.239464,104,169,0.374722838137472
"2638",145619,"Benedictine University",1,0,2010,548,311,237,197,63,134,0.431,0.359,0.266,22500,63.950332,108,190,0.346715328467153
"2639",145637,"UNIVERSITY OF ILLINOIS URBANA CAMPUS",1,0,1991,5649,2615,3034,2770,1300,1470,0.562,0.49,0.428,3184,768.487322,1937,4125,0.730217737652682
"2640",145637,"UNIVERSITY OF ILLINOIS URBANA CAMPUS",1,0,1992,5491,2566,2925,2656,1267,1389,0.541,0.484,0.433,3458,771.805427,1905,3918,0.713531232926607
"2641",145637,"UNIVERSITY OF ILLINOIS AT URBANA",1,0,1993,5705,2588,3117,2665,1307,1358,0.525,0.467,0.419,3506,805.182519,1868,4068,0.713058720420684
"2642",145637,"UNIVERSITY OF ILLINOIS AT URBANA",1,0,1995,6101,2944,3157,3312,1492,1820,0.618,0.543,0.473,3958,863.141803,1831,4379,0.717751188329782
"2643",145637,"UNIVERSITY OF ILLINOIS AT URBANA",1,0,1996,5938,2865,3073,3321,1507,1814,0.633,0.559,0.49,4153,872.884862,1855,4184,0.704614348265409
"2644",145637,"UNIVERSITY OF ILLINOIS AT URBANA",1,0,1997,5789,2865,2924,3331,1523,1808,0.631,0.575,0.521,4340,919.154765,1765,4051,0.69977543617205
"2645",145637,"UNIVERSITY OF ILLINOIS AT URBANA",1,0,1998,6453,3174,3279,3729,1680,2049,0.646,0.578,0.512,4554,967.05257,1730,4500,0.697350069735007
"2646",145637,"UNIVERSITY OF ILLINOIS AT URBANA",1,0,1999,6458,3131,3327,3849,1733,2116,0.676,0.596,0.521,3546,1011.771729,1759,4521,0.700061938680706
"2647",145637,"UNIVERSITY OF ILLINOIS AT URBANA-CHAMPAIGN",1,0,2000,6167,2990,3177,3737,1692,2045,0.684,0.606,0.533,3724,1063.13113,2019.5,4241,0.687692557159073
"2648",145637,"UNIVERSITY OF ILLINOIS AT URBANA-CHAMPAIGN",1,0,2001,6234,3008,3226,3886,1789,2097,0.697,0.623,0.555,4410,1121.713552,2280,4149,0.665543792107796
"2649",145637,"UNIVERSITY OF ILLINOIS AT URBANA-CHAMPAIGN",1,0,2002,6354,3120,3234,4027,1814,2213,0.709,0.634,0.561,5302,1342.798333,2259,4322,0.68020144790683
"2650",145637,"UNIVERSITY OF ILLINOIS AT URBANA-CHAMPAIGN",1,0,2003,6807,3268,3539,4390,2070,2320,0.71,0.645,0.585,5568,1470.22041,2229,4543,0.66740120464228
"2651",145637,"UNIVERSITY OF ILLINOIS AT URBANA-CHAMPAIGN",1,0,2004,7225,3555,3670,4848,2215,2633,0.741,0.671,0.604,6460,1809.047742,2205,4897,0.677785467128028
"2652",145637,"University of Illinois at Urbana-Champaign",1,0,2005,7565,3511,4054,4966,2375,2591,0.738,0.656,0.586,7042,1654.324359,2124,5099,0.674025115664243
"2653",145637,"University of Illinois at Urbana-Champaign",1,0,2006,7152,3518,3634,4881,2256,2625,0.746,0.682,0.621,7708,1719.621509,2184,4656,0.651006711409396
"2654",145637,"University of Illinois at Urbana-Champaign",1,0,2007,6930,3295,3635,4722,2281,2441,0.741,0.681,0.628,8440,1775.062977,2193,4412,0.636652236652237
"2655",145637,"University of Illinois at Urbana-Champaign",1,0,2008,7277,3386,3891,5015,2439,2576,0.761,0.689,0.627,9242,1894.50227,2203,4416,0.60684347945582
"2656",145637,"University of Illinois at Urbana-Champaign",1,0,2009,6974,3332,3642,4938,2317,2621,0.787,0.708,0.636,9484,1966.956879,2204,4310,0.618009750501864
"2657",145637,"University of Illinois at Urbana-Champaign",1,0,2010,6921,3054,3867,4823,2414,2409,0.789,0.697,0.624,11003,2047.223003,2112,3940,0.569281895679815
"2658",145691,"ILLINOIS COLLEGE",1,0,1991,241,117,124,85,39,46,0.393,0.353,0.315,6600,13.116937,47,232,0.962655601659751
"2659",145691,"ILLINOIS COLLEGE",1,0,1992,260,136,124,114,35,79,0.581,0.438,0.282,7050,13.509299,48,255,0.980769230769231
"2660",145691,"ILLINOIS COLLEGE",1,0,1993,261,150,111,113,34,79,0.527,0.433,0.306,7550,13.908128,51,253,0.969348659003831
"2661",145691,"ILLINOIS COLLEGE",1,0,1995,223,139,84,98,30,68,0.489,0.439,0.357,8600,16.989597,52,216,0.968609865470852
"2662",145691,"ILLINOIS COLLEGE",1,0,1996,200,123,77,87,22,65,0.528,0.435,0.286,9150,18.045915,53,191,0.955
"2663",145691,"ILLINOIS COLLEGE",1,0,1997,242,148,94,102,30,72,0.486,0.421,0.319,9500,15.020037,54,230,0.950413223140496
"2664",145691,"ILLINOIS COLLEGE",1,0,1998,238,133,105,107,37,70,0.526,0.45,0.352,9850,13.048461,55,224,0.941176470588235
"2665",145691,"ILLINOIS COLLEGE",1,0,1999,241,131,110,97,34,63,0.481,0.402,0.309,10200,13.862874,55,224,0.929460580912863
"2666",145691,"ILLINOIS COLLEGE",1,0,2000,239,128,111,102,32,70,0.547,0.427,0.288,10735,14.693151,55.5,216,0.903765690376569
"2667",145691,"ILLINOIS COLLEGE",1,0,2001,205,113,92,94,37,57,0.504,0.459,0.402,11272,15.852164,56,190,0.926829268292683
"2668",145691,"ILLINOIS COLLEGE",1,0,2002,306,170,136,156,60,96,0.565,0.51,0.441,11850,17.38358,57,287,0.937908496732026
"2669",145691,"ILLINOIS COLLEGE",1,0,2003,318,180,138,157,59,98,0.544,0.494,0.428,13300,19.059815,61,285,0.89622641509434
"2670",145691,"ILLINOIS COLLEGE",1,0,2004,258,136,122,135,49,86,0.632,0.523,0.402,14600,22.155992,74,237,0.918604651162791
"2671",145691,"Illinois College",1,0,2005,256,117,139,124,60,64,0.547,0.484,0.432,15500,21.922063,71,232,0.90625
"2672",145691,"Illinois College",1,0,2006,293,154,139,148,49,99,0.643,0.505,0.353,16610,23.768814,74,260,0.887372013651877
"2673",145691,"Illinois College",1,0,2007,258,125,133,144,58,86,0.688,0.558,0.436,17600,23.119038,72,228,0.883720930232558
"2674",145691,"Illinois College",1,0,2008,166,84,82,110,51,59,0.702,0.663,0.622,18500,24.819013,75,136,0.819277108433735
"2675",145691,"Illinois College",1,0,2009,224,99,125,139,71,68,0.687,0.621,0.568,20900,27.300199,75,191,0.852678571428571
"2676",145691,"Illinois College",1,0,2010,225,113,112,134,58,76,0.673,0.596,0.518,22350,25.920254,75,169,0.751111111111111
"2677",145813,"ILLINOIS STATE UNIVERSITY",1,0,1991,3055,1757,1298,849,286,563,0.32,0.278,0.22,2430,176.783274,738,2588,0.847135842880524
"2678",145813,"ILLINOIS STATE UNIVERSITY",1,0,1992,2898,1706,1192,772,229,543,0.318,0.266,0.192,2871,175.864879,715,2457,0.847826086956522
"2679",145813,"ILLINOIS STATE UNIVERSITY",1,0,1993,2387,1440,947,648,183,465,0.323,0.271,0.193,3253,185.095563,720,1915,0.802262253875157
"2680",145813,"ILLINOIS STATE UNIVERSITY",1,0,1995,2950,1798,1152,823,240,583,0.324,0.279,0.208,3544,185.783514,772,2460,0.833898305084746
"2681",145813,"ILLINOIS STATE UNIVERSITY",1,0,1996,2888,1793,1095,877,245,632,0.352,0.304,0.224,3720,215.43066,773,2416,0.836565096952909
"2682",145813,"ILLINOIS STATE UNIVERSITY",1,0,1997,3253,1981,1272,1016,297,719,0.363,0.312,0.233,3969,227.553572,784,2723,0.837073470642484
"2683",145813,"ILLINOIS STATE UNIVERSITY",1,0,1998,2740,1728,1012,915,268,647,0.374,0.334,0.265,4085,246.22524,807,2281,0.832481751824818
"2684",145813,"ILLINOIS STATE UNIVERSITY",1,0,1999,3067,1907,1160,1072,301,771,0.404,0.35,0.259,3127,266.933319,839,2690,0.87707857841539
"2685",145813,"ILLINOIS STATE UNIVERSITY",1,0,2000,3254,1996,1258,1204,347,857,0.429,0.37,0.276,3219,272.855575,852,2891,0.888444990780578
"2686",145813,"ILLINOIS STATE UNIVERSITY",1,0,2001,3331,2080,1251,1316,364,952,0.458,0.395,0.291,3332,294.92123,865,2943,0.883518462924047
"2687",145813,"ILLINOIS STATE UNIVERSITY",1,0,2002,3097,1933,1164,1279,366,913,0.472,0.413,0.314,3640,310.419011,799,2763,0.892153697126251
"2688",145813,"ILLINOIS STATE UNIVERSITY",1,0,2003,3088,1934,1154,1294,411,883,0.457,0.419,0.356,3640,307.078429,833,2639,0.854598445595855
"2689",145813,"ILLINOIS STATE UNIVERSITY",1,0,2004,2824,1739,1085,1280,392,888,0.511,0.453,0.361,4800,370.931598,821,2290,0.810906515580737
"2690",145813,"Illinois State University",1,0,2005,3167,1970,1197,1388,419,969,0.492,0.438,0.35,5400,316.259877,820,2541,0.802336596147774
"2691",145813,"Illinois State University",1,0,2006,3188,1915,1273,1496,471,1025,0.535,0.469,0.37,6150,332.585619,833,2681,0.840966122961104
"2692",145813,"Illinois State University",1,0,2007,3140,1887,1253,1457,455,1002,0.531,0.464,0.363,6999,350.200037,815,2650,0.843949044585987
"2693",145813,"Illinois State University",1,0,2008,3387,2088,1299,1545,503,1042,0.499,0.456,0.387,7680,375.579344,834,2838,0.837909654561559
"2694",145813,"Illinois State University",1,0,2009,3060,1816,1244,1462,500,962,0.53,0.478,0.402,8280,399.698341,864,2413,0.788562091503268
"2695",145813,"Illinois State University",1,0,2010,3179,1914,1265,1512,499,1013,0.529,0.476,0.394,8051,442.190509,852,2591,0.815036174897767
"2696",146481,"LAKE FOREST COLLEGE",1,0,1991,234,124,110,123,53,70,0.565,0.526,0.482,13895,22.187242,85,201,0.858974358974359
"2697",146481,"LAKE FOREST COLLEGE",1,0,1992,235,123,112,145,66,79,0.642,0.617,0.589,15085,23.652563,82,183,0.778723404255319
"2698",146481,"LAKE FOREST COLLEGE",1,0,1993,271,140,131,148,65,83,0.593,0.546,0.496,16175,24.262824,81,224,0.826568265682657
"2699",146481,"LAKE FOREST COLLEGE",1,0,1995,266,155,111,156,58,98,0.632,0.586,0.523,18116,27.678797,76,218,0.819548872180451
"2700",146481,"LAKE FOREST COLLEGE",1,0,1996,324,152,172,188,90,98,0.645,0.58,0.523,19000,29.479323,76,254,0.783950617283951
"2701",146481,"LAKE FOREST COLLEGE",1,0,1997,337,191,146,205,77,128,0.67,0.608,0.527,19560,24.30596,81,264,0.783382789317507
"2702",146481,"LAKE FOREST COLLEGE",1,0,1998,302,177,125,167,63,104,0.588,0.553,0.504,20080,25.845507,83,246,0.814569536423841
"2703",146481,"LAKE FOREST COLLEGE",1,0,1999,341,208,133,216,80,136,0.654,0.633,0.602,20240,27.70797,76,270,0.791788856304985
"2704",146481,"LAKE FOREST COLLEGE",1,0,2000,335,187,148,194,78,116,0.62,0.579,0.527,20900,29.747204,80,282,0.841791044776119
"2705",146481,"LAKE FOREST COLLEGE",1,0,2001,336,188,148,214,83,131,0.697,0.637,0.561,21896,31.782892,84,256,0.761904761904762
"2706",146481,"LAKE FOREST COLLEGE",1,0,2002,358,219,139,213,71,142,0.648,0.595,0.511,22976,32.66929,84,270,0.754189944134078
"2707",146481,"LAKE FOREST COLLEGE",1,0,2003,347,194,153,203,86,117,0.603,0.585,0.562,24096,34.690359,84,260,0.749279538904899
"2708",146481,"LAKE FOREST COLLEGE",1,0,2004,405,247,158,257,83,174,0.705,0.635,0.525,25518,35.853135,86,322,0.795061728395062
"2709",146481,"Lake Forest College",1,0,2005,358,202,156,213,78,135,0.668,0.595,0.5,27000,38.338137,92,276,0.770949720670391
"2710",146481,"Lake Forest College",1,0,2006,386,224,162,241,96,145,0.647,0.624,0.593,28700,39.883635,89,303,0.784974093264249
"2711",146481,"Lake Forest College",1,0,2007,356,214,142,208,75,133,0.622,0.584,0.528,30600,42.225195,90,273,0.76685393258427
"2712",146481,"Lake Forest College",1,0,2008,378,218,160,242,85,157,0.72,0.64,0.531,32130,43.74872,91,261,0.69047619047619
"2713",146481,"Lake Forest College",1,0,2009,354,213,141,232,81,151,0.709,0.655,0.574,33576,43.849212,92,248,0.700564971751412
"2714",146481,"Lake Forest College",1,0,2010,402,238,164,258,98,160,0.672,0.642,0.598,34885,44.0861,96,232,0.577114427860697
"2715",146612,"LEWIS UNIVERSITY",1,0,1991,387,166,221,122,59,63,0.38,0.315,0.267,8502,26.975181,122,302,0.780361757105943
"2716",146612,"LEWIS UNIVERSITY",1,0,1992,345,161,184,84,34,50,0.311,0.243,0.185,9536,29.938384,132,278,0.805797101449275
"2717",146612,"LEWIS UNIVERSITY",1,0,1993,344,155,189,109,49,60,0.387,0.317,0.259,10112,32.652154,136,252,0.732558139534884
"2718",146612,"LEWIS UNIVERSITY",1,0,1995,331,158,173,104,49,55,0.348,0.314,0.283,11008,39.922159,121,219,0.661631419939577
"2719",146612,"LEWIS UNIVERSITY",1,0,1996,312,137,175,120,57,63,0.46,0.385,0.326,11552,41.318055,127,219,0.701923076923077
"2720",146612,"LEWIS UNIVERSITY",1,0,1997,386,176,210,145,70,75,0.426,0.376,0.333,12416,46.746393,143,252,0.652849740932642
"2721",146612,"LEWIS UNIVERSITY",1,0,1998,391,193,198,151,64,87,0.451,0.386,0.323,13024,37.985575,148,254,0.649616368286445
"2722",146612,"LEWIS UNIVERSITY",1,0,1999,425,194,231,171,82,89,0.459,0.402,0.355,13664,54.313671,143,290,0.682352941176471
"2723",146612,"LEWIS UNIVERSITY",1,0,2000,427,183,244,127,69,58,0.317,0.297,0.283,14208,59.837513,142,293,0.686182669789227
"2724",146612,"LEWIS UNIVERSITY",1,0,2001,384,191,193,126,52,74,0.387,0.328,0.269,14976,63.437417,141,272,0.708333333333333
"2725",146612,"LEWIS UNIVERSITY",1,0,2002,366,161,205,132,66,66,0.41,0.361,0.322,15250,66.701423,142,272,0.743169398907104
"2726",146612,"LEWIS UNIVERSITY",1,0,2003,458,224,234,179,86,93,0.415,0.391,0.368,15950,68.407304,144,321,0.700873362445415
"2727",146612,"LEWIS UNIVERSITY",1,0,2004,509,275,234,186,81,105,0.382,0.365,0.346,16906,71.452097,150,369,0.724950884086444
"2728",146612,"Lewis University",1,0,2005,557,321,236,232,92,140,0.436,0.417,0.39,17990,77.710417,163,404,0.725314183123878
"2729",146612,"Lewis University",1,0,2006,568,323,245,223,94,129,0.399,0.393,0.384,19200,87.326225,169,405,0.713028169014085
"2730",146612,"Lewis University",1,0,2007,634,365,269,283,131,152,0.416,0.446,0.487,20450,95.962694,179,435,0.686119873817035
"2731",146612,"Lewis University",1,0,2008,650,345,305,272,127,145,0.42,0.418,0.416,21990,76.049186,183,435,0.669230769230769
"2732",146612,"Lewis University",1,0,2009,653,360,293,288,114,174,0.483,0.441,0.389,22990,80.42657,189,433,0.663093415007657
"2733",146612,"Lewis University",1,0,2010,632,319,313,257,126,131,0.411,0.407,0.403,23780,98.679868,201,387,0.612341772151899
"2734",146719,"LOYOLA UNIVERSITY OF CHICAGO",1,0,1991,922,593,329,347,119,228,0.385,0.376,0.362,9270,561.76308,601,579,0.627982646420824
"2735",146719,"LOYOLA UNIVERSITY OF CHICAGO",1,0,1992,985,587,398,377,143,234,0.399,0.383,0.359,9840,635.436091,606,707,0.717766497461929
"2736",146719,"LOYOLA UNIVERSITY OF CHICAGO",1,0,1993,856,511,345,366,141,225,0.44,0.428,0.409,10470,662.272481,563,562,0.656542056074766
"2737",146719,"LOYOLA UNIVERSITY OF CHICAGO",1,0,1995,1182,733,449,544,167,377,0.514,0.46,0.372,13000,641.228839,536,793,0.670896785109983
"2738",146719,"LOYOLA UNIVERSITY OF CHICAGO",1,0,1996,1063,690,373,562,175,387,0.561,0.529,0.469,14400,387.764641,532,677,0.636876763875823
"2739",146719,"LOYOLA UNIVERSITY OF CHICAGO",1,0,1997,1189,758,431,558,189,369,0.487,0.469,0.439,15654,361.520895,530,739,0.621530698065601
"2740",146719,"LOYOLA UNIVERSITY OF CHICAGO",1,0,1998,1340,868,472,641,208,433,0.499,0.478,0.441,16600,297.603342,535,819,0.611194029850746
"2741",146719,"LOYOLA UNIVERSITY CHICAGO",1,0,1999,1067,717,350,541,169,372,0.519,0.507,0.483,17750,326.684018,522,638,0.597938144329897
"2742",146719,"LOYOLA UNIVERSITY CHICAGO",1,0,2000,889,585,304,542,164,378,0.646,0.61,0.539,18266,315.669381,494,566,0.636670416197975
"2743",146719,"LOYOLA UNIVERSITY CHICAGO",1,0,2001,1424,960,464,674,202,472,0.492,0.473,0.435,18814,317.901622,466,875,0.614466292134832
"2744",146719,"LOYOLA UNIVERSITY CHICAGO",1,0,2002,1623,1069,554,821,261,560,0.524,0.506,0.471,19472,316.555773,442,1005,0.619223659889094
"2745",146719,"LOYOLA UNIVERSITY CHICAGO",1,0,2003,1915,1292,623,924,296,628,0.486,0.483,0.475,20544,309.298747,524,1172,0.61201044386423
"2746",146719,"LOYOLA UNIVERSITY CHICAGO",1,0,2004,1787,1176,611,856,296,560,0.476,0.479,0.484,21780,310.40654,502,1101,0.61611639619474
"2747",146719,"Loyola University Chicago",1,0,2005,2080,1365,715,1053,346,707,0.518,0.506,0.484,23500,327.797622,523,1316,0.632692307692308
"2748",146719,"Loyola University Chicago",1,0,2006,2134,1426,708,1104,357,747,0.524,0.517,0.504,24580,354.411527,550,1381,0.647141518275539
"2749",146719,"Loyola University Chicago",1,0,2007,2035,1377,658,1215,371,844,0.613,0.597,0.564,27200,375.331354,582,1349,0.662899262899263
"2750",146719,"Loyola University Chicago",1,0,2008,2176,1460,716,1419,448,971,0.665,0.652,0.626,28700,410.357419,597,1541,0.708180147058823
"2751",146719,"Loyola University Chicago",1,0,2009,2076,1358,718,1323,434,889,0.655,0.637,0.604,29850,421.527019,629,1410,0.679190751445087
"2752",146719,"Loyola University-Chicago",1,0,2010,2063,1315,748,1342,444,898,0.683,0.651,0.594,31040,402.689139,658,1400,0.678623364032962
"2753",146825,"MACMURRAY COLLEGE",1,0,1991,185,89,96,83,28,55,0.618,0.449,0.292,8150,12.407437,66,160,0.864864864864865
"2754",146825,"MACMURRAY COLLEGE",1,0,1992,171,84,87,67,23,44,0.524,0.392,0.264,8620,13.505439,69,155,0.906432748538012
"2755",146825,"MACMURRAY COLLEGE",1,0,1993,151,72,79,64,21,43,0.597,0.424,0.266,9160,14.163477,69,130,0.860927152317881
"2756",146825,"MACMURRAY COLLEGE",1,0,1995,175,75,100,50,12,38,0.507,0.286,0.12,10190,15.804065,66,156,0.891428571428571
"2757",146825,"MACMURRAY COLLEGE",1,0,1996,156,90,66,54,15,39,0.433,0.346,0.227,10940,14.668524,64,134,0.858974358974359
"2758",146825,"MACMURRAY COLLEGE",1,0,1997,127,49,78,47,24,23,0.469,0.37,0.308,11400,13.776536,66,109,0.858267716535433
"2759",146825,"MACMURRAY COLLEGE",1,0,1998,163,79,84,59,22,37,0.468,0.362,0.262,11820,14.104256,72,142,0.871165644171779
"2760",146825,"MACMURRAY COLLEGE",1,0,1999,187,80,107,55,25,30,0.375,0.294,0.234,12300,13.777262,56,138,0.737967914438503
"2761",146825,"MACMURRAY COLLEGE",1,0,2000,199,97,102,55,20,35,0.361,0.276,0.196,13140,13.896518,53.5,158,0.793969849246231
"2762",146825,"MACMURRAY COLLEGE",1,0,2001,144,65,79,37,14,23,0.354,0.257,0.177,14000,15.022325,51,107,0.743055555555556
"2763",146825,"MACMURRAY COLLEGE",1,0,2002,127,72,55,46,14,32,0.444,0.362,0.255,14500,13.356183,45,103,0.811023622047244
"2764",146825,"MACMURRAY COLLEGE",1,0,2003,162,79,83,48,17,31,0.392,0.296,0.205,14500,12.518368,40,113,0.697530864197531
"2765",146825,"MACMURRAY COLLEGE",1,0,2004,152,74,78,37,17,20,0.27,0.243,0.218,14500,13.264619,39,115,0.756578947368421
"2766",146825,"MacMurray College",1,0,2005,159,77,82,35,10,25,0.325,0.22,0.122,15000,13.546312,41,110,0.691823899371069
"2767",146825,"MacMurray College",1,0,2006,166,86,80,41,14,27,0.314,0.247,0.175,15500,13.954413,38,114,0.686746987951807
"2768",146825,"MacMurray College",1,0,2007,125,73,52,35,3,32,0.438,0.28,0.058,16400,11.767836,35,89,0.712
"2769",146825,"MacMurray College",1,0,2008,90,36,54,21,8,13,0.361,0.233,0.148,17000,10.396702,31,59,0.655555555555556
"2770",146825,"MacMurray College",1,0,2009,96,34,62,19,6,13,0.382,0.198,0.097,17940,10.003159,33,61,0.635416666666667
"2771",146825,"MacMurray College",1,0,2010,90,39,51,10,4,6,0.154,0.111,0.078,18838,8.595246,33,52,0.577777777777778
"2772",147013,"MCKENDREE COLLEGE",1,0,1991,132,79,53,46,15,31,0.392,0.348,0.283,6746,11.195621,41,114,0.863636363636364
"2773",147013,"MCKENDREE COLLEGE",1,0,1992,134,82,52,53,19,34,0.415,0.396,0.365,7066,12.343461,46,118,0.880597014925373
"2774",147013,"MCKENDREE COLLEGE",1,0,1993,119,72,47,34,12,22,0.306,0.286,0.255,7450,13.208569,47,99,0.831932773109244
"2775",147013,"MCKENDREE COLLEGE",1,0,1995,188,109,79,54,16,38,0.349,0.287,0.203,8640,13.913492,48,175,0.930851063829787
"2776",147013,"MCKENDREE COLLEGE",1,0,1996,309,142,167,106,46,60,0.422,0.343,0.275,9600,15.905391,51,282,0.912621359223301
"2777",147013,"MCKENDREE COLLEGE",1,0,1997,242,131,111,98,35,63,0.481,0.405,0.315,10400,14.266206,57,220,0.909090909090909
"2778",147013,"MCKENDREE COLLEGE",1,0,1998,247,139,108,91,24,67,0.482,0.368,0.222,11200,15.810881,57,213,0.862348178137652
"2779",147013,"MCKENDREE COLLEGE",1,0,1999,246,164,82,101,27,74,0.451,0.411,0.329,12000,17.281567,60,211,0.857723577235772
"2780",147013,"MCKENDREE COLLEGE",1,0,2000,265,154,111,97,35,62,0.403,0.366,0.315,12300,19.849333,61.5,239,0.90188679245283
"2781",147013,"MCKENDREE COLLEGE",1,0,2001,284,168,116,128,35,93,0.554,0.451,0.302,13350,21.668405,63,244,0.859154929577465
"2782",147013,"MCKENDREE COLLEGE",1,0,2002,258,135,123,127,48,79,0.585,0.492,0.39,14200,22.466566,65,229,0.887596899224806
"2783",147013,"MCKENDREE COLLEGE",1,0,2003,287,124,163,113,55,58,0.468,0.394,0.337,15200,21.861367,71,224,0.780487804878049
"2784",147013,"MCKENDREE COLLEGE",1,0,2004,337,134,203,122,55,67,0.5,0.362,0.271,16400,23.838502,70,269,0.798219584569733
"2785",147013,"McKendree College",1,0,2005,273,126,147,94,39,55,0.436,0.344,0.265,17500,25.831042,76,209,0.765567765567766
"2786",147013,"McKendree College",1,0,2006,343,162,181,114,40,74,0.457,0.332,0.221,18300,26.663345,82,265,0.772594752186589
"2787",147013,"McKendree University",1,0,2007,298,131,167,94,42,52,0.397,0.315,0.251,19500,29.9414,87,238,0.798657718120805
"2788",147013,"McKendree University",1,0,2008,308,145,163,110,40,70,0.483,0.357,0.245,20570,30.126195,94,228,0.74025974025974
"2789",147013,"McKendree University",1,0,2009,305,148,157,102,44,58,0.392,0.334,0.28,21370,31.093461,91,231,0.757377049180328
"2790",147013,"McKendree University",1,0,2010,335,154,181,121,54,67,0.435,0.361,0.298,22330,31.593971,97,239,0.713432835820896
"2791",147244,"MILLIKIN UNIVERSITY",1,0,1991,422,242,180,245,94,151,0.624,0.581,0.522,9990,29.311958,116,390,0.924170616113744
"2792",147244,"MILLIKIN UNIVERSITY",1,0,1992,516,302,214,289,102,187,0.619,0.56,0.477,10590,30.969184,118,479,0.928294573643411
"2793",147244,"MILLIKIN UNIVERSITY",1,0,1993,452,235,217,256,111,145,0.617,0.566,0.512,11240,34.825176,124,415,0.918141592920354
"2794",147244,"MILLIKIN UNIVERSITY",1,0,1995,494,272,222,248,98,150,0.551,0.502,0.441,12596,35.938683,128,409,0.827935222672065
"2795",147244,"MILLIKIN UNIVERSITY",1,0,1996,497,284,213,253,80,173,0.609,0.509,0.376,13290,38.526984,130,422,0.849094567404427
"2796",147244,"MILLIKIN UNIVERSITY",1,0,1997,569,302,267,286,112,174,0.576,0.503,0.419,14138,28.285297,222,473,0.83128295254833
"2797",147244,"MILLIKIN UNIVERSITY",1,0,1998,594,331,263,291,91,200,0.604,0.49,0.346,14758,31.052635,136,495,0.833333333333333
"2798",147244,"MILLIKIN UNIVERSITY",1,0,1999,595,324,271,323,130,193,0.596,0.543,0.48,15348,35.415925,137,521,0.87563025210084
"2799",147244,"MILLIKIN UNIVERSITY",1,0,2000,574,316,258,320,120,200,0.633,0.557,0.465,16192,38.179957,148,487,0.848432055749129
"2800",147244,"MILLIKIN UNIVERSITY",1,0,2001,646,356,290,349,139,210,0.59,0.54,0.479,17084,41.36781,159,547,0.846749226006192
"2801",147244,"MILLIKIN UNIVERSITY",1,0,2002,634,351,283,335,117,218,0.621,0.528,0.413,18109,48.115103,159,551,0.869085173501577
"2802",147244,"MILLIKIN UNIVERSITY",1,0,2003,595,299,296,317,132,185,0.619,0.533,0.446,18834,41.451315,143,491,0.825210084033613
"2803",147244,"MILLIKIN UNIVERSITY",1,0,2004,530,302,228,268,99,169,0.56,0.506,0.434,19900,40.011384,138,429,0.809433962264151
"2804",147244,"Millikin University",1,0,2005,572,313,259,311,119,192,0.613,0.544,0.459,20696,41.353776,142,470,0.821678321678322
"2805",147244,"Millikin University",1,0,2006,475,261,214,214,89,125,0.479,0.451,0.416,21524,42.68309,145,386,0.812631578947368
"2806",147244,"Millikin University",1,0,2007,475,268,207,228,91,137,0.511,0.48,0.44,23250,46.33716,155,384,0.808421052631579
"2807",147244,"Millikin University",1,0,2008,484,298,186,247,83,164,0.55,0.51,0.446,24600,48.126975,158,388,0.801652892561983
"2808",147244,"Millikin University",1,0,2009,541,317,224,259,97,162,0.511,0.479,0.433,25750,50.083813,154,421,0.77818853974122
"2809",147244,"Millikin University",1,0,2010,498,258,240,244,101,143,0.554,0.49,0.421,26780,48.219455,151,372,0.746987951807229
"2810",147341,"MONMOUTH COLLEGE",1,0,1991,252,117,135,113,48,65,0.556,0.448,0.356,12450,14.889175,53,222,0.880952380952381
"2811",147341,"MONMOUTH COLLEGE",1,0,1992,125,67,58,61,23,38,0.567,0.488,0.397,12800,15.40303,53,112,0.896
"2812",147341,"MONMOUTH COLLEGE",1,0,1993,204,93,111,77,31,46,0.495,0.377,0.279,12900,14.726836,44,185,0.906862745098039
"2813",147341,"MONMOUTH COLLEGE",1,0,1995,308,187,121,156,54,102,0.545,0.506,0.446,13460,18.521916,49,284,0.922077922077922
"2814",147341,"MONMOUTH COLLEGE",1,0,1996,282,167,115,139,52,87,0.521,0.493,0.452,13965,20.288695,52,254,0.900709219858156
"2815",147341,"MONMOUTH COLLEGE",1,0,1997,272,176,96,150,48,102,0.58,0.551,0.5,14420,12.459627,51,234,0.860294117647059
"2816",147341,"MONMOUTH COLLEGE",1,0,1998,320,146,174,170,84,86,0.589,0.531,0.483,15120,13.647436,49,271,0.846875
"2817",147341,"MONMOUTH COLLEGE",1,0,1999,259,155,104,132,44,88,0.568,0.51,0.423,15720,14.400049,57,233,0.8996138996139
"2818",147341,"MONMOUTH COLLEGE",1,0,2000,235,136,99,143,51,92,0.677,0.609,0.515,16370,15.781718,57.5,214,0.91063829787234
"2819",147341,"MONMOUTH COLLEGE",1,0,2001,258,122,136,128,67,61,0.5,0.496,0.493,17000,17.466465,58,236,0.914728682170543
"2820",147341,"MONMOUTH COLLEGE",1,0,2002,282,147,135,150,61,89,0.605,0.532,0.452,17760,19.013151,61,261,0.925531914893617
"2821",147341,"MONMOUTH COLLEGE",1,0,2003,355,175,180,215,97,118,0.674,0.606,0.539,18600,19.735348,66,324,0.912676056338028
"2822",147341,"MONMOUTH COLLEGE",1,0,2004,389,227,162,169,59,110,0.485,0.434,0.364,19350,21.38215,69,349,0.897172236503856
"2823",147341,"Monmouth College",1,0,2005,367,180,187,140,50,90,0.5,0.381,0.267,20200,23.747388,73,325,0.885558583106267
"2824",147341,"Monmouth College",1,0,2006,392,215,177,172,64,108,0.502,0.439,0.362,21100,25.846358,79,310,0.790816326530612
"2825",147341,"Monmouth College",1,0,2007,393,213,180,223,90,133,0.624,0.567,0.5,22000,27.106146,74,344,0.875318066157761
"2826",147341,"Monmouth College",1,0,2008,383,179,204,182,84,98,0.547,0.475,0.412,24000,27.595858,81,319,0.83289817232376
"2827",147341,"Monmouth College",1,0,2009,378,187,191,183,79,104,0.556,0.484,0.414,24950,28.56748,80,296,0.783068783068783
"2828",147341,"Monmouth College",1,0,2010,355,187,168,168,73,95,0.508,0.473,0.435,26900,29.77298,78,249,0.701408450704225
"2829",147703,"NORTHERN ILLINOIS UNIVERSITY",1,0,1991,3161,1646,1515,651,251,400,0.243,0.206,0.166,2641,206.163415,1003,2368,0.749130022144891
"2830",147703,"NORTHERN ILLINOIS UNIVERSITY",1,0,1992,2742,1537,1205,607,211,396,0.258,0.221,0.175,3084,210.086263,963,1954,0.712618526622903
"2831",147703,"NORTHERN ILLINOIS UNIVERSITY",1,0,1993,2380,1320,1060,491,163,328,0.249,0.206,0.154,3339,219.435834,944,1633,0.686134453781513
"2832",147703,"NORTHERN ILLINOIS UNIVERSITY",1,0,1995,2429,1368,1061,582,200,382,0.279,0.24,0.189,3746,238.351511,941,1620,0.666941128036229
"2833",147703,"NORTHERN ILLINOIS UNIVERSITY",1,0,1996,2434,1339,1095,613,246,367,0.274,0.252,0.225,3948,261.553585,929,1605,0.659408381265407
"2834",147703,"NORTHERN ILLINOIS UNIVERSITY",1,0,1997,2673,1444,1229,691,252,439,0.304,0.259,0.205,4122,269.945729,891,1855,0.693976805087916
"2835",147703,"NORTHERN ILLINOIS UNIVERSITY",1,0,1998,2818,1513,1305,682,244,438,0.29,0.242,0.187,4210,281.39409,856,1839,0.652590489709013
"2836",147703,"NORTHERN ILLINOIS UNIVERSITY",1,0,1999,2924,1587,1337,742,285,457,0.288,0.254,0.213,3060,296.478468,847,1918,0.655950752393981
"2837",147703,"NORTHERN ILLINOIS UNIVERSITY",1,0,2000,2765,1341,1424,634,273,361,0.269,0.229,0.192,3150,319.964372,867,1748,0.632188065099457
"2838",147703,"NORTHERN ILLINOIS UNIVERSITY",1,0,2001,2792,1459,1333,725,281,444,0.304,0.26,0.211,3293,348.924555,887,1810,0.648280802292264
"2839",147703,"NORTHERN ILLINOIS UNIVERSITY",1,0,2002,3015,1585,1430,698,283,415,0.262,0.232,0.198,3581,372.366019,908,1993,0.661028192371476
"2840",147703,"NORTHERN ILLINOIS UNIVERSITY",1,0,2003,3229,1635,1594,737,300,437,0.267,0.228,0.188,3956,369.945819,898,2097,0.649427067203469
"2841",147703,"NORTHERN ILLINOIS UNIVERSITY",1,0,2004,2933,1585,1348,807,334,473,0.298,0.275,0.248,4612,457.665746,874,2014,0.686668939652233
"2842",147703,"Northern Illinois University",1,0,2005,3171,1637,1534,826,360,466,0.285,0.26,0.235,5061,405.282105,891,2095,0.660674865972879
"2843",147703,"Northern Illinois University",1,0,2006,3260,1641,1619,903,427,476,0.29,0.277,0.264,5550,420.798489,904,2140,0.656441717791411
"2844",147703,"Northern Illinois University",1,0,2007,2997,1584,1413,793,353,440,0.278,0.265,0.25,6150,433.016409,908,1637,0.546212879546213
"2845",147703,"Northern Illinois University",1,0,2008,2844,1469,1375,718,315,403,0.274,0.252,0.229,6720,463.14356,926,1633,0.574191279887482
"2846",147703,"Northern Illinois University",1,0,2009,2988,1573,1415,754,310,444,0.282,0.252,0.219,7260,484.375128,921,1711,0.572623828647925
"2847",147703,"Northern Illinois University",1,0,2010,2663,1338,1325,625,278,347,0.259,0.235,0.21,7020,502.113951,896,1396,0.524220803604957
"2848",147767,"NORTHWESTERN UNIVERSITY",0,1,1991,1945,955,990,1601,782,819,0.858,0.823,0.79,14370,589.244,875,1405,0.722365038560411
"2849",147767,"NORTHWESTERN UNIVERSITY",0,1,1992,1889,948,941,1533,719,814,0.859,0.812,0.764,15075,663.591,886,1364,0.722075172048703
"2850",147767,"NORTHWESTERN UNIVERSITY",0,1,1993,1903,950,953,1566,749,817,0.86,0.823,0.786,15804,694.555,872,1356,0.712559117183395
"2851",147767,"NORTHWESTERN UNIVERSITY",0,1,1995,1948,1066,882,1595,672,923,0.866,0.819,0.762,17184,786.636,878,1235,0.633983572895277
"2852",147767,"NORTHWESTERN UNIVERSITY",0,1,1996,1947,1035,912,1639,719,920,0.889,0.842,0.788,18108,848.516,892,1305,0.670261941448382
"2853",147767,"NORTHWESTERN UNIVERSITY",0,1,1997,1889,959,930,1578,743,835,0.871,0.835,0.799,19152,660.765,879,1206,0.638433033350979
"2854",147767,"NORTHWESTERN UNIVERSITY",0,1,1998,1912,1023,889,1601,706,895,0.875,0.837,0.794,22392,672.467,916,1223,0.639644351464435
"2855",147767,"NORTHWESTERN UNIVERSITY",0,1,1999,1951,1039,912,1657,746,911,0.877,0.849,0.818,23476,758.327,896,1202,0.616094310609944
"2856",147767,"NORTHWESTERN UNIVERSITY",0,1,2000,1876,983,893,1612,731,881,0.896,0.859,0.819,24648,819.646,901.5,1148,0.611940298507463
"2857",147767,"NORTHWESTERN UNIVERSITY",0,1,2001,1947,1026,921,1682,769,913,0.89,0.864,0.835,25839,871.935,907,1143,0.587057010785824
"2858",147767,"NORTHWESTERN UNIVERSITY",0,1,2002,2000,1075,925,1725,759,966,0.899,0.863,0.821,27108,921.225,915,1199,0.5995
"2859",147767,"NORTHWESTERN UNIVERSITY",0,1,2003,1941,1035,906,1694,753,941,0.909,0.873,0.831,28404,958.882,900,1206,0.621329211746522
"2860",147767,"NORTHWESTERN UNIVERSITY",0,1,2004,1914,1030,884,1652,728,924,0.897,0.863,0.824,29940,1063.589,933,1178,0.61546499477534
"2861",147767,"Northwestern University",0,1,2005,1952,1018,934,1669,756,913,0.897,0.855,0.809,31644,1169.656,1170,1172,0.600409836065574
"2862",147767,"Northwestern University",0,1,2006,2060,1089,971,1768,799,969,0.89,0.858,0.823,33408,1245.029,1223,1221,0.592718446601942
"2863",147767,"Northwestern University",0,1,2007,1979,1057,922,1705,770,935,0.885,0.862,0.835,35064,1356.559,1266,1112,0.561899949469429
"2864",147767,"Northwestern University",0,1,2008,2077,1075,1002,1773,822,951,0.885,0.854,0.82,36756,1563.035,1294,1167,0.561868078960039
"2865",147767,"Northwestern University",0,1,2009,2128,1076,1052,1754,826,928,0.863,0.824,0.785,38463,1588.143,1310,1186,0.557330827067669
"2866",147767,"Northwestern University",0,1,2010,2126,1125,1001,1785,790,995,0.884,0.84,0.789,39840,1671.197,1352,1190,0.559736594543744
"2867",147776,"NORTHEASTERN ILLINOIS UNIVERSITY",0,1,1991,724,447,277,17,5,12,0.027,0.023,0.018,2092,57.339573,345,314,0.433701657458564
"2868",147776,"NORTHEASTERN ILLINOIS UNIVERSITY",1,0,1992,688,408,280,21,6,15,0.037,0.031,0.021,1834,59.80775,340,292,0.424418604651163
"2869",147776,"NORTHEASTERN ILLINOIS UNIVERSITY",1,0,1993,641,374,267,14,3,11,0.029,0.022,0.011,2062,60.647722,331,227,0.354134165366615
"2870",147776,"NORTHEASTERN ILLINOIS UNIVERSITY",1,0,1995,812,488,324,20,7,13,0.027,0.025,0.022,2244,66.953186,319,316,0.389162561576355
"2871",147776,"NORTHEASTERN ILLINOIS UNIVERSITY",1,0,1996,799,474,325,12,6,6,0.013,0.015,0.018,2352,74.268532,322,271,0.339173967459324
"2872",147776,"NORTHEASTERN ILLINOIS UNIVERSITY",1,0,1997,1007,630,377,25,9,16,0.025,0.025,0.024,2469,77.075785,327,364,0.361469712015889
"2873",147776,"NORTHEASTERN ILLINOIS UNIVERSITY",1,0,1998,961,594,367,15,3,12,0.02,0.016,0.008,2507,76.579898,329,324,0.337148803329865
"2874",147776,"NORTHEASTERN ILLINOIS UNIVERSITY",1,0,1999,943,573,370,22,7,15,0.026,0.023,0.019,2262,83.441627,312,304,0.32237539766702
"2875",147776,"NORTHEASTERN ILLINOIS UNIVERSITY",1,0,2000,948,570,378,27,7,20,0.035,0.028,0.019,2340,91.01603,332,323,0.340717299578059
"2876",147776,"NORTHEASTERN ILLINOIS UNIVERSITY",1,0,2001,964,622,342,21,7,14,0.022,0.022,0.02,2424,99.656845,352,337,0.349585062240664
"2877",147776,"NORTHEASTERN ILLINOIS UNIVERSITY",1,0,2002,977,589,388,27,9,18,0.031,0.028,0.023,2508,104.717831,370,331,0.338792221084954
"2878",147776,"NORTHEASTERN ILLINOIS UNIVERSITY",1,0,2003,1046,657,389,36,12,24,0.036,0.034,0.031,2640,105.35715,398,361,0.345124282982792
"2879",147776,"NORTHEASTERN ILLINOIS UNIVERSITY",1,0,2004,972,580,392,37,7,30,0.052,0.038,0.018,2976,136.830924,415,337,0.346707818930041
"2880",147776,"Northeastern Illinois University",1,0,2005,960,570,390,51,16,35,0.061,0.053,0.041,3840,120.069108,415,320,0.333333333333333
"2881",147776,"Northeastern Illinois University",1,0,2006,1022,600,422,40,18,22,0.037,0.039,0.043,4200,123.134565,411,300,0.293542074363992
"2882",147776,"Northeastern Illinois University",1,0,2007,870,506,364,36,9,27,0.053,0.041,0.025,4680,134.579369,411,298,0.342528735632184
"2883",147776,"Northeastern Illinois University",1,0,2008,952,519,433,48,18,30,0.058,0.05,0.042,5280,136.970706,421,269,0.282563025210084
"2884",147776,"Northeastern Illinois University",1,0,2009,996,545,451,50,20,30,0.055,0.05,0.044,5880,137.53064,404,273,0.274096385542169
"2885",147776,"Northeastern Illinois University",1,0,2010,976,551,425,37,11,26,0.047,0.038,0.026,5520,150.14281,416,274,0.280737704918033
"2886",147828,"OLIVET NAZARENE UNIVERSITY",1,0,1991,376,209,167,140,42,98,0.469,0.372,0.251,6476,17.407594,74,338,0.898936170212766
"2887",147828,"OLIVET NAZARENE UNIVERSITY",1,0,1992,388,202,186,129,48,81,0.401,0.332,0.258,7050,19.207675,80,350,0.902061855670103
"2888",147828,"OLIVET NAZARENE UNIVERSITY",1,0,1993,421,234,187,169,61,108,0.462,0.401,0.326,7836,21.471059,96,386,0.916864608076009
"2889",147828,"OLIVET NAZARENE UNIVERSITY",1,0,1995,389,217,172,150,60,90,0.415,0.386,0.349,9440,25.395606,82,371,0.953727506426735
"2890",147828,"OLIVET NAZARENE UNIVERSITY",1,0,1996,400,231,169,141,55,86,0.372,0.352,0.325,10166,27.224987,81,374,0.935
"2891",147828,"OLIVET NAZARENE UNIVERSITY",1,0,1997,426,229,197,170,53,117,0.511,0.399,0.269,10840,25.195975,85,385,0.903755868544601
"2892",147828,"OLIVET NAZARENE UNIVERSITY",1,0,1998,428,227,201,159,59,100,0.44,0.371,0.294,11728,25.815979,84,382,0.892523364485981
"2893",147828,"OLIVET NAZARENE UNIVERSITY",1,0,1999,410,224,186,169,61,108,0.482,0.412,0.328,11528,27.855504,83,365,0.890243902439024
"2894",147828,"OLIVET NAZARENE UNIVERSITY",1,0,2000,468,278,190,187,61,126,0.453,0.4,0.321,11928,29.685213,82,421,0.89957264957265
"2895",147828,"OLIVET NAZARENE UNIVERSITY",1,0,2001,541,297,244,240,90,150,0.505,0.444,0.369,12644,32.196935,81,480,0.88724584103512
"2896",147828,"OLIVET NAZARENE UNIVERSITY",1,0,2002,553,328,225,274,95,179,0.546,0.495,0.422,13400,36.097868,86,490,0.886075949367089
"2897",147828,"OLIVET NAZARENE UNIVERSITY",1,0,2003,578,339,239,252,93,159,0.469,0.436,0.389,14160,39.643737,92,506,0.875432525951557
"2898",147828,"OLIVET NAZARENE UNIVERSITY",1,0,2004,699,427,272,338,97,241,0.564,0.484,0.357,14900,42.750192,96,613,0.876967095851216
"2899",147828,"Olivet Nazarene University",1,0,2005,669,404,265,294,94,200,0.495,0.439,0.355,15650,47.280191,106,560,0.837070254110613
"2900",147828,"Olivet Nazarene University",1,0,2006,751,414,337,332,126,206,0.498,0.442,0.374,16750,51.381074,107,654,0.870838881491345
"2901",147828,"Olivet Nazarene University",1,0,2007,704,384,320,343,135,208,0.542,0.487,0.422,18750,56.605889,119,609,0.865056818181818
"2902",147828,"Olivet Nazarene University",1,0,2008,590,357,233,260,76,184,0.515,0.441,0.326,20750,58.563818,118,505,0.855932203389831
"2903",147828,"Olivet Nazarene University",1,0,2009,771,447,324,395,134,261,0.584,0.512,0.414,22750,62.328965,122,677,0.878080415045396
"2904",147828,"Olivet Nazarene University",1,0,2010,740,417,323,344,128,216,0.518,0.465,0.396,24750,66.36542,122,628,0.848648648648649
"2905",148131,"QUINCY COLLEGE",1,0,1991,296,153,143,105,44,61,0.399,0.355,0.308,8604,14.793589,61,278,0.939189189189189
"2906",148131,"QUINCY COLLEGE",1,0,1992,313,148,165,80,24,56,0.378,0.256,0.145,9160,15.224122,58,285,0.910543130990415
"2907",148131,"QUINCY UNIVERSITY",1,0,1993,297,134,163,71,33,38,0.284,0.239,0.202,9532,15.533624,55,262,0.882154882154882
"2908",148131,"QUINCY UNIVERSITY",1,0,1995,259,126,133,89,30,59,0.468,0.344,0.226,10910,16.52044,54,230,0.888030888030888
"2909",148131,"QUINCY UNIVERSITY",1,0,1996,283,135,148,112,50,62,0.459,0.396,0.338,11510,17.207924,51,243,0.858657243816254
"2910",148131,"QUINCY UNIVERSITY",1,0,1997,224,116,108,77,26,51,0.44,0.344,0.241,12410,13.085654,52,199,0.888392857142857
"2911",148131,"QUINCY UNIVERSITY",1,0,1998,232,122,110,109,43,66,0.541,0.47,0.391,13370,14.21253,58,204,0.879310344827586
"2912",148131,"QUINCY UNIVERSITY",1,0,1999,273,148,125,98,36,62,0.419,0.359,0.288,13450,14.988678,60,223,0.816849816849817
"2913",148131,"QUINCY UNIVERSITY",1,0,2000,235,137,98,81,25,56,0.409,0.345,0.255,14300,16.037846,60.5,201,0.85531914893617
"2914",148131,"QUINCY UNIVERSITY",1,0,2001,231,119,112,83,32,51,0.429,0.359,0.286,15010,16.454871,61,190,0.822510822510823
"2915",148131,"QUINCY UNIVERSITY",1,0,2002,229,112,117,88,33,55,0.491,0.384,0.282,15910,17.65855,58,197,0.860262008733624
"2916",148131,"QUINCY UNIVERSITY",1,0,2003,222,108,114,68,32,36,0.333,0.306,0.281,16400,16.197364,48,179,0.806306306306306
"2917",148131,"QUINCY UNIVERSITY",1,0,2004,228,124,104,75,27,48,0.387,0.329,0.26,17140,16.654476,45,167,0.732456140350877
"2918",148131,"Quincy University",1,0,2005,202,99,103,69,28,41,0.414,0.342,0.272,17800,17.177988,52,150,0.742574257425743
"2919",148131,"Quincy University",1,0,2006,161,88,73,67,27,40,0.454,0.416,0.37,18450,18.172853,53,131,0.813664596273292
"2920",148131,"Quincy University",1,0,2007,234,104,130,92,42,50,0.481,0.393,0.323,18950,18.503913,48,170,0.726495726495726
"2921",148131,"Quincy University",1,0,2008,245,108,137,81,31,50,0.463,0.331,0.226,20100,20.009588,49,176,0.718367346938775
"2922",148131,"Quincy University",1,0,2009,248,127,121,81,31,50,0.394,0.327,0.256,21300,21.790766,53,180,0.725806451612903
"2923",148131,"Quincy University",1,0,2010,272,136,136,94,44,50,0.368,0.346,0.324,22240,23.931922,58,152,0.558823529411765
"2924",148496,"ROSARY COLLEGE",1,0,1991,152,124,28,58,11,47,0.379,0.382,0.393,9226,15.795578,71,113,0.743421052631579
"2925",148496,"ROSARY COLLEGE",1,0,1992,142,117,25,67,9,58,0.496,0.472,0.36,9940,16.170774,74,109,0.767605633802817
"2926",148496,"ROSARY COLLEGE",1,0,1993,140,101,39,66,17,49,0.485,0.471,0.436,10500,16.69972,72,104,0.742857142857143
"2927",148496,"ROSARY COLLEGE",1,0,1995,124,95,29,67,13,54,0.568,0.54,0.448,11550,19.294097,69,98,0.790322580645161
"2928",148496,"ROSARY COLLEGE",1,0,1996,153,106,47,80,27,53,0.5,0.523,0.574,12230,19.635942,71,108,0.705882352941177
"2929",148496,"DOMINICAN UNIVERSITY",1,0,1997,199,140,59,99,28,71,0.507,0.497,0.475,13050,16.719394,73,154,0.773869346733668
"2930",148496,"DOMINICAN UNIVERSITY",1,0,1998,207,137,70,102,36,66,0.482,0.493,0.514,13700,19.363808,76,150,0.72463768115942
"2931",148496,"DOMINICAN UNIVERSITY",1,0,1999,195,144,51,112,28,84,0.583,0.574,0.549,14160,21.458391,79,135,0.692307692307692
"2932",148496,"DOMINICAN UNIVERSITY",1,0,2000,165,108,57,94,30,64,0.593,0.57,0.526,14720,22.902023,84.5,114,0.690909090909091
"2933",148496,"DOMINICAN UNIVERSITY",1,0,2001,222,139,83,111,34,77,0.554,0.5,0.41,15600,25.698823,90,159,0.716216216216216
"2934",148496,"DOMINICAN UNIVERSITY",1,0,2002,192,123,69,111,29,82,0.667,0.578,0.42,16620,28.303747,97,137,0.713541666666667
"2935",148496,"DOMINICAN UNIVERSITY",1,0,2003,240,176,64,146,40,106,0.602,0.608,0.625,17850,32.201296,96,175,0.729166666666667
"2936",148496,"DOMINICAN UNIVERSITY",1,0,2004,271,181,90,156,41,115,0.635,0.576,0.456,18900,34.095451,100,177,0.653136531365314
"2937",148496,"Dominican University",1,0,2005,266,178,88,147,46,101,0.567,0.553,0.523,19950,37.624364,109,161,0.605263157894737
"2938",148496,"Dominican University",1,0,2006,362,256,106,203,52,151,0.59,0.561,0.491,21150,40.458776,112,205,0.566298342541437
"2939",148496,"Dominican University",1,0,2007,366,265,101,184,43,141,0.532,0.503,0.426,22350,42.795956,122,199,0.543715846994536
"2940",148496,"Dominican University",1,0,2008,416,291,125,198,59,139,0.478,0.476,0.472,23700,45.825066,125,234,0.5625
"2941",148496,"Dominican University",1,0,2009,405,279,126,193,51,142,0.509,0.477,0.405,24600,49.612977,140,231,0.57037037037037
"2942",148496,"Dominican University",1,0,2010,427,287,140,212,60,152,0.53,0.496,0.429,25560,52.896566,156,207,0.484777517564403
"2943",148584,"COLLEGE OF SAINT FRANCIS",1,0,1991,171,81,90,58,22,36,0.444,0.339,0.244,7982,15.184974,50,144,0.842105263157895
"2944",148584,"COLLEGE OF SAINT FRANCIS",1,0,1992,144,67,77,52,23,29,0.433,0.361,0.299,8600,16.621232,51,133,0.923611111111111
"2945",148584,"COLLEGE OF SAINT FRANCIS",1,0,1993,149,79,70,61,25,36,0.456,0.409,0.357,9100,17.653597,50,140,0.939597315436242
"2946",148584,"COLLEGE OF ST FRANCIS",1,0,1995,165,82,83,67,30,37,0.451,0.406,0.361,10790,19.741556,53,149,0.903030303030303
"2947",148584,"COLLEGE OF ST FRANCIS",1,0,1996,151,91,60,53,15,38,0.418,0.351,0.25,11490,23.222377,53,102,0.675496688741722
"2948",148584,"UNIVERSITY OF ST FRANCIS",1,0,1997,134,82,52,48,13,35,0.427,0.358,0.25,11950,25.30946,69,91,0.67910447761194
"2949",148584,"UNIVERSITY OF ST FRANCIS",1,0,1998,176,88,88,64,21,43,0.489,0.364,0.239,12480,28.247039,70,118,0.670454545454545
"2950",148584,"UNIVERSITY OF ST FRANCIS",1,0,1999,170,101,69,54,14,40,0.396,0.318,0.203,12800,30.820787,69,145,0.852941176470588
"2951",148584,"UNIVERSITY OF ST FRANCIS",1,0,2000,190,109,81,73,25,48,0.44,0.384,0.309,13990,24.946512,72.5,148,0.778947368421053
"2952",148584,"UNIVERSITY OF ST FRANCIS",1,0,2001,177,112,65,72,21,51,0.455,0.407,0.323,14680,28.031246,76,153,0.864406779661017
"2953",148584,"UNIVERSITY OF ST FRANCIS",1,0,2002,149,86,63,49,17,32,0.372,0.329,0.27,15710,28.883544,75,101,0.677852348993289
"2954",148584,"UNIVERSITY OF ST FRANCIS",1,0,2003,190,110,80,62,27,35,0.318,0.326,0.338,16480,31.386503,79,144,0.757894736842105
"2955",148584,"UNIVERSITY OF ST FRANCIS",1,0,2004,157,94,63,64,21,43,0.457,0.408,0.333,17310,40.619312,81,120,0.764331210191083
"2956",148584,"University of St Francis",1,0,2005,190,116,74,85,27,58,0.5,0.447,0.365,18170,34.417453,84,137,0.721052631578947
"2957",148584,"University of St Francis",1,0,2006,181,104,77,62,21,41,0.394,0.343,0.273,19150,34.362515,87,128,0.707182320441989
"2958",148584,"University of St Francis",1,0,2007,198,124,74,63,18,45,0.363,0.318,0.243,20440,35.105451,84,149,0.752525252525252
"2959",148584,"University of St Francis",1,0,2008,203,125,78,77,27,50,0.4,0.379,0.346,21450,37.69614,93,160,0.788177339901478
"2960",148584,"University of St Francis",1,0,2009,223,144,79,92,26,66,0.458,0.413,0.329,22288,39.41618,96,170,0.762331838565022
"2961",148584,"University of St Francis",1,0,2010,210,131,79,93,29,64,0.489,0.443,0.367,24292,39.001615,95,144,0.685714285714286
"2962",148627,"SAINT XAVIER COLLEGE",1,0,1991,160,109,51,50,11,39,0.358,0.312,0.216,8840,25.859128,133,118,0.7375
"2963",148627,"SAINT XAVIER UNIVERSITY",1,0,1992,192,134,58,55,11,44,0.328,0.286,0.19,9650,28.873992,145,129,0.671875
"2964",148627,"SAINT XAVIER UNIVERSITY",1,0,1993,272,163,109,75,20,55,0.337,0.276,0.183,10340,29.544951,153,196,0.720588235294118
"2965",148627,"SAINT XAVIER UNIVERSITY",1,0,1995,226,139,87,67,19,48,0.345,0.296,0.218,11600,35.187747,137,153,0.676991150442478
"2966",148627,"SAINT XAVIER UNIVERSITY",1,0,1996,203,116,87,56,14,42,0.362,0.276,0.161,12080,36.979468,141,133,0.655172413793103
"2967",148627,"SAINT XAVIER UNIVERSITY",1,0,1997,270,180,90,82,21,61,0.339,0.304,0.233,12560,29.93047,140,164,0.607407407407407
"2968",148627,"SAINT XAVIER UNIVERSITY",1,0,1998,271,180,91,87,21,66,0.367,0.321,0.231,13160,31.476164,142,167,0.616236162361624
"2969",148627,"SAINT XAVIER UNIVERSITY",1,0,1999,325,196,129,96,33,63,0.321,0.295,0.256,13650,34.038411,139,222,0.683076923076923
"2970",148627,"SAINT XAVIER UNIVERSITY",1,0,2000,352,222,130,112,36,76,0.342,0.318,0.277,14400,36.062307,142,226,0.642045454545455
"2971",148627,"SAINT XAVIER UNIVERSITY",1,0,2001,353,208,145,88,31,57,0.274,0.249,0.214,15000,40.357712,145,224,0.634560906515581
"2972",148627,"SAINT XAVIER UNIVERSITY",1,0,2002,375,262,113,89,24,65,0.248,0.237,0.212,15750,45.320654,151,240,0.64
"2973",148627,"SAINT XAVIER UNIVERSITY",1,0,2003,371,231,140,107,32,75,0.325,0.288,0.229,16500,51.309452,160,241,0.649595687331536
"2974",148627,"SAINT XAVIER UNIVERSITY",1,0,2004,406,259,147,130,44,86,0.332,0.32,0.299,17150,58.022752,168,250,0.61576354679803
"2975",148627,"Saint Xavier University",1,0,2005,410,236,174,133,50,83,0.352,0.324,0.287,18350,63.519429,168,251,0.61219512195122
"2976",148627,"Saint Xavier University",1,0,2006,525,370,155,172,47,125,0.338,0.328,0.303,19640,66.814099,190,310,0.59047619047619
"2977",148627,"Saint Xavier University",1,0,2007,507,342,165,152,50,102,0.298,0.3,0.303,21016,72.588143,186,265,0.522682445759369
"2978",148627,"Saint Xavier University",1,0,2008,547,375,172,176,55,121,0.323,0.322,0.32,22486,75.186561,176,291,0.53199268738574
"2979",148627,"Saint Xavier University",1,0,2009,438,282,156,131,34,97,0.344,0.299,0.218,23610,76.420932,180,241,0.550228310502283
"2980",148627,"Saint Xavier University",1,0,2010,488,308,180,153,41,112,0.364,0.314,0.228,24790,78.870802,179,239,0.489754098360656
"2981",149222,"SOUTHERN ILLINOIS UNIVERSITY-CARBONDALE",1,0,1991,2376,1018,1358,302,139,163,0.16,0.127,0.102,2382,298.177409,1062,1724,0.725589225589226
"2982",149222,"SOUTHERN ILLINOIS UNIVERSITY-CARBONDALE",1,0,1992,2756,1203,1553,442,195,247,0.205,0.16,0.126,2556,297.72488,991,2019,0.732583454281567
"2983",149222,"SOUTHERN ILLINOIS UNIVERSITY-CARBONDALE",1,0,1993,2271,969,1302,318,152,166,0.171,0.14,0.117,3052,307.944481,977,1673,0.736679876706297
"2984",149222,"SOUTHERN ILLINOIS UNIVERSITY-CARBONDALE",1,0,1995,2277,1006,1271,371,162,209,0.208,0.163,0.127,3338,334.228455,973,1698,0.745718050065876
"2985",149222,"SOUTHERN ILLINOIS UNIVERSITY-CARBONDALE",1,0,1996,2404,1054,1350,376,152,224,0.212,0.156,0.113,3522,341.886455,963,1679,0.698419301164726
"2986",149222,"SOUTHERN ILLINOIS UNIVERSITY-CARBONDALE",1,0,1997,2400,1051,1349,451,188,263,0.25,0.188,0.139,3716,349.96476,941,1682,0.700833333333333
"2987",149222,"SOUTHERN ILLINOIS UNIVERSITY-CARBONDALE",1,0,1998,2637,1131,1506,542,248,294,0.26,0.206,0.165,3821,347.797031,918,1851,0.70193401592719
"2988",149222,"SOUTHERN ILLINOIS UNIVERSITY-CARBONDALE",1,0,1999,2547,1094,1453,483,234,249,0.228,0.19,0.161,2865,352.301264,948,1628,0.639183352964272
"2989",149222,"SOUTHERN ILLINOIS UNIVERSITY-CARBONDALE",1,0,2000,2325,1036,1289,473,201,272,0.262,0.203,0.156,2408,364.938289,1159.5,1545,0.664516129032258
"2990",149222,"SOUTHERN ILLINOIS UNIVERSITY-CARBONDALE",1,0,2001,2153,967,1186,501,220,281,0.291,0.233,0.185,2482,386.240194,1371,1571,0.729679516953089
"2991",149222,"SOUTHERN ILLINOIS UNIVERSITY-CARBONDALE",1,0,2002,2395,1037,1358,550,262,288,0.278,0.23,0.193,2928,479.348226,1279,1650,0.688935281837161
"2992",149222,"SOUTHERN ILLINOIS UNIVERSITY-CARBONDALE",1,0,2003,2532,1089,1443,595,280,315,0.289,0.235,0.194,4245,475.14047,1290,1757,0.69391785150079
"2993",149222,"SOUTHERN ILLINOIS UNIVERSITY CARBONDALE",1,0,2004,2545,1053,1492,646,308,338,0.321,0.254,0.206,4920,602.935318,973,1762,0.692337917485265
"2994",149222,"Southern Illinois University Carbondale",1,0,2005,2382,1034,1348,560,261,299,0.289,0.235,0.194,5310,528.126865,954,1553,0.651973131821998
"2995",149222,"Southern Illinois University Carbondale",1,0,2006,2278,1005,1273,586,266,320,0.318,0.257,0.209,5808,555.636743,972,1527,0.670324846356453
"2996",149222,"Southern Illinois University Carbondale",1,0,2007,2541,1127,1414,582,268,314,0.279,0.229,0.19,6348,568.590863,926,1489,0.58598976780795
"2997",149222,"Southern Illinois University Carbondale",1,0,2008,2592,1183,1409,627,305,322,0.272,0.242,0.216,6975,614.798909,941,1560,0.601851851851852
"2998",149222,"Southern Illinois University Carbondale",1,0,2009,2445,1131,1314,624,264,360,0.318,0.255,0.201,7290,652.762794,952,1460,0.597137014314928
"2999",149222,"Southern Illinois University Carbondale",1,0,2010,2314,1104,1210,602,283,319,0.289,0.26,0.234,6975,702.427505,914,1217,0.525929127052723
"3000",149231,"SOUTHERN ILLINOIS UNIVERSITY AT EDWARDSVILLE",0,1,1991,948,539,409,107,30,77,0.143,0.113,0.073,1965,96.591445,459,707,0.7457805907173
"3001",149231,"SOUTHERN ILLINOIS UNIVERSITY AT EDWARDSVILLE",0,1,1992,965,558,407,100,32,68,0.122,0.104,0.079,2158,98.626425,426,729,0.755440414507772
"3002",149231,"SOUTHERN ILLINOIS UNIVERSITY-EDWARDSVILLE",1,0,1993,912,523,389,113,38,75,0.143,0.124,0.098,2199,103.46551,421,711,0.779605263157895
"3003",149231,"SOUTHERN ILLINOIS UNIVERSITY-EDWARDSVILLE",1,0,1995,1085,644,441,154,40,114,0.177,0.142,0.091,2329,116.087566,461,842,0.776036866359447
"3004",149231,"SOUTHERN ILLINOIS UNIVERSITY-EDWARDSVILLE",1,0,1996,1176,741,435,170,36,134,0.181,0.145,0.083,2469,121.910019,466,940,0.799319727891156
"3005",149231,"SOUTHERN ILLINOIS UNIVERSITY-EDWARDSVILLE",1,0,1997,1219,734,485,242,65,177,0.241,0.199,0.134,2586,133.986953,482,1004,0.823625922887613
"3006",149231,"SOUTHERN ILLINOIS UNIVERSITY-EDWARDSVILLE",1,0,1998,1408,853,555,257,70,187,0.219,0.183,0.126,2664,127.771624,481,1125,0.799005681818182
"3007",149231,"SOUTHERN ILLINOIS UNIVERSITY-EDWARDSVILLE",1,0,1999,1357,800,557,253,66,187,0.234,0.186,0.118,2143,134.62068,491,1081,0.796610169491525
"3008",149231,"SOUTHERN ILLINOIS UNIVERSITY-EDWARDSVILLE",1,0,2000,1495,848,647,324,103,221,0.261,0.217,0.159,2388,146.018858,488.5,1221,0.816722408026756
"3009",149231,"SOUTHERN ILLINOIS UNIVERSITY-EDWARDSVILLE",1,0,2001,1573,895,678,332,108,224,0.25,0.211,0.159,2574,161.635591,486,1313,0.834710743801653
"3010",149231,"SOUTHERN ILLINOIS UNIVERSITY-EDWARDSVILLE",1,0,2002,1629,866,763,356,126,230,0.266,0.219,0.165,2970,192.071948,494,1394,0.855739717618171
"3011",149231,"SOUTHERN ILLINOIS UNIVERSITY-EDWARDSVILLE",1,0,2003,1699,982,717,399,129,270,0.275,0.235,0.18,3360,188.065788,518,1427,0.839905826957034
"3012",149231,"SOUTHERN ILLINOIS UNIVERSITY EDWARDSVILLE",1,0,2004,1695,986,709,485,162,323,0.328,0.286,0.228,4020,246.762491,528,1470,0.867256637168142
"3013",149231,"Southern Illinois University Edwardsville",1,0,2005,1721,994,727,487,166,321,0.323,0.283,0.228,4350,214.485365,556,1478,0.858803021499128
"3014",149231,"Southern Illinois University Edwardsville",1,0,2006,1770,1025,745,527,163,364,0.355,0.298,0.219,4758,222.357523,578,1535,0.867231638418079
"3015",149231,"Southern Illinois University Edwardsville",1,0,2007,1833,1026,807,509,179,330,0.322,0.278,0.222,5228,232.729015,592,1426,0.777959629023459
"3016",149231,"Southern Illinois University Edwardsville",1,0,2008,1901,1101,800,545,194,351,0.319,0.287,0.242,5850,254.716661,610,1492,0.784850078905839
"3017",149231,"Southern Illinois University Edwardsville",1,0,2009,1911,1068,843,503,198,305,0.286,0.263,0.235,6201,266.504303,622,1437,0.751962323390895
"3018",149231,"Southern Illinois University Edwardsville",1,0,2010,2022,1104,918,520,196,324,0.294,0.257,0.214,5668,286.542204,627,1460,0.722057368941642
"3019",149772,"WESTERN ILLINOIS UNIVERSITY",1,0,1991,1685,877,808,354,155,199,0.227,0.21,0.192,2241,121.201456,604,1355,0.804154302670623
"3020",149772,"WESTERN ILLINOIS UNIVERSITY",1,0,1992,1566,763,803,315,137,178,0.233,0.201,0.171,2454,123.698924,604,1264,0.807151979565773
"3021",149772,"WESTERN ILLINOIS UNIVERSITY",1,0,1993,1531,793,738,347,146,201,0.254,0.227,0.198,2548,122.190764,606,1228,0.802090137165251
"3022",149772,"WESTERN ILLINOIS UNIVERSITY",1,0,1995,1538,757,781,392,168,224,0.296,0.255,0.215,2702,127.791112,616,1316,0.855656697009103
"3023",149772,"WESTERN ILLINOIS UNIVERSITY",1,0,1996,1477,720,757,428,171,257,0.357,0.29,0.226,2810,139.946723,621,1275,0.863236289776574
"3024",149772,"WESTERN ILLINOIS UNIVERSITY",1,0,1997,1602,833,769,450,180,270,0.324,0.281,0.234,3036,143.096138,598,1388,0.866416978776529
"3025",149772,"WESTERN ILLINOIS UNIVERSITY",1,0,1998,1749,928,821,504,203,301,0.324,0.288,0.247,3185,155.598692,605,1502,0.858776443682104
"3026",149772,"WESTERN ILLINOIS UNIVERSITY",1,0,1999,1690,856,834,542,215,327,0.382,0.321,0.258,2730,165.249268,599,1434,0.848520710059172
"3027",149772,"WESTERN ILLINOIS UNIVERSITY",1,0,2000,1762,904,858,557,245,312,0.345,0.316,0.286,2812,177.434335,613,1488,0.844494892167991
"3028",149772,"WESTERN ILLINOIS UNIVERSITY",1,0,2001,1677,836,841,557,245,312,0.373,0.332,0.291,2982,194.658773,627,1457,0.86881335718545
"3029",149772,"WESTERN ILLINOIS UNIVERSITY",1,0,2002,1917,941,976,619,280,339,0.36,0.323,0.287,3465,196.283319,606,1637,0.853938445487741
"3030",149772,"WESTERN ILLINOIS UNIVERSITY",1,0,2003,1938,939,999,675,322,353,0.376,0.348,0.322,3915,191.659816,619,1607,0.829205366357069
"3031",149772,"WESTERN ILLINOIS UNIVERSITY",1,0,2004,2056,1025,1031,681,301,380,0.371,0.331,0.292,4537,240.987536,610,1694,0.823929961089494
"3032",149772,"Western Illinois University",1,0,2005,1802,885,917,549,265,284,0.321,0.305,0.289,4968,208.23566,632,1449,0.804106548279689
"3033",149772,"Western Illinois University",1,0,2006,1907,909,998,583,303,280,0.308,0.306,0.304,5439,215.175916,642,1556,0.815941269008915
"3034",149772,"Western Illinois University",1,0,2007,1943,952,991,572,258,314,0.33,0.294,0.26,5895,227.236863,646,1506,0.775090066906845
"3035",149772,"Western Illinois University",1,0,2008,1806,881,925,536,278,258,0.293,0.297,0.301,6456,239.166808,668,1353,0.749169435215947
"3036",149772,"Western Illinois University",1,0,2009,1633,817,816,515,226,289,0.354,0.315,0.277,6779,248.213446,662,1193,0.730557256582976
"3037",149772,"Western Illinois University",1,0,2010,1741,886,855,534,265,269,0.304,0.307,0.31,6588,260.583553,648,1172,0.673176335439403
"3038",149781,"WHEATON COLLEGE",1,0,1991,544,277,267,373,164,209,0.755,0.686,0.614,9548,45.381516,147,504,0.926470588235294
"3039",149781,"WHEATON COLLEGE",1,0,1992,548,294,254,392,172,220,0.748,0.715,0.677,10280,48.08609,154,489,0.892335766423358
"3040",149781,"WHEATON COLLEGE",1,0,1993,546,282,264,371,159,212,0.752,0.679,0.602,10640,51.202467,156,480,0.879120879120879
"3041",149781,"WHEATON COLLEGE",1,0,1995,546,281,265,425,198,227,0.808,0.778,0.747,12300,57.513174,166,480,0.879120879120879
"3042",149781,"WHEATON COLLEGE",1,0,1996,557,278,279,424,207,217,0.781,0.761,0.742,13100,62.38245,171,489,0.877917414721723
"3043",149781,"WHEATON COLLEGE",1,0,1997,546,290,256,418,189,229,0.79,0.766,0.738,13780,60.502753,170,485,0.888278388278388
"3044",149781,"WHEATON COLLEGE",1,0,1998,573,300,273,409,186,223,0.743,0.714,0.681,14360,58.840732,170,519,0.905759162303665
"3045",149781,"WHEATON COLLEGE",1,0,1999,583,311,272,450,204,246,0.791,0.772,0.75,14930,61.200423,166,518,0.888507718696398
"3046",149781,"WHEATON COLLEGE",1,0,2000,568,291,277,441,212,229,0.787,0.776,0.765,15540,64.942367,211,491,0.86443661971831
"3047",149781,"WHEATON COLLEGE",1,0,2001,572,276,296,416,200,216,0.783,0.727,0.676,16390,68.383451,256,494,0.863636363636364
"3048",149781,"WHEATON COLLEGE",1,0,2002,569,286,283,447,213,234,0.818,0.786,0.753,17320,74.222338,185,489,0.859402460456942
"3049",149781,"WHEATON COLLEGE",1,0,2003,576,288,288,462,223,239,0.83,0.802,0.774,18500,75.507899,183,503,0.873263888888889
"3050",149781,"WHEATON COLLEGE",1,0,2004,595,318,277,469,202,267,0.84,0.788,0.729,20000,77.602919,188,503,0.845378151260504
"3051",149781,"Wheaton College",1,0,2005,578,287,291,458,220,238,0.829,0.792,0.756,21100,84.714912,193,496,0.858131487889273
"3052",149781,"Wheaton College",1,0,2006,572,278,294,435,219,216,0.777,0.76,0.745,22450,90.536301,196,481,0.840909090909091
"3053",149781,"Wheaton College",1,0,2007,580,292,288,432,216,216,0.74,0.745,0.75,23730,94.420858,196,486,0.837931034482759
"3054",149781,"Wheaton College",1,0,2008,580,291,289,462,219,243,0.835,0.797,0.758,25500,101.280139,202,475,0.818965517241379
"3055",149781,"Wheaton College",1,0,2009,620,318,302,501,232,269,0.846,0.808,0.768,26520,106.246757,202,510,0.82258064516129
"3056",149781,"Wheaton College",1,0,2010,602,312,290,495,226,269,0.862,0.822,0.779,27580,105.381135,199,502,0.833887043189369
"3057",150066,"ANDERSON UNIVERSITY",1,0,1991,460,245,215,123,47,76,0.31,0.267,0.219,8060,24.928614,103,432,0.939130434782609
"3058",150066,"ANDERSON UNIVERSITY",1,0,1992,507,297,210,162,53,109,0.367,0.32,0.252,8780,26.264081,123,470,0.927021696252465
"3059",150066,"ANDERSON UNIVERSITY",1,0,1993,423,251,172,131,43,88,0.351,0.31,0.25,9520,29.605914,136,394,0.931442080378251
"3060",150066,"ANDERSON UNIVERSITY",1,0,1995,498,298,200,169,59,110,0.369,0.339,0.295,11240,35.558187,136,470,0.943775100401606
"3061",150066,"ANDERSON UNIVERSITY",1,0,1996,406,222,184,144,47,97,0.437,0.355,0.255,11840,35.979895,137,376,0.926108374384236
"3062",150066,"ANDERSON UNIVERSITY",1,0,1997,451,266,185,172,54,118,0.444,0.381,0.292,12700,23.197966,136,418,0.926829268292683
"3063",150066,"ANDERSON UNIVERSITY",1,0,1998,534,319,215,202,78,124,0.389,0.378,0.363,13360,27.373959,135,500,0.936329588014981
"3064",150066,"ANDERSON UNIVERSITY",1,0,1999,498,304,194,206,61,145,0.477,0.414,0.314,13740,28.496124,135,455,0.913654618473896
"3065",150066,"ANDERSON UNIVERSITY",1,0,2000,538,275,263,212,77,135,0.491,0.394,0.293,14680,29.43194,138,497,0.923791821561338
"3066",150066,"ANDERSON UNIVERSITY",1,0,2001,462,272,190,170,45,125,0.46,0.368,0.237,15380,30.90126,141,402,0.87012987012987
"3067",150066,"ANDERSON UNIVERSITY",1,0,2002,591,335,256,225,72,153,0.457,0.381,0.281,16140,33.842,139,522,0.883248730964467
"3068",150066,"ANDERSON UNIVERSITY",1,0,2003,559,337,222,246,81,165,0.49,0.44,0.365,17050,38.358,139,511,0.914132379248658
"3069",150066,"ANDERSON UNIVERSITY",1,0,2004,579,340,239,248,92,156,0.459,0.428,0.385,17990,40.57,137,515,0.889464594127807
"3070",150066,"Anderson University",1,0,2005,565,348,217,272,93,179,0.514,0.481,0.429,18900,44.136,141,500,0.884955752212389
"3071",150066,"Anderson University",1,0,2006,447,245,202,206,83,123,0.502,0.461,0.411,19990,46.601,148,397,0.888143176733781
"3072",150066,"Anderson University",1,0,2007,479,239,240,216,90,126,0.527,0.451,0.375,20976,48.368,145,414,0.864300626304802
"3073",150066,"Anderson University",1,0,2008,540,316,224,259,97,162,0.513,0.48,0.433,21920,48.636,140,470,0.87037037037037
"3074",150066,"Anderson University",1,0,2009,547,313,234,238,83,155,0.495,0.435,0.355,22910,50.374,146,478,0.873857404021938
"3075",150066,"Anderson University",1,0,2010,469,264,205,230,79,151,0.572,0.49,0.385,23940,50.496,138,377,0.803837953091684
"3076",150136,"BALL STATE UNIVERSITY",1,0,1991,3447,1976,1471,1555,602,953,0.482,0.451,0.409,2280,216.311817,943,3132,0.908616187989556
"3077",150136,"BALL STATE UNIVERSITY",1,0,1992,3265,1841,1424,699,236,463,0.252,0.214,0.166,2464,230.299772,939,2983,0.913629402756508
"3078",150136,"BALL STATE UNIVERSITY",1,0,1993,3872,2104,1768,701,230,471,0.224,0.181,0.13,2656,233.69647,965,3496,0.902892561983471
"3079",150136,"BALL STATE UNIVERSITY",1,0,1995,3855,2068,1787,787,262,525,0.254,0.204,0.147,3048,246.312324,906,3463,0.898313878080415
"3080",150136,"BALL STATE UNIVERSITY",1,0,1996,3763,1959,1804,726,241,485,0.248,0.193,0.134,3188,258.328678,893,3377,0.897422269465852
"3081",150136,"BALL STATE UNIVERSITY",1,0,1997,4047,2177,1870,837,242,595,0.273,0.207,0.129,3316,268.897104,870,3537,0.873980726464047
"3082",150136,"BALL STATE UNIVERSITY",1,0,1998,3512,1905,1607,896,311,585,0.307,0.255,0.194,3454,277.658719,863,3126,0.890091116173121
"3083",150136,"BALL STATE UNIVERSITY",1,0,1999,3602,1931,1671,943,348,595,0.308,0.262,0.208,3576,280.240581,841,3171,0.880344253192671
"3084",150136,"BALL STATE UNIVERSITY",1,0,2000,3694,2023,1671,1062,372,690,0.341,0.287,0.223,3720,288.677552,862,3242,0.877639415268002
"3085",150136,"BALL STATE UNIVERSITY",1,0,2001,3743,2039,1704,1066,344,722,0.354,0.285,0.202,3924,305.871664,883,3338,0.891798022976222
"3086",150136,"BALL STATE UNIVERSITY",1,0,2002,4010,2207,1803,1327,507,820,0.372,0.331,0.281,4320,288.046978,858,3571,0.890523690773067
"3087",150136,"BALL STATE UNIVERSITY",1,0,2003,3963,2139,1824,1329,507,822,0.384,0.335,0.278,4532,303.261723,896,3627,0.915215745647237
"3088",150136,"BALL STATE UNIVERSITY",1,0,2004,3662,1951,1711,1141,390,751,0.385,0.312,0.228,5264,314.18808,903,3274,0.89404696886947
"3089",150136,"Ball State University",1,0,2005,3660,1892,1768,1063,367,696,0.368,0.29,0.208,6030,328.765361,910,3165,0.864754098360656
"3090",150136,"Ball State University",1,0,2006,3947,2027,1920,1155,425,730,0.36,0.293,0.221,6360,342.150332,915,3418,0.865974157588042
"3091",150136,"Ball State University",1,0,2007,3747,2033,1714,1223,432,791,0.389,0.326,0.252,6736,356.898495,917,3204,0.855084067253803
"3092",150136,"Ball State University",1,0,2008,3983,2188,1795,1384,504,880,0.402,0.347,0.281,7000,385.217613,925,3447,0.865428069294502
"3093",150136,"Ball State University",1,0,2009,4131,2240,1891,1542,570,972,0.434,0.373,0.301,7228,396.73254,940,3494,0.845800048414427
"3094",150136,"Ball State University",1,0,2010,3849,2123,1726,1588,560,1028,0.484,0.413,0.324,7508,405.792502,950,3259,0.846713432060275
"3095",150145,"BETHEL COLLEGE",1,0,1991,116,61,55,29,17,12,0.197,0.25,0.309,7500,6.039832,33,111,0.956896551724138
"3096",150145,"BETHEL COLLEGE",1,0,1992,152,88,64,48,16,32,0.364,0.316,0.25,7950,7.292238,33,132,0.868421052631579
"3097",150145,"BETHEL COLLEGE",1,0,1993,168,95,73,62,23,39,0.41,0.369,0.315,8700,8.492283,36,158,0.94047619047619
"3098",150145,"BETHEL COLLEGE",1,0,1995,184,118,66,63,18,45,0.381,0.342,0.273,9750,10.724936,48,166,0.902173913043478
"3099",150145,"BETHEL COLLEGE",1,0,1996,201,117,84,68,22,46,0.393,0.338,0.262,10350,12.446338,51,184,0.915422885572139
"3100",150145,"BETHEL COLLEGE",1,0,1997,223,144,79,97,33,64,0.444,0.435,0.418,11100,12.441796,58,201,0.901345291479821
"3101",150145,"BETHEL COLLEGE",1,0,1998,273,173,100,104,36,68,0.393,0.381,0.36,11500,14.408788,63,257,0.941391941391941
"3102",150145,"BETHEL COLLEGE",1,0,1999,265,156,109,98,30,68,0.436,0.37,0.275,11950,15.861138,68,250,0.943396226415094
"3103",150145,"BETHEL COLLEGE",1,0,2000,294,182,112,114,41,73,0.401,0.388,0.366,12550,16.748774,68.5,277,0.942176870748299
"3104",150145,"BETHEL COLLEGE",1,0,2001,258,161,97,110,34,76,0.472,0.426,0.351,13300,17.975598,69,231,0.895348837209302
"3105",150145,"BETHEL COLLEGE",1,0,2002,253,143,110,108,34,74,0.517,0.427,0.309,13990,18.372287,76,231,0.91304347826087
"3106",150145,"BETHEL COLLEGE",1,0,2003,291,175,116,117,39,78,0.446,0.402,0.336,14390,20.185129,83,265,0.910652920962199
"3107",150145,"BETHEL COLLEGE",1,0,2004,306,174,132,125,38,87,0.5,0.408,0.288,15200,22.314441,88,278,0.908496732026144
"3108",150145,"Bethel College",1,0,2005,310,207,103,122,41,81,0.391,0.394,0.398,15950,24.32812,84,283,0.912903225806452
"3109",150145,"Bethel College",1,0,2006,303,190,113,136,41,95,0.5,0.449,0.363,17450,26.275211,88,259,0.854785478547855
"3110",150145,"Bethel College",1,0,2007,249,159,90,106,33,73,0.459,0.426,0.367,18600,27.754569,84,204,0.819277108433735
"3111",150145,"Bethel College",1,0,2008,242,149,93,132,45,87,0.584,0.545,0.484,19996,31.786034,91,199,0.822314049586777
"3112",150145,"Bethel College",1,0,2009,295,175,120,165,60,105,0.6,0.559,0.5,20978,30.115123,91,263,0.891525423728814
"3113",150145,"Bethel College-Mishawaka",1,0,2010,269,169,100,144,51,93,0.55,0.535,0.51,21990,30.869353,88,225,0.836431226765799
"3114",150163,"BUTLER UNIVERSITY",1,0,1991,622,363,259,252,94,158,0.435,0.405,0.363,10500,47.32635,217,550,0.884244372990354
"3115",150163,"BUTLER UNIVERSITY",1,0,1992,666,383,283,257,98,159,0.415,0.386,0.346,11340,52.483134,216,613,0.92042042042042
"3116",150163,"BUTLER UNIVERSITY",1,0,1993,700,437,263,288,94,194,0.444,0.411,0.357,12280,58.638,220,646,0.922857142857143
"3117",150163,"BUTLER UNIVERSITY",1,0,1995,847,510,337,409,145,264,0.518,0.483,0.43,13990,62.972,231,757,0.893742621015348
"3118",150163,"BUTLER UNIVERSITY",1,0,1996,777,475,302,426,137,289,0.608,0.548,0.454,14900,72.248,230,626,0.805662805662806
"3119",150163,"BUTLER UNIVERSITY",1,0,1997,699,458,241,369,120,249,0.544,0.528,0.498,15570,67.068,227,541,0.773962804005722
"3120",150163,"BUTLER UNIVERSITY",1,0,1998,912,557,355,452,145,307,0.551,0.496,0.408,16280,71.841,239,821,0.900219298245614
"3121",150163,"BUTLER UNIVERSITY",1,0,1999,861,529,332,470,168,302,0.571,0.546,0.506,17180,82.929223,245,700,0.813008130081301
"3122",150163,"BUTLER UNIVERSITY",1,0,2000,868,559,309,516,182,334,0.598,0.594,0.589,18040,80.901,260,736,0.847926267281106
"3123",150163,"BUTLER UNIVERSITY",1,0,2001,929,593,336,512,168,344,0.58,0.551,0.5,18940,81.764,275,822,0.884822389666308
"3124",150163,"BUTLER UNIVERSITY",1,0,2002,936,595,341,485,157,328,0.551,0.518,0.46,19990,81.453,257,836,0.893162393162393
"3125",150163,"BUTLER UNIVERSITY",1,0,2003,972,612,360,550,184,366,0.598,0.566,0.511,20990,83.321,289,803,0.826131687242798
"3126",150163,"BUTLER UNIVERSITY",1,0,2004,925,571,354,458,143,315,0.552,0.495,0.404,22250,87.247,272,799,0.863783783783784
"3127",150163,"Butler University",1,0,2005,864,536,328,391,119,272,0.508,0.453,0.363,23530,90.737,285,752,0.87037037037037
"3128",150163,"Butler University",1,0,2006,965,604,361,479,150,329,0.545,0.496,0.416,24710,95.199,291,811,0.840414507772021
"3129",150163,"Butler University",1,0,2007,987,613,374,502,157,345,0.563,0.509,0.42,26070,103.514,305,864,0.875379939209726
"3130",150163,"Butler University",1,0,2008,934,566,368,580,209,371,0.655,0.621,0.568,27500,112.543,307,788,0.843683083511777
"3131",150163,"Butler University",1,0,2009,944,571,373,501,166,335,0.587,0.531,0.445,28460,118.13,325,804,0.851694915254237
"3132",150163,"Butler University",1,0,2010,1049,616,433,600,211,389,0.631,0.572,0.487,29740,123.86,332,863,0.822688274547188
"3133",150400,"DEPAUW UNIVERSITY",1,0,1991,475,258,217,367,157,210,0.814,0.773,0.724,12288,44.454503,155,404,0.850526315789474
"3134",150400,"DEPAUW UNIVERSITY",1,0,1992,566,326,240,410,169,241,0.739,0.724,0.704,13000,44.390484,149,471,0.832155477031802
"3135",150400,"DEPAUW UNIVERSITY",1,0,1993,495,250,245,361,179,182,0.728,0.729,0.731,13700,49.188312,146,440,0.888888888888889
"3136",150400,"DEPAUW UNIVERSITY",1,0,1995,580,328,252,434,187,247,0.753,0.748,0.742,15475,47.625328,146,479,0.825862068965517
"3137",150400,"DEPAUW UNIVERSITY",1,0,1996,619,351,268,450,192,258,0.735,0.727,0.716,16180,53.381206,148,538,0.869143780290792
"3138",150400,"DEPAUW UNIVERSITY",1,0,1997,673,363,310,493,228,265,0.73,0.733,0.735,17050,62.305959,153,591,0.87815750371471
"3139",150400,"DEPAUW UNIVERSITY",1,0,1998,593,344,249,423,164,259,0.753,0.713,0.659,17650,67.710047,149,510,0.860033726812816
"3140",150400,"DEPAUW UNIVERSITY",1,0,1999,579,327,252,436,194,242,0.74,0.753,0.77,19420,73.433666,167,491,0.848013816925734
"3141",150400,"DEPAUW UNIVERSITY",1,0,2000,610,336,274,479,202,277,0.824,0.785,0.737,20200,80.265335,174.5,537,0.880327868852459
"3142",150400,"DEPAUW UNIVERSITY",1,0,2001,620,350,270,481,205,276,0.789,0.776,0.759,21100,90.285125,182,543,0.875806451612903
"3143",150400,"DEPAUW UNIVERSITY",1,0,2002,685,369,316,566,259,307,0.832,0.826,0.82,22400,94.783913,185,590,0.861313868613139
"3144",150400,"DEPAUW UNIVERSITY",1,0,2003,580,305,275,456,202,254,0.833,0.786,0.735,24000,106.029309,209,480,0.827586206896552
"3145",150400,"DEPAUW UNIVERSITY",1,0,2004,661,367,294,546,229,317,0.864,0.826,0.779,25000,108.783676,213,572,0.86535552193646
"3146",150400,"DePauw University",1,0,2005,586,337,249,470,197,273,0.81,0.802,0.791,26100,112.918993,226,505,0.861774744027304
"3147",150400,"DePauw University",1,0,2006,595,334,261,442,186,256,0.767,0.743,0.713,27400,120.031097,221,476,0.8
"3148",150400,"DePauw University",1,0,2007,664,369,295,493,211,282,0.764,0.742,0.715,29300,122.368114,216,524,0.789156626506024
"3149",150400,"DePauw University",1,0,2008,600,341,259,448,172,276,0.809,0.747,0.664,31400,93.333653,227,437,0.728333333333333
"3150",150400,"DePauw University",1,0,2009,717,405,312,543,222,321,0.793,0.757,0.712,32800,94.888199,220,515,0.718270571827057
"3151",150400,"DePauw University",1,0,2010,608,345,263,474,202,272,0.788,0.78,0.768,34440,91.938967,215,400,0.657894736842105
"3152",150534,"UNIVERSITY OF EVANSVILLE",1,0,1991,694,403,291,281,101,180,0.447,0.405,0.347,9910,35.058607,154,614,0.884726224783862
"3153",150534,"UNIVERSITY OF EVANSVILLE",1,0,1992,754,435,319,322,117,205,0.471,0.427,0.367,10700,40.872462,165,677,0.897877984084881
"3154",150534,"UNIVERSITY OF EVANSVILLE",1,0,1993,746,424,322,296,113,183,0.432,0.397,0.351,11130,45.689741,170,651,0.872654155495979
"3155",150534,"UNIVERSITY OF EVANSVILLE",1,0,1995,826,504,322,370,131,239,0.474,0.448,0.407,12600,54.973898,176,710,0.85956416464891
"3156",150534,"UNIVERSITY OF EVANSVILLE",1,0,1996,694,428,266,294,99,195,0.456,0.424,0.372,13220,60.300285,183,588,0.847262247838617
"3157",150534,"UNIVERSITY OF EVANSVILLE",1,0,1997,719,424,295,312,108,204,0.481,0.434,0.366,13600,43.426758,182,616,0.856745479833102
"3158",150534,"UNIVERSITY OF EVANSVILLE",1,0,1998,665,423,242,293,92,201,0.475,0.441,0.38,14400,45.770658,176,545,0.819548872180451
"3159",150534,"UNIVERSITY OF EVANSVILLE",1,0,1999,594,367,227,276,97,179,0.488,0.465,0.427,15200,46.457704,177,474,0.797979797979798
"3160",150534,"UNIVERSITY OF EVANSVILLE",1,0,2000,555,320,235,237,84,153,0.478,0.427,0.357,16100,47.256898,175,422,0.76036036036036
"3161",150534,"UNIVERSITY OF EVANSVILLE",1,0,2001,511,310,201,226,93,133,0.429,0.442,0.463,17050,48.174193,173,324,0.634050880626223
"3162",150534,"UNIVERSITY OF EVANSVILLE",1,0,2002,600,369,231,289,100,189,0.512,0.482,0.433,17900,47.420383,168,385,0.641666666666667
"3163",150534,"UNIVERSITY OF EVANSVILLE",1,0,2003,662,418,244,346,119,227,0.543,0.523,0.488,18900,49.152837,168,456,0.688821752265861
"3164",150534,"UNIVERSITY OF EVANSVILLE",1,0,2004,634,382,252,357,131,226,0.592,0.563,0.52,19995,51.554492,167,508,0.801261829652997
"3165",150534,"University of Evansville",1,0,2005,670,416,254,337,105,232,0.558,0.503,0.413,21120,54.466701,174,535,0.798507462686567
"3166",150534,"University of Evansville",1,0,2006,643,379,264,359,139,220,0.581,0.558,0.527,22370,58.32526,179,527,0.819595645412131
"3167",150534,"University of Evansville",1,0,2007,651,375,276,344,129,215,0.573,0.528,0.467,23710,66.004981,177,510,0.783410138248848
"3168",150534,"University of Evansville",1,0,2008,616,377,239,325,116,209,0.554,0.528,0.485,25130,64.016827,176,490,0.795454545454545
"3169",150534,"University of Evansville",1,0,2009,701,433,268,403,152,251,0.58,0.575,0.567,26010,65.428186,172,574,0.818830242510699
"3170",150534,"University of Evansville",1,0,2010,683,403,280,398,136,262,0.65,0.583,0.486,27310,67.144833,174,570,0.834553440702782
"3171",150668,"GOSHEN COLLEGE",0,1,1991,194,106,88,83,30,53,0.5,0.428,0.341,7720,14.525084,72,167,0.860824742268041
"3172",150668,"GOSHEN COLLEGE",0,1,1992,201,104,97,73,37,36,0.346,0.363,0.381,8310,14.909855,74,177,0.880597014925373
"3173",150668,"GOSHEN COLLEGE",0,1,1993,229,140,89,88,34,54,0.386,0.384,0.382,8770,15.976391,84,196,0.85589519650655
"3174",150668,"GOSHEN COLLEGE",1,0,1995,213,111,102,104,40,64,0.577,0.488,0.392,9900,19.78033,74,192,0.901408450704225
"3175",150668,"GOSHEN COLLEGE",1,0,1996,197,107,90,90,39,51,0.477,0.457,0.433,10900,19.902403,74,182,0.923857868020305
"3176",150668,"GOSHEN COLLEGE",1,0,1997,209,116,93,89,32,57,0.491,0.426,0.344,11450,17.673717,67,180,0.861244019138756
"3177",150668,"GOSHEN COLLEGE",1,0,1998,207,121,86,99,39,60,0.496,0.478,0.453,12150,17.865599,72,181,0.8743961352657
"3178",150668,"GOSHEN COLLEGE",1,0,1999,220,135,85,90,30,60,0.444,0.409,0.353,12320,19.711968,76,190,0.863636363636364
"3179",150668,"GOSHEN COLLEGE",1,0,2000,194,113,81,87,30,57,0.504,0.448,0.37,12870,20.412678,77,158,0.814432989690722
"3180",150668,"GOSHEN COLLEGE",1,0,2001,172,94,78,87,33,54,0.575,0.506,0.423,13600,22.224054,78,140,0.813953488372093
"3181",150668,"GOSHEN COLLEGE",1,0,2002,133,81,52,74,28,46,0.568,0.556,0.538,14700,25.192112,75,107,0.804511278195489
"3182",150668,"GOSHEN COLLEGE",1,0,2003,181,99,82,101,41,60,0.606,0.558,0.5,16320,25.867711,69,157,0.867403314917127
"3183",150668,"GOSHEN COLLEGE",1,0,2004,168,95,73,84,38,46,0.484,0.5,0.521,18200,25.734557,65,143,0.851190476190476
"3184",150668,"Goshen College",1,0,2005,194,108,86,113,44,69,0.639,0.582,0.512,19300,26.264186,72,162,0.835051546391753
"3185",150668,"Goshen College",1,0,2006,206,122,84,114,44,70,0.574,0.553,0.524,20300,26.934952,73,172,0.83495145631068
"3186",150668,"Goshen College",1,0,2007,202,114,88,110,44,66,0.579,0.545,0.5,21300,28.902958,71,160,0.792079207920792
"3187",150668,"Goshen College",1,0,2008,172,97,75,95,36,59,0.608,0.552,0.48,22300,30.029708,67,131,0.761627906976744
"3188",150668,"Goshen College",1,0,2009,238,148,90,126,45,81,0.547,0.529,0.5,23400,30.243402,67,196,0.823529411764706
"3189",150668,"Goshen College",1,0,2010,179,106,73,100,39,61,0.576,0.559,0.534,24500,29.588338,72,128,0.715083798882682
"3190",150941,"HUNTINGTON COLLEGE",1,0,1991,154,76,78,55,30,25,0.329,0.357,0.385,7890,9.106762,38,144,0.935064935064935
"3191",150941,"HUNTINGTON COLLEGE",1,0,1992,150,92,58,75,24,51,0.554,0.5,0.414,8730,9.593187,37,138,0.92
"3192",150941,"HUNTINGTON COLLEGE",1,0,1993,124,69,55,64,26,38,0.551,0.516,0.473,9490,10.143129,38,117,0.943548387096774
"3193",150941,"HUNTINGTON COLLEGE",1,0,1995,191,113,78,87,27,60,0.531,0.455,0.346,10800,11.532147,40,180,0.942408376963351
"3194",150941,"HUNTINGTON COLLEGE",1,0,1996,174,104,70,95,37,58,0.558,0.546,0.529,11520,13.08464,41,169,0.971264367816092
"3195",150941,"HUNTINGTON COLLEGE",1,0,1997,197,129,68,95,21,74,0.574,0.482,0.309,12180,14.825785,43,193,0.979695431472081
"3196",150941,"HUNTINGTON COLLEGE",1,0,1998,227,151,76,115,34,81,0.536,0.507,0.447,12250,16.289118,49,221,0.973568281938326
"3197",150941,"HUNTINGTON COLLEGE",1,0,1999,221,140,81,127,43,84,0.6,0.575,0.531,12780,13.833376,52,214,0.968325791855204
"3198",150941,"HUNTINGTON COLLEGE",1,0,2000,206,109,97,100,46,54,0.495,0.485,0.474,13540,15.211599,53.5,200,0.970873786407767
"3199",150941,"HUNTINGTON COLLEGE",1,0,2001,220,135,85,117,43,74,0.548,0.532,0.506,14270,16.468775,55,212,0.963636363636364
"3200",150941,"HUNTINGTON COLLEGE",1,0,2002,236,145,91,110,40,70,0.483,0.466,0.44,15520,17.102989,56,224,0.949152542372881
"3201",150941,"HUNTINGTON COLLEGE",1,0,2003,190,103,87,94,45,49,0.476,0.495,0.517,16120,18.268984,54,184,0.968421052631579
"3202",150941,"HUNTINGTON COLLEGE",1,0,2004,203,123,80,108,44,64,0.52,0.532,0.55,18060,18.077959,57,196,0.96551724137931
"3203",150941,"Huntington University",1,0,2005,232,133,99,113,45,68,0.511,0.487,0.455,18060,19.770661,61,219,0.943965517241379
"3204",150941,"Huntington University",1,0,2006,250,140,110,126,52,74,0.529,0.504,0.473,18420,20.62689,61,238,0.952
"3205",150941,"Huntington University",1,0,2007,244,138,106,138,63,75,0.543,0.566,0.594,18980,21.457988,61,233,0.954918032786885
"3206",150941,"Huntington University",1,0,2008,275,161,114,133,51,82,0.509,0.484,0.447,19840,22.690158,60,249,0.905454545454545
"3207",150941,"Huntington University",1,0,2009,250,138,112,142,64,78,0.565,0.568,0.571,20820,24.926339,62,229,0.916
"3208",150941,"Huntington University",1,0,2010,263,146,117,144,62,82,0.562,0.548,0.53,21850,24.980771,60,231,0.878326996197719
"3209",151102,"INDIANA UNIVERSITY-PURDUE UNIVERSITY AT FORT WAYNE",1,0,1991,1134,607,527,34,17,17,0.028,0.03,0.032,1981,46.524126,301,1052,0.927689594356261
"3210",151102,"INDIANA UNIVERSITY-PURDUE UNIVERSITY AT FORT WAYNE",1,0,1992,1126,612,514,39,14,25,0.041,0.035,0.027,2144,51.665222,307,1050,0.932504440497336
"3211",151102,"INDIANA UNIVERSITY-PURDUE UNIVERSITY-FORT WAYNE",1,0,1993,1189,650,539,47,17,30,0.046,0.04,0.032,2310,63.237694,306,1114,0.936921783010934
"3212",151102,"INDIANA UNIVERSITY-PURDUE UNIVERSITY-FORT WAYNE",1,0,1995,1063,577,486,43,14,29,0.05,0.04,0.029,2709,54.205508,307,977,0.919096895578551
"3213",151102,"INDIANA UNIVERSITY-PURDUE UNIVERSITY-FORT WAYNE",1,0,1996,1196,647,549,44,16,28,0.043,0.037,0.029,3006,56.383012,299,1094,0.914715719063545
"3214",151102,"INDIANA UNIVERSITY-PURDUE UNIVERSITY-FORT WAYNE",1,0,1997,1196,659,537,49,7,42,0.064,0.041,0.013,3213,60.58387,299,1086,0.908026755852843
"3215",151102,"INDIANA UNIVERSITY-PURDUE UNIVERSITY-FORT WAYNE",1,0,1998,1303,673,630,38,16,22,0.033,0.029,0.025,3350,64.100167,299,1166,0.894858019953952
"3216",151102,"INDIANA UNIVERSITY-PURDUE UNIVERSITY-FORT WAYNE",1,0,1999,1303,688,615,48,16,32,0.047,0.037,0.026,3159,68.424884,307,1199,0.920184190330008
"3217",151102,"INDIANA UNIVERSITY-PURDUE UNIVERSITY-FORT WAYNE",1,0,2000,1337,723,614,48,22,26,0.036,0.036,0.036,3446,74.074368,310,1248,0.933433059087509
"3218",151102,"INDIANA UNIVERSITY-PURDUE UNIVERSITY-FORT WAYNE",1,0,2001,1426,735,691,69,30,39,0.053,0.048,0.043,2815,76.723191,313,1307,0.916549789621318
"3219",151102,"INDIANA UNIVERSITY-PURDUE UNIVERSITY-FORT WAYNE",1,0,2002,1409,782,627,61,24,37,0.047,0.043,0.038,3384,74.229184,310,1296,0.919801277501774
"3220",151102,"INDIANA UNIVERSITY-PURDUE UNIVERSITY-FORT WAYNE",1,0,2003,1366,757,609,76,29,47,0.062,0.056,0.048,4108,83.403009,323,1218,0.891654465592972
"3221",151102,"INDIANA UNIVERSITY-PURDUE UNIVERSITY-FORT WAYNE",1,0,2004,1553,859,694,103,29,74,0.086,0.066,0.042,4266,91.344573,315,1352,0.870573084352865
"3222",151102,"Indiana University-Purdue University-Fort Wayne",1,0,2005,1534,850,684,82,31,51,0.06,0.053,0.045,4523,105.781567,306,1334,0.869621903520209
"3223",151102,"Indiana University-Purdue University-Fort Wayne",1,0,2006,1608,859,749,61,20,41,0.048,0.038,0.027,4793,121.162769,317,1407,0.875
"3224",151102,"Indiana University-Purdue University-Fort Wayne",1,0,2007,1804,942,862,91,33,58,0.062,0.05,0.038,4982,107.892187,338,1555,0.861973392461197
"3225",151102,"Indiana University-Purdue University-Fort Wayne",1,0,2008,1905,1009,896,118,36,82,0.081,0.062,0.04,5181,123.355157,342,1614,0.847244094488189
"3226",151102,"Indiana University-Purdue University-Fort Wayne",1,0,2009,2040,1054,986,131,54,77,0.073,0.064,0.055,5441,123.371222,342,1642,0.804901960784314
"3227",151102,"Indiana University-Purdue University-Fort Wayne",1,0,2010,2117,1078,1039,134,47,87,0.081,0.063,0.045,5712,135.960639,377,1654,0.781294284364667
"3228",151111,"INDIANA UNIVERSITY-PURDUE UNIV AT INDIANAPOLIS",1,0,1991,1536,862,674,54,24,30,0.035,0.035,0.036,2277,626.324309,696,1313,0.854817708333333
"3229",151111,"INDIANA UNIVERSITY-PURDUE UNIV INDIANAPOLIS",1,0,1992,1507,837,670,42,18,24,0.029,0.028,0.027,2461,727.283214,686,1300,0.86264100862641
"3230",151111,"INDIANA UNIVERSITY-PURDUE UNIVERSITY-INDIANAPOLIS",1,0,1993,1509,830,679,70,29,41,0.049,0.046,0.043,2634,729.93924,688,1342,0.889330682571239
"3231",151111,"INDIANA UNIVERSITY-PURDUE UNIVERSITY-INDIANAPOLIS",1,0,1995,1860,1024,836,148,65,83,0.081,0.08,0.078,3156,814.720372,672,1610,0.865591397849462
"3232",151111,"INDIANA UNIVERSITY-PURDUE UNIVERSITY-INDIANAPOLIS",1,0,1996,2100,1172,928,87,30,57,0.049,0.041,0.032,3300,535.558607,680,1733,0.825238095238095
"3233",151111,"INDIANA UNIVERSITY-PURDUE UNIVERSITY-INDIANAPOLIS",1,0,1997,2154,1198,956,113,55,58,0.048,0.052,0.058,3441,585.211583,705,1784,0.828226555246054
"3234",151111,"INDIANA UNIVERSITY-PURDUE UNIVERSITY-INDIANAPOLIS",1,0,1998,2570,1387,1183,110,41,69,0.05,0.043,0.035,3576,632.596997,689,2164,0.842023346303502
"3235",151111,"INDIANA UNIVERSITY-PURDUE UNIVERSITY-INDIANAPOLIS",1,0,1999,2552,1409,1143,166,67,99,0.07,0.065,0.059,3432,657.748232,683,2126,0.83307210031348
"3236",151111,"INDIANA UNIVERSITY-PURDUE UNIVERSITY-INDIANAPOLIS",1,0,2000,2473,1414,1059,168,48,120,0.085,0.068,0.045,3570,711.518415,708.5,2081,0.841488071168621
"3237",151111,"INDIANA UNIVERSITY-PURDUE UNIVERSITY-INDIANAPOLIS",1,0,2001,2275,1325,950,188,71,117,0.088,0.083,0.075,3839,768.508439,734,1911,0.84
"3238",151111,"INDIANA UNIVERSITY-PURDUE UNIVERSITY-INDIANAPOLIS",1,0,2002,2235,1286,949,195,63,132,0.103,0.087,0.066,4183,776.380438,809,1887,0.844295302013423
"3239",151111,"INDIANA UNIVERSITY-PURDUE UNIVERSITY-INDIANAPOLIS",1,0,2003,2336,1361,975,210,79,131,0.096,0.09,0.081,5151,843.648107,787,1964,0.840753424657534
"3240",151111,"INDIANA UNIVERSITY-PURDUE UNIVERSITY-INDIANAPOLIS",1,0,2004,2294,1371,923,226,80,146,0.107,0.099,0.087,5357,846.914774,854,1849,0.806015693112467
"3241",151111,"Indiana University-Purdue University-Indianapolis",1,0,2005,2396,1414,982,234,88,146,0.103,0.098,0.09,5625,945.540497,711,1895,0.790901502504174
"3242",151111,"Indiana University-Purdue University-Indianapolis",1,0,2006,2516,1549,967,317,109,208,0.134,0.126,0.113,5924,994.0853,736,1992,0.791732909379968
"3243",151111,"Indiana University-Purdue University-Indianapolis",1,0,2007,2737,1659,1078,392,144,248,0.15,0.143,0.134,6221,990.784521,738,2202,0.804530507855316
"3244",151111,"Indiana University-Purdue University-Indianapolis",1,0,2008,2802,1657,1145,463,170,293,0.177,0.165,0.148,6531,1014.062879,758,2204,0.786581013561742
"3245",151111,"Indiana University-Purdue University-Indianapolis",1,0,2009,2794,1670,1124,500,187,313,0.187,0.179,0.166,6923,1071.499881,789,2230,0.798138869005011
"3246",151111,"Indiana University-Purdue University-Indianapolis",1,0,2010,2679,1607,1072,478,176,302,0.188,0.178,0.164,7255,1059.862092,801,2036,0.759985069055618
"3247",151306,"UNIVERSITY OF SOUTHERN INDIANA",1,0,1991,1078,611,467,86,24,62,0.102,0.08,0.051,1808,30.241002,158,1030,0.955473098330241
"3248",151306,"UNIVERSITY OF SOUTHERN INDIANA",1,0,1992,1080,624,456,90,27,63,0.101,0.083,0.059,2062,33.249645,168,1014,0.938888888888889
"3249",151306,"UNIVERSITY OF SOUTHERN INDIANA",1,0,1993,1162,681,481,79,21,58,0.085,0.068,0.044,2163,36.203512,181,1096,0.943201376936317
"3250",151306,"UNIVERSITY OF SOUTHERN INDIANA",1,0,1995,1407,813,594,138,30,108,0.133,0.098,0.051,2285,45.973656,205,1305,0.927505330490405
"3251",151306,"UNIVERSITY OF SOUTHERN INDIANA",1,0,1996,1573,912,661,173,45,128,0.14,0.11,0.068,2415,48.94881,211,1496,0.951048951048951
"3252",151306,"UNIVERSITY OF SOUTHERN INDIANA",1,0,1997,1839,1053,786,239,63,176,0.167,0.13,0.08,2565,55.488985,220,1734,0.942903752039152
"3253",151306,"UNIVERSITY OF SOUTHERN INDIANA",1,0,1998,1552,945,607,197,56,141,0.149,0.127,0.092,2780,63.603461,238,1473,0.94909793814433
"3254",151306,"UNIVERSITY OF SOUTHERN INDIANA",1,0,1999,1674,1003,671,200,49,151,0.151,0.119,0.073,2768,70.266061,253,1591,0.950418160095579
"3255",151306,"UNIVERSITY OF SOUTHERN INDIANA",1,0,2000,1729,1033,696,247,57,190,0.184,0.143,0.082,2626,78.701315,258.5,1612,0.932330827067669
"3256",151306,"UNIVERSITY OF SOUTHERN INDIANA",1,0,2001,1897,1135,762,236,64,172,0.152,0.124,0.084,2774,81.514641,264,1788,0.942540853979968
"3257",151306,"UNIVERSITY OF SOUTHERN INDIANA",1,0,2002,1891,1152,739,217,50,167,0.145,0.115,0.068,3051,81.92514,276,1788,0.945531464833421
"3258",151306,"UNIVERSITY OF SOUTHERN INDIANA",1,0,2003,1953,1151,802,271,78,193,0.168,0.139,0.097,3442,85.200322,278,1835,0.93958013312852
"3259",151306,"UNIVERSITY OF SOUTHERN INDIANA",1,0,2004,2004,1196,808,269,71,198,0.166,0.134,0.088,3676,96.486385,284,1849,0.922654690618762
"3260",151306,"University of Southern Indiana",1,0,2005,2042,1195,847,306,90,216,0.181,0.15,0.106,3807,101.613633,311,1890,0.925563173359451
"3261",151306,"University of Southern Indiana",1,0,2006,2021,1253,768,321,70,251,0.2,0.159,0.091,4014,109.201683,296,1843,0.911924789708065
"3262",151306,"University of Southern Indiana",1,0,2007,2074,1209,865,299,74,225,0.186,0.144,0.086,4258,112.982354,307,1868,0.900675024108004
"3263",151306,"University of Southern Indiana",1,0,2008,2055,1232,823,340,83,257,0.209,0.165,0.101,4509,115.517578,323,1794,0.872992700729927
"3264",151306,"University of Southern Indiana",1,0,2009,2048,1199,849,420,100,320,0.267,0.205,0.118,5274,120.779928,343,1809,0.88330078125
"3265",151306,"University of Southern Indiana",1,0,2010,2041,1179,862,378,115,263,0.223,0.185,0.133,5540,127.561582,349,1757,0.860852523272905
"3266",151324,"INDIANA STATE UNIVERSITY",1,0,1991,1919,969,950,276,114,162,0.167,0.144,0.12,2272,131.43589,605,1677,0.873892652423137
"3267",151324,"INDIANA STATE UNIVERSITY",1,0,1992,2187,1161,1026,339,124,215,0.185,0.155,0.121,2452,131.985484,560,1871,0.855509830818473
"3268",151324,"INDIANA STATE UNIVERSITY",1,0,1993,2221,1165,1056,334,128,206,0.177,0.15,0.121,2622,129.887383,548,1939,0.873030166591625
"3269",151324,"INDIANA STATE UNIVERSITY",1,0,1995,1980,1032,948,350,132,218,0.211,0.177,0.139,2928,140.131652,549,1661,0.838888888888889
"3270",151324,"INDIANA STATE UNIVERSITY",1,0,1996,1911,1026,885,355,111,244,0.238,0.186,0.125,3072,145.706848,535,1606,0.840397697540555
"3271",151324,"INDIANA STATE UNIVERSITY",1,0,1997,1878,998,880,356,127,229,0.23,0.19,0.144,3196,155.01539,538,1573,0.837593184238552
"3272",151324,"INDIANA STATE UNIVERSITY",1,0,1998,1994,1062,932,368,123,245,0.231,0.185,0.132,3324,157.352986,532,1653,0.828986960882648
"3273",151324,"INDIANA STATE UNIVERSITY",1,0,1999,2014,998,1016,352,132,220,0.22,0.175,0.13,3426,166.904571,524,1665,0.826713008937438
"3274",151324,"INDIANA STATE UNIVERSITY",1,0,2000,2124,1122,1002,404,126,278,0.248,0.19,0.126,3564,177.206829,547.5,1766,0.831450094161959
"3275",151324,"INDIANA STATE UNIVERSITY",1,0,2001,2156,1166,990,413,148,265,0.227,0.192,0.149,3672,182.148236,571,1746,0.809833024118738
"3276",151324,"INDIANA STATE UNIVERSITY",1,0,2002,2083,1065,1018,393,143,250,0.235,0.189,0.14,4116,173.382503,539,1719,0.825252040326452
"3277",151324,"INDIANA STATE UNIVERSITY",1,0,2003,1974,974,1000,351,128,223,0.229,0.178,0.128,5322,176.292516,557,1603,0.812056737588652
"3278",151324,"INDIANA STATE UNIVERSITY",1,0,2004,1813,901,912,341,128,213,0.236,0.188,0.14,5536,181.297245,544,1445,0.797021511307226
"3279",151324,"Indiana State University",1,0,2005,1622,810,812,311,122,189,0.233,0.192,0.15,5756,179.643447,509,1287,0.793464858199753
"3280",151324,"Indiana State University",1,0,2006,1657,827,830,335,125,210,0.254,0.202,0.151,6102,174.675847,467,1250,0.754375377187689
"3281",151324,"Indiana State University",1,0,2007,1820,924,896,375,138,237,0.256,0.206,0.154,6462,176.842916,461,1365,0.75
"3282",151324,"Indiana State University",1,0,2008,1907,954,953,357,151,206,0.216,0.187,0.158,6792,186.221037,454,1405,0.736759307813319
"3283",151324,"Indiana State University",1,0,2009,1969,954,1015,393,183,210,0.22,0.2,0.18,7226,195.691573,447,1412,0.717115286947689
"3284",151324,"Indiana State University",1,0,2010,2687,1352,1335,497,199,298,0.22,0.185,0.149,7514,198.716342,436,1816,0.675846669147748
"3285",151333,"INDIANA UNIVERSITY AT KOKOMO",1,0,1991,315,199,116,8,1,7,0.035,0.025,0.009,1938,13.722927,73,300,0.952380952380952
"3286",151333,"INDIANA UNIVERSITY KOKOMO",1,0,1992,304,200,104,15,4,11,0.055,0.049,0.038,2099,15.570615,77,286,0.940789473684211
"3287",151333,"INDIANA UNIVERSITY-KOKOMO",1,0,1993,330,208,122,14,7,7,0.034,0.042,0.057,2244,17.585069,81,319,0.966666666666667
"3288",151333,"INDIANA UNIVERSITY-KOKOMO",1,0,1995,294,184,110,27,7,20,0.109,0.092,0.064,2599,19.012097,78,276,0.938775510204082
"3289",151333,"INDIANA UNIVERSITY-KOKOMO",1,0,1996,339,227,112,20,6,14,0.062,0.059,0.054,2757,19.886124,69,319,0.941002949852507
"3290",151333,"INDIANA UNIVERSITY-KOKOMO",1,0,1997,306,204,102,17,5,12,0.059,0.056,0.049,2890,19.510016,72,291,0.950980392156863
"3291",151333,"INDIANA UNIVERSITY-KOKOMO",1,0,1998,333,230,103,25,2,23,0.1,0.075,0.019,3004,20.186382,69,319,0.957957957957958
"3292",151333,"INDIANA UNIVERSITY-KOKOMO",1,0,1999,295,213,82,27,7,20,0.094,0.092,0.085,2922,21.155963,67,283,0.959322033898305
"3293",151333,"INDIANA UNIVERSITY-KOKOMO",1,0,2000,347,223,124,28,9,19,0.085,0.081,0.073,3024,22.121605,67.5,334,0.962536023054755
"3294",151333,"INDIANA UNIVERSITY-KOKOMO",1,0,2001,343,233,110,36,8,28,0.12,0.105,0.073,3221,22.383371,68,314,0.915451895043732
"3295",151333,"INDIANA UNIVERSITY-KOKOMO",1,0,2002,339,226,113,28,5,23,0.102,0.083,0.044,3478,22.460632,74,311,0.91740412979351
"3296",151333,"INDIANA UNIVERSITY-KOKOMO",1,0,2003,382,264,118,27,5,22,0.083,0.071,0.042,4117,24.269121,77,358,0.93717277486911
"3297",151333,"INDIANA UNIVERSITY-KOKOMO",1,0,2004,356,237,119,18,5,13,0.055,0.051,0.042,4283,22.271818,83,328,0.921348314606742
"3298",151333,"Indiana University-Kokomo",1,0,2005,382,251,131,31,6,25,0.1,0.081,0.046,4475,25.552061,85,360,0.942408376963351
"3299",151333,"Indiana University-Kokomo",1,0,2006,329,210,119,26,6,20,0.095,0.079,0.05,4694,26.829425,86,297,0.90273556231003
"3300",151333,"Indiana University-Kokomo",1,0,2007,381,234,147,27,6,21,0.09,0.071,0.041,4928,26.242333,84,343,0.900262467191601
"3301",151333,"Indiana University-Kokomo",1,0,2008,341,212,129,31,6,25,0.118,0.091,0.047,5174,26.157809,80,306,0.897360703812317
"3302",151333,"Indiana University-Kokomo",1,0,2009,406,232,174,51,14,37,0.16,0.126,0.08,5408,26.022586,72,350,0.862068965517241
"3303",151333,"Indiana University-Kokomo",1,0,2010,345,217,128,59,23,36,0.166,0.171,0.18,5663,26.479622,76,314,0.910144927536232
"3304",151342,"INDIANA UNIVERSITY AT SOUTH BEND",1,0,1991,554,352,202,40,15,25,0.071,0.072,0.074,1952,29.527246,171,481,0.868231046931408
"3305",151342,"INDIANA UNIVERSITY SOUTH BEND",1,0,1992,564,337,227,34,11,23,0.068,0.06,0.048,2105,34.159762,171,499,0.884751773049645
"3306",151342,"INDIANA UNIVERSITY-SOUTH BEND",1,0,1993,554,360,194,32,16,16,0.044,0.058,0.082,2290,37.417751,175,485,0.875451263537906
"3307",151342,"INDIANA UNIVERSITY-SOUTH BEND",1,0,1995,626,374,252,51,19,32,0.086,0.081,0.075,2742,40.151776,182,532,0.849840255591054
"3308",151342,"INDIANA UNIVERSITY-SOUTH BEND",1,0,1996,593,360,233,41,9,32,0.089,0.069,0.039,2856,40.71264,180,490,0.826306913996627
"3309",151342,"INDIANA UNIVERSITY-SOUTH BEND",1,0,1997,629,384,245,47,20,27,0.07,0.075,0.082,2985,41.515615,183,529,0.841017488076312
"3310",151342,"INDIANA UNIVERSITY-SOUTH BEND",1,0,1998,732,427,305,31,14,17,0.04,0.042,0.046,3096,47.034512,200,624,0.852459016393443
"3311",151342,"INDIANA UNIVERSITY-SOUTH BEND",1,0,1999,637,382,255,37,10,27,0.071,0.058,0.039,2974,49.333491,202,562,0.882260596546311
"3312",151342,"INDIANA UNIVERSITY-SOUTH BEND",1,0,2000,637,349,288,22,6,16,0.046,0.035,0.021,3078,51.212432,207,562,0.882260596546311
"3313",151342,"INDIANA UNIVERSITY-SOUTH BEND",1,0,2001,750,449,301,40,15,25,0.056,0.053,0.05,3278,54.942947,212,639,0.852
"3314",151342,"INDIANA UNIVERSITY-SOUTH BEND",1,0,2002,660,390,270,36,9,27,0.069,0.055,0.033,3543,68.336622,219,563,0.853030303030303
"3315",151342,"INDIANA UNIVERSITY-SOUTH BEND",1,0,2003,707,417,290,42,18,24,0.058,0.059,0.062,4180,57.339463,220,619,0.875530410183876
"3316",151342,"INDIANA UNIVERSITY-SOUTH BEND",1,0,2004,704,432,272,29,11,18,0.042,0.041,0.04,4349,54.087795,237,589,0.836647727272727
"3317",151342,"Indiana University-South Bend",1,0,2005,805,466,339,34,16,18,0.039,0.042,0.047,4583,65.270013,233,685,0.850931677018634
"3318",151342,"Indiana University-South Bend",1,0,2006,772,427,345,31,16,15,0.035,0.04,0.046,4826,67.093256,234,629,0.814766839378238
"3319",151342,"Indiana University-South Bend",1,0,2007,876,524,352,44,26,18,0.034,0.05,0.074,5069,64.803014,237,729,0.832191780821918
"3320",151342,"Indiana University-South Bend",1,0,2008,943,590,353,54,23,31,0.052,0.057,0.065,5324,75.157659,235,729,0.773064687168611
"3321",151342,"Indiana University-South Bend",1,0,2009,1045,611,434,60,21,39,0.064,0.057,0.048,5573,67.932297,251,827,0.791387559808612
"3322",151342,"Indiana University-South Bend",1,0,2010,895,503,392,61,25,36,0.072,0.068,0.064,5843,68.596388,248,684,0.764245810055866
"3323",151351,"INDIANA UNIVERSITY BLOOMINGTON",1,0,1991,5208,3013,2195,2205,881,1324,0.439,0.423,0.401,2484,532.776559,1428,4596,0.882488479262673
"3324",151351,"INDIANA UNIVERSITY BLOOMINGTON",1,0,1992,5529,3233,2296,2231,840,1391,0.43,0.404,0.366,2794,588.767375,1374,4881,0.882799782962561
"3325",151351,"INDIANA UNIVERSITY-BLOOMINGTON",1,0,1993,5833,3340,2493,2427,906,1521,0.455,0.416,0.363,2988,580.064121,1361,5174,0.88702211554946
"3326",151351,"INDIANA UNIVERSITY-BLOOMINGTON",1,0,1995,5705,3293,2412,3057,1182,1875,0.569,0.536,0.49,3582,682.151631,1344,4952,0.868010517090272
"3327",151351,"INDIANA UNIVERSITY-BLOOMINGTON",1,0,1996,5766,3376,2390,2660,975,1685,0.499,0.461,0.408,3783,853.012883,1350,5043,0.874609781477627
"3328",151351,"INDIANA UNIVERSITY-BLOOMINGTON",1,0,1997,6036,3497,2539,2827,1045,1782,0.51,0.468,0.412,3929,789.880175,1404,5294,0.877070907886017
"3329",151351,"INDIANA UNIVERSITY-BLOOMINGTON",1,0,1998,6735,3810,2925,2747,1088,1659,0.435,0.408,0.372,4068,943.814362,1411,5937,0.881514476614699
"3330",151351,"INDIANA UNIVERSITY-BLOOMINGTON",1,0,1999,6503,3828,2675,3137,1138,1999,0.522,0.482,0.425,3752,944.402756,1396,5683,0.873904351837613
"3331",151351,"INDIANA UNIVERSITY-BLOOMINGTON",1,0,2000,6862,3839,3023,3421,1362,2059,0.536,0.499,0.451,3902,1028.212041,1384.5,5994,0.873506266394637
"3332",151351,"INDIANA UNIVERSITY-BLOOMINGTON",1,0,2001,6728,3716,3012,3353,1424,1929,0.519,0.498,0.473,4196,1079.887175,1373,5859,0.870838287752675
"3333",151351,"INDIANA UNIVERSITY-BLOOMINGTON",1,0,2002,6987,3895,3092,3546,1471,2075,0.533,0.508,0.476,4573,836.118811,1432,6102,0.873336195792185
"3334",151351,"INDIANA UNIVERSITY-BLOOMINGTON",1,0,2003,6739,3773,2966,3490,1419,2071,0.549,0.518,0.478,5756,851.698467,1486,5809,0.861997328980561
"3335",151351,"INDIANA UNIVERSITY-BLOOMINGTON",1,0,2004,6300,3407,2893,3110,1273,1837,0.539,0.494,0.44,5986,881.854869,1562,5340,0.847619047619048
"3336",151351,"Indiana University-Bloomington",1,0,2005,6903,3785,3118,3425,1383,2042,0.54,0.496,0.444,6291,941.797774,1589,5778,0.837027379400261
"3337",151351,"Indiana University-Bloomington",1,0,2006,7208,3875,3333,3949,1681,2268,0.585,0.548,0.504,6657,979.719849,1615,6087,0.844478357380688
"3338",151351,"Indiana University-Bloomington",1,0,2007,7167,3707,3460,4169,1874,2295,0.619,0.582,0.542,7000,1089.979017,1640,5975,0.833682154318404
"3339",151351,"Indiana University-Bloomington",1,0,2008,7550,3990,3560,4485,1959,2526,0.633,0.594,0.55,7368,1136.766197,1682,6307,0.835364238410596
"3340",151351,"Indiana University-Bloomington",1,0,2009,7301,3640,3661,4387,2001,2386,0.655,0.601,0.547,7722,1197.587704,1721,5833,0.798931653198192
"3341",151351,"Indiana University-Bloomington",1,0,2010,6977,3659,3318,4165,1805,2360,0.645,0.597,0.544,8124,1233.437046,1726,5174,0.741579475419235
"3342",151360,"INDIANA UNIVERSITY NORTHWEST",1,0,1991,614,396,218,35,14,21,0.053,0.057,0.064,1952,24.605821,134,447,0.728013029315961
"3343",151360,"INDIANA UNIVERSITY NORTHWEST",1,0,1992,597,386,211,26,9,17,0.044,0.044,0.043,2105,27.638941,151,405,0.678391959798995
"3344",151360,"INDIANA UNIVERSITY-NORTHWEST",1,0,1993,665,415,250,26,13,13,0.031,0.039,0.052,2250,30.423706,152,473,0.711278195488722
"3345",151360,"INDIANA UNIVERSITY-NORTHWEST",1,0,1995,599,383,216,42,13,29,0.076,0.07,0.06,2595,34.434764,150,376,0.62771285475793
"3346",151360,"INDIANA UNIVERSITY-NORTHWEST",1,0,1996,560,355,205,37,14,23,0.065,0.066,0.068,2768,34.488047,143,368,0.657142857142857
"3347",151360,"INDIANA UNIVERSITY-NORTHWEST",1,0,1997,508,340,168,21,7,14,0.041,0.041,0.042,2883,34.667229,147,315,0.62007874015748
"3348",151360,"INDIANA UNIVERSITY-NORTHWEST",1,0,1998,535,347,188,31,8,23,0.066,0.058,0.043,3021,36.124079,142,329,0.614953271028037
"3349",151360,"INDIANA UNIVERSITY-NORTHWEST",1,0,1999,540,345,195,45,16,29,0.084,0.083,0.082,2955,37.286237,138,352,0.651851851851852
"3350",151360,"INDIANA UNIVERSITY-NORTHWEST",1,0,2000,517,318,199,33,16,17,0.054,0.064,0.08,3024,41.573537,134,332,0.642166344294004
"3351",151360,"INDIANA UNIVERSITY-NORTHWEST",1,0,2001,511,340,171,43,12,31,0.091,0.084,0.07,3221,41.963741,130,330,0.645792563600783
"3352",151360,"INDIANA UNIVERSITY-NORTHWEST",1,0,2002,602,365,237,39,14,25,0.068,0.065,0.059,3478,32.91456,141,402,0.667774086378738
"3353",151360,"INDIANA UNIVERSITY-NORTHWEST",1,0,2003,660,417,243,49,14,35,0.084,0.074,0.058,4117,42.195003,165,433,0.656060606060606
"3354",151360,"INDIANA UNIVERSITY-NORTHWEST",1,0,2004,604,375,229,28,10,18,0.048,0.046,0.044,4283,38.787286,164,401,0.663907284768212
"3355",151360,"Indiana University-Northwest",1,0,2005,471,280,191,33,19,14,0.05,0.07,0.099,4475,46.889642,163,312,0.662420382165605
"3356",151360,"Indiana University-Northwest",1,0,2006,561,352,209,31,8,23,0.065,0.055,0.038,4710,50.820327,167,369,0.657754010695187
"3357",151360,"Indiana University-Northwest",1,0,2007,556,356,200,38,13,25,0.07,0.068,0.065,4962,49.90022,168,362,0.651079136690647
"3358",151360,"Indiana University-Northwest",1,0,2008,596,387,209,47,13,34,0.088,0.079,0.062,5228,46.973837,155,373,0.625838926174497
"3359",151360,"Indiana University-Northwest",1,0,2009,773,483,290,70,22,48,0.099,0.091,0.076,5478,50.135912,161,437,0.565329883570505
"3360",151360,"Indiana University-Northwest",1,0,2010,784,495,289,47,13,34,0.069,0.06,0.045,5752,50.313123,161,440,0.561224489795918
"3361",151379,"INDIANA UNIVERSITY SOUTHEAST",1,0,1991,589,343,246,23,6,17,0.05,0.039,0.024,1962,22.299714,114,572,0.971137521222411
"3362",151379,"INDIANA UNIVERSITY SOUTHEAST",1,0,1992,638,381,257,27,6,21,0.055,0.042,0.023,2115,25.539561,127,621,0.973354231974922
"3363",151379,"INDIANA UNIVERSITY-SOUTHEAST",1,0,1993,700,392,308,37,12,25,0.064,0.053,0.039,2260,27.643162,125,668,0.954285714285714
"3364",151379,"INDIANA UNIVERSITY-SOUTHEAST",1,0,1995,593,357,236,74,27,47,0.132,0.125,0.114,2572,28.272272,119,570,0.961214165261383
"3365",151379,"INDIANA UNIVERSITY-SOUTHEAST",1,0,1996,643,375,268,60,18,42,0.112,0.093,0.067,2718,30.448764,124,629,0.978227060653188
"3366",151379,"INDIANA UNIVERSITY-SOUTHEAST",1,0,1997,641,376,265,57,12,45,0.12,0.089,0.045,2847,31.527503,138,617,0.962558502340094
"3367",151379,"INDIANA UNIVERSITY-SOUTHEAST",1,0,1998,727,407,320,28,6,22,0.054,0.039,0.019,2986,34.27442,141,698,0.960110041265475
"3368",151379,"INDIANA UNIVERSITY-SOUTHEAST",1,0,1999,719,448,271,54,13,41,0.092,0.075,0.048,2922,36.157256,139,694,0.965229485396384
"3369",151379,"INDIANA UNIVERSITY-SOUTHEAST",1,0,2000,700,413,287,57,18,39,0.094,0.081,0.063,3024,39.825853,145,688,0.982857142857143
"3370",151379,"INDIANA UNIVERSITY-SOUTHEAST",1,0,2001,722,440,282,57,13,44,0.1,0.079,0.046,3221,42.924674,151,639,0.885041551246537
"3371",151379,"INDIANA UNIVERSITY-SOUTHEAST",1,0,2002,678,419,259,53,11,42,0.1,0.078,0.042,3479,48.535469,163,627,0.924778761061947
"3372",151379,"INDIANA UNIVERSITY-SOUTHEAST",1,0,2003,674,400,274,53,15,38,0.095,0.079,0.055,4117,46.533877,175,622,0.922848664688427
"3373",151379,"INDIANA UNIVERSITY-SOUTHEAST",1,0,2004,714,420,294,63,12,51,0.121,0.088,0.041,4283,42.785566,181,663,0.928571428571429
"3374",151379,"Indiana University-Southeast",1,0,2005,664,409,255,53,12,41,0.1,0.08,0.047,4475,52.648555,172,594,0.894578313253012
"3375",151379,"Indiana University-Southeast",1,0,2006,727,430,297,63,24,39,0.091,0.087,0.081,4698,52.422402,175,663,0.911966987620358
"3376",151379,"Indiana University-Southeast",1,0,2007,783,449,334,69,21,48,0.107,0.088,0.063,4934,52.637463,178,714,0.911877394636015
"3377",151379,"Indiana University-Southeast",1,0,2008,970,590,380,81,26,55,0.093,0.084,0.068,5184,67.487704,180,841,0.867010309278351
"3378",151379,"Indiana University-Southeast",1,0,2009,995,612,383,80,27,53,0.087,0.08,0.07,5417,59.483851,179,866,0.87035175879397
"3379",151379,"Indiana University-Southeast",1,0,2010,945,581,364,111,29,82,0.141,0.117,0.08,5672,58.651237,182,821,0.868783068783069
"3380",151388,"INDIANA UNIVERSITY EAST",1,0,1991,222,146,76,2,0,2,0.014,0.009,0,1952,10.185616,54,207,0.932432432432432
"3381",151388,"INDIANA UNIVERSITY EAST",1,0,1992,263,197,66,8,2,6,0.03,0.03,0.03,2105,12.27004,54,254,0.965779467680608
"3382",151388,"INDIANA UNIVERSITY-EAST",1,0,1993,264,168,96,8,2,6,0.036,0.03,0.021,2250,14.051225,59,247,0.935606060606061
"3383",151388,"INDIANA UNIVERSITY-EAST",1,0,1995,242,144,98,12,5,7,0.049,0.05,0.051,2615,15.501244,62,220,0.909090909090909
"3384",151388,"INDIANA UNIVERSITY-EAST",1,0,1996,233,148,85,9,3,6,0.04,0.039,0.035,2728,16.930493,62,220,0.944206008583691
"3385",151388,"INDIANA UNIVERSITY-EAST",1,0,1997,278,193,85,14,7,7,0.036,0.05,0.082,2849,17.490572,59,259,0.931654676258993
"3386",151388,"INDIANA UNIVERSITY-EAST",1,0,1998,230,146,84,7,2,5,0.034,0.03,0.024,2987,18.494499,59,210,0.91304347826087
"3387",151388,"INDIANA UNIVERSITY-EAST",1,0,1999,255,161,94,10,1,9,0.056,0.039,0.011,2922,19.460209,61,226,0.886274509803922
"3388",151388,"INDIANA UNIVERSITY-EAST",1,0,2000,249,161,88,10,1,9,0.056,0.04,0.011,3024,21.749083,60,230,0.923694779116466
"3389",151388,"INDIANA UNIVERSITY-EAST",1,0,2001,264,172,92,18,5,13,0.076,0.068,0.054,3221,23.061795,59,236,0.893939393939394
"3390",151388,"INDIANA UNIVERSITY-EAST",1,0,2002,303,200,103,19,4,15,0.075,0.063,0.039,3478,18.453161,69,281,0.927392739273927
"3391",151388,"INDIANA UNIVERSITY-EAST",1,0,2003,318,203,115,20,7,13,0.064,0.063,0.061,4117,26.163374,74,283,0.889937106918239
"3392",151388,"INDIANA UNIVERSITY-EAST",1,0,2004,270,182,88,14,3,11,0.06,0.052,0.034,4283,23.382254,77,250,0.925925925925926
"3393",151388,"Indiana University-East",1,0,2005,284,179,105,13,2,11,0.062,0.046,0.019,4475,27.138549,83,256,0.901408450704225
"3394",151388,"Indiana University-East",1,0,2006,225,135,90,9,3,6,0.044,0.04,0.033,4697,26.851793,78,209,0.928888888888889
"3395",151388,"Indiana University-East",1,0,2007,264,157,107,22,4,18,0.115,0.083,0.037,4932,25.18713,76,243,0.920454545454545
"3396",151388,"Indiana University-East",1,0,2008,291,190,101,26,8,18,0.095,0.089,0.079,5178,24.390156,71,262,0.900343642611684
"3397",151388,"Indiana University-East",1,0,2009,358,217,141,51,11,40,0.184,0.142,0.078,5416,26.69313,75,323,0.902234636871508
"3398",151388,"Indiana University-East",1,0,2010,378,224,154,54,15,39,0.174,0.143,0.097,5676,28.192331,72,347,0.917989417989418
"3399",151777,"MANCHESTER COLLEGE",1,0,1991,277,146,131,121,48,73,0.5,0.437,0.366,8270,16.404485,71,253,0.913357400722022
"3400",151777,"MANCHESTER COLLEGE",1,0,1992,245,120,125,109,51,58,0.483,0.445,0.408,8960,17.975799,71,225,0.918367346938776
"3401",151777,"MANCHESTER COLLEGE",1,0,1993,238,118,120,94,43,51,0.432,0.395,0.358,9600,17.669506,74,217,0.911764705882353
"3402",151777,"MANCHESTER COLLEGE",1,0,1995,321,158,163,136,61,75,0.475,0.424,0.374,11470,19.001466,69,301,0.937694704049844
"3403",151777,"MANCHESTER COLLEGE",1,0,1996,305,151,154,113,46,67,0.444,0.37,0.299,12120,21.523812,70,278,0.911475409836066
"3404",151777,"MANCHESTER COLLEGE",1,0,1997,288,135,153,122,47,75,0.556,0.424,0.307,12660,16.832088,68,257,0.892361111111111
"3405",151777,"MANCHESTER COLLEGE",1,0,1998,309,173,136,139,47,92,0.532,0.45,0.346,13280,17.543834,65,287,0.928802588996764
"3406",151777,"MANCHESTER COLLEGE",1,0,1999,328,166,162,132,41,91,0.548,0.402,0.253,13930,18.443311,70,277,0.844512195121951
"3407",151777,"MANCHESTER COLLEGE",1,0,2000,333,178,155,142,46,96,0.539,0.426,0.297,14510,19.500731,70,292,0.876876876876877
"3408",151777,"MANCHESTER COLLEGE",1,0,2001,334,179,155,145,53,92,0.514,0.434,0.342,15230,19.407124,70,289,0.865269461077844
"3409",151777,"MANCHESTER COLLEGE",1,0,2002,309,178,131,137,54,83,0.466,0.443,0.412,15990,19.930215,67,269,0.870550161812298
"3410",151777,"MANCHESTER COLLEGE",1,0,2003,335,168,167,127,53,74,0.44,0.379,0.317,16940,20.032967,68,298,0.88955223880597
"3411",151777,"MANCHESTER COLLEGE",1,0,2004,278,154,124,113,34,79,0.513,0.406,0.274,17950,21.440607,67,243,0.87410071942446
"3412",151777,"Manchester College",1,0,2005,329,170,159,140,50,90,0.529,0.426,0.314,18860,21.990889,79,290,0.881458966565349
"3413",151777,"Manchester College",1,0,2006,311,137,174,136,62,74,0.54,0.437,0.356,19800,23.522302,73,270,0.868167202572347
"3414",151777,"Manchester College",1,0,2007,316,147,169,126,55,71,0.483,0.399,0.325,21000,23.838765,77,277,0.876582278481013
"3415",151777,"Manchester College",1,0,2008,396,202,194,190,77,113,0.559,0.48,0.397,22000,24.944312,69,346,0.873737373737374
"3416",151777,"Manchester College",1,0,2009,426,210,216,198,88,110,0.524,0.465,0.407,23000,25.398496,72,383,0.89906103286385
"3417",151777,"Manchester College",1,0,2010,405,217,188,200,81,119,0.548,0.494,0.431,24100,25.782638,74,349,0.861728395061728
"3418",151786,"MARIAN COLLEGE",1,0,1991,217,154,63,53,13,40,0.26,0.244,0.206,7584,9.602937,51,195,0.898617511520737
"3419",151786,"MARIAN COLLEGE",1,0,1992,244,149,95,75,32,43,0.289,0.307,0.337,8594,13.2279,76,113,0.463114754098361
"3420",151786,"MARIAN COLLEGE",1,0,1993,239,150,89,74,23,51,0.34,0.31,0.258,9360,14.803031,78,198,0.828451882845188
"3421",151786,"MARIAN COLLEGE",1,0,1995,255,168,87,90,28,62,0.369,0.353,0.322,10824,16.847845,74,190,0.745098039215686
"3422",151786,"MARIAN COLLEGE",1,0,1996,221,151,70,67,16,51,0.338,0.303,0.229,11440,19.213695,72,137,0.619909502262443
"3423",151786,"MARIAN COLLEGE",1,0,1997,255,156,99,73,21,52,0.333,0.286,0.212,12458,14.793344,72,196,0.768627450980392
"3424",151786,"MARIAN COLLEGE",1,0,1998,205,158,47,70,14,56,0.354,0.341,0.298,13406,15.534987,56,162,0.790243902439024
"3425",151786,"MARIAN COLLEGE",1,0,1999,251,181,70,88,19,69,0.381,0.351,0.271,14012,16.422101,71,210,0.836653386454183
"3426",151786,"MARIAN COLLEGE",1,0,2000,208,126,82,58,12,46,0.365,0.279,0.146,14432,16.791003,67,185,0.889423076923077
"3427",151786,"MARIAN COLLEGE",1,0,2001,183,113,70,66,21,45,0.398,0.361,0.3,15226,17.399095,63,148,0.808743169398907
"3428",151786,"MARIAN COLLEGE",1,0,2002,230,153,77,73,16,57,0.372,0.317,0.208,16000,17.106878,62,186,0.808695652173913
"3429",151786,"MARIAN COLLEGE",1,0,2003,239,162,77,71,27,44,0.272,0.297,0.351,16800,19.322929,66,201,0.841004184100418
"3430",151786,"MARIAN COLLEGE",1,0,2004,245,166,79,84,26,58,0.349,0.343,0.329,17600,20.900373,70,210,0.857142857142857
"3431",151786,"Marian College",1,0,2005,189,127,62,64,17,47,0.37,0.339,0.274,18400,23.201429,72,154,0.814814814814815
"3432",151786,"Marian College",1,0,2006,277,148,129,108,32,76,0.514,0.39,0.248,19900,24.249214,71,240,0.866425992779783
"3433",151786,"Marian College",1,0,2007,271,142,129,76,23,53,0.373,0.28,0.178,20800,26.74664,67,224,0.826568265682657
"3434",151786,"Marian College",1,0,2008,326,158,168,111,50,61,0.386,0.34,0.298,22400,29.906742,81,262,0.803680981595092
"3435",151786,"Marian University",1,0,2009,312,166,146,103,39,64,0.385,0.33,0.267,24000,32.514208,86,250,0.801282051282051
"3436",151786,"Marian University",1,0,2010,317,166,151,124,49,75,0.452,0.391,0.325,24960,34.584234,91,266,0.839116719242902
"3437",152080,"UNIVERSITY OF NOTRE DAME",1,0,1991,1880,717,1163,1635,988,647,0.902,0.87,0.85,6752,278.179137,625,1567,0.833510638297872
"3438",152080,"UNIVERSITY OF NOTRE DAME",1,0,1992,1879,822,1057,1631,900,731,0.889,0.868,0.851,14650,305.508566,640,1580,0.840872804683342
"3439",152080,"UNIVERSITY OF NOTRE DAME",1,0,1993,1901,851,1050,1685,910,775,0.911,0.886,0.867,15810,319.124394,644,1602,0.842714360862704
"3440",152080,"UNIVERSITY OF NOTRE DAME",1,0,1995,1902,870,1032,1667,887,780,0.897,0.876,0.859,17830,376.652101,670,1586,0.833859095688749
"3441",152080,"UNIVERSITY OF NOTRE DAME",1,0,1996,1920,862,1058,1698,915,783,0.908,0.884,0.865,18810,393.52435,687,1589,0.827604166666667
"3442",152080,"UNIVERSITY OF NOTRE DAME",1,0,1997,1904,875,1029,1675,879,796,0.91,0.88,0.854,19800,395.609,698,1620,0.850840336134454
"3443",152080,"UNIVERSITY OF NOTRE DAME",1,0,1998,1937,895,1042,1706,891,815,0.911,0.881,0.855,20900,372.813,704,1633,0.843056272586474
"3444",152080,"UNIVERSITY OF NOTRE DAME",1,0,1999,1967,932,1035,1739,880,859,0.922,0.884,0.85,22030,395.408,726,1627,0.827147941026945
"3445",152080,"UNIVERSITY OF NOTRE DAME",1,0,2000,1955,919,1036,1757,921,836,0.91,0.899,0.889,23180,444.145,744.5,1580,0.808184143222506
"3446",152080,"UNIVERSITY OF NOTRE DAME",1,0,2001,2036,958,1078,1825,956,869,0.907,0.896,0.887,24320,486.281,763,1636,0.803536345776031
"3447",152080,"UNIVERSITY OF NOTRE DAME",1,0,2002,1945,935,1010,1765,909,856,0.915,0.907,0.9,25510,535.951,760,1561,0.802570694087404
"3448",152080,"UNIVERSITY OF NOTRE DAME",1,0,2003,1995,928,1067,1797,955,842,0.907,0.901,0.895,27170,552.463,783,1511,0.757393483709273
"3449",152080,"UNIVERSITY OF NOTRE DAME",1,0,2004,1987,947,1040,1789,914,875,0.924,0.9,0.879,29070,584.763,780,1513,0.761449421238047
"3450",152080,"University of Notre Dame",1,0,2005,1990,935,1055,1800,942,858,0.918,0.905,0.893,31100,615.838,877,1493,0.750251256281407
"3451",152080,"University of Notre Dame",1,0,2006,2029,928,1101,1800,962,838,0.903,0.887,0.874,32900,643.885,853,1445,0.712173484475111
"3452",152080,"University of Notre Dame",1,0,2007,1984,948,1036,1782,913,869,0.917,0.898,0.881,34680,680.04,890,1471,0.741431451612903
"3453",152080,"University of Notre Dame",1,0,2008,1991,951,1040,1806,932,874,0.919,0.907,0.896,36340,730.195,907,1515,0.760924158714214
"3454",152080,"University of Notre Dame",1,0,2009,2055,930,1125,1867,1009,858,0.923,0.909,0.897,37970,773.206,947,1500,0.72992700729927
"3455",152080,"University of Notre Dame",1,0,2010,2056,966,1090,1846,966,880,0.911,0.898,0.886,39412,829.224,982,1477,0.718385214007782
"3456",152248,"PURDUE UNIVERSITY CALUMET CAMPUS",1,0,1991,921,466,455,17,6,11,0.024,0.018,0.013,1985,36.895257,235,704,0.764386536373507
"3457",152248,"PURDUE UNIVERSITY CALUMET CAMPUS",1,0,1992,985,535,450,22,8,14,0.026,0.022,0.018,2145,39.975692,241,741,0.752284263959391
"3458",152248,"PURDUE UNIVERSITY-CALUMET CAMPUS",1,0,1993,847,475,372,64,32,32,0.067,0.076,0.086,2290,43.050978,247,607,0.716646989374262
"3459",152248,"PURDUE UNIVERSITY-CALUMET CAMPUS",1,0,1995,906,487,419,71,21,50,0.103,0.078,0.05,2658,45.781898,251,642,0.708609271523179
"3460",152248,"PURDUE UNIVERSITY-CALUMET CAMPUS",1,0,1996,1026,558,468,92,42,50,0.09,0.09,0.09,2775,48.809,247,741,0.722222222222222
"3461",152248,"PURDUE UNIVERSITY-CALUMET CAMPUS",1,0,1997,1071,556,515,101,49,52,0.094,0.094,0.095,2970,49.475694,257,771,0.719887955182073
"3462",152248,"PURDUE UNIVERSITY-CALUMET CAMPUS",1,0,1998,1062,560,502,38,17,21,0.038,0.036,0.034,3093,54.124336,262,745,0.7015065913371
"3463",152248,"PURDUE UNIVERSITY-CALUMET CAMPUS",1,0,1999,1112,593,519,42,13,29,0.049,0.038,0.025,2926,55.908451,260,800,0.719424460431655
"3464",152248,"PURDUE UNIVERSITY-CALUMET CAMPUS",1,0,2000,1043,577,466,37,14,23,0.04,0.035,0.03,3043,58.716759,269,773,0.741131351869607
"3465",152248,"PURDUE UNIVERSITY-CALUMET CAMPUS",1,0,2001,958,507,451,37,12,25,0.049,0.039,0.027,3272,65.742912,278,713,0.744258872651357
"3466",152248,"PURDUE UNIVERSITY-CALUMET CAMPUS",1,0,2002,927,474,453,36,16,20,0.042,0.039,0.035,3125,63.798875,272,669,0.72168284789644
"3467",152248,"PURDUE UNIVERSITY-CALUMET CAMPUS",1,0,2003,997,527,470,56,21,35,0.066,0.056,0.045,3708,65.267035,273,741,0.743229689067202
"3468",152248,"PURDUE UNIVERSITY-CALUMET CAMPUS",1,0,2004,954,492,462,55,24,31,0.063,0.058,0.052,3974,68.229127,263,630,0.660377358490566
"3469",152248,"Purdue University-Calumet Campus",1,0,2005,1093,599,494,57,23,34,0.057,0.052,0.047,4212,72.700845,256,689,0.630375114364135
"3470",152248,"Purdue University-Calumet Campus",1,0,2006,1036,546,490,52,19,33,0.06,0.05,0.039,4464,85.461037,262,641,0.618725868725869
"3471",152248,"Purdue University-Calumet Campus",1,0,2007,1220,630,590,104,40,64,0.102,0.085,0.068,4666,84.97178,279,728,0.59672131147541
"3472",152248,"Purdue University-Calumet Campus",1,0,2008,1213,624,589,108,50,58,0.093,0.089,0.085,4875,95.03784,287,672,0.553998351195383
"3473",152248,"Purdue University-Calumet Campus",1,0,2009,1060,499,561,92,37,55,0.11,0.087,0.066,5119,102.112965,293,624,0.588679245283019
"3474",152248,"Purdue University-Calumet Campus",1,0,2010,965,484,481,101,48,53,0.11,0.105,0.1,5374,107.072459,297,555,0.575129533678757
"3475",152363,"SAINT JOSEPH'S COLLEGE",1,0,1991,252,94,158,95,51,44,0.468,0.377,0.323,9410,16.047306,48,227,0.900793650793651
"3476",152363,"SAINT JOSEPH'S COLLEGE",1,0,1992,258,129,129,94,40,54,0.419,0.364,0.31,10030,15.607327,48,233,0.903100775193798
"3477",152363,"SAINT JOSEPHS COLLEGE",1,0,1993,292,140,152,110,59,51,0.364,0.377,0.388,10830,15.197381,45,262,0.897260273972603
"3478",152363,"SAINT JOSEPHS COLLEGE",1,0,1995,237,106,131,99,52,47,0.443,0.418,0.397,11900,19.415597,42,200,0.843881856540084
"3479",152363,"SAINT JOSEPHS COLLEGE",1,0,1996,212,107,105,93,40,53,0.495,0.439,0.381,12260,19.80641,49,190,0.89622641509434
"3480",152363,"SAINT JOSEPHS COLLEGE",1,0,1997,267,138,129,112,46,66,0.478,0.419,0.357,12620,14.471046,47,239,0.895131086142322
"3481",152363,"SAINT JOSEPHS COLLEGE",1,0,1998,254,136,118,113,46,67,0.493,0.445,0.39,13590,14.428337,50,227,0.893700787401575
"3482",152363,"SAINT JOSEPHS COLLEGE",1,0,1999,290,122,168,114,56,58,0.475,0.393,0.333,14070,15.232628,54,246,0.848275862068966
"3483",152363,"SAINT JOSEPHS COLLEGE",1,0,2000,246,132,114,109,50,59,0.447,0.443,0.439,14920,16.481558,53.5,222,0.902439024390244
"3484",152363,"SAINT JOSEPHS COLLEGE",1,0,2001,232,121,111,105,43,62,0.512,0.453,0.387,15880,17.573026,53,205,0.883620689655172
"3485",152363,"SAINT JOSEPHS COLLEGE",1,0,2002,276,155,121,108,34,74,0.477,0.391,0.281,16900,17.57729,56,242,0.876811594202899
"3486",152363,"SAINT JOSEPHS COLLEGE",1,0,2003,306,159,147,134,66,68,0.428,0.438,0.449,17900,19.74416,56,255,0.833333333333333
"3487",152363,"SAINT JOSEPHS COLLEGE",1,0,2004,246,145,101,128,37,91,0.628,0.52,0.366,19000,20.794184,52,210,0.853658536585366
"3488",152363,"Saint Josephs College",1,0,2005,266,145,121,128,41,87,0.6,0.481,0.339,19960,21.068604,56,229,0.860902255639098
"3489",152363,"Saint Josephs College",1,0,2006,251,111,140,100,49,51,0.46,0.398,0.35,20800,21.019034,53,198,0.788844621513944
"3490",152363,"Saint Josephs College",1,0,2007,300,138,162,107,50,57,0.413,0.357,0.309,21710,20.64284,53,226,0.753333333333333
"3491",152363,"Saint Josephs College",1,0,2008,296,144,152,118,51,67,0.465,0.399,0.336,23000,22.440637,54,234,0.790540540540541
"3492",152363,"Saint Josephs College",1,0,2009,240,108,132,102,41,61,0.565,0.425,0.311,24350,22.845505,51,187,0.779166666666667
"3493",152363,"Saint Josephs College",1,0,2010,257,120,137,111,43,68,0.567,0.432,0.314,25080,21.728209,56,191,0.743190661478599
"3494",152530,"TAYLOR UNIVERSITY",1,0,1991,466,248,218,247,94,153,0.617,0.53,0.431,9353,25.873547,86,439,0.94206008583691
"3495",152530,"TAYLOR UNIVERSITY-UPLAND",1,0,1992,491,256,235,324,153,171,0.668,0.66,0.651,10000,27.908182,89,466,0.94908350305499
"3496",152530,"TAYLOR UNIVERSITY-UPLAND",1,0,1993,435,233,202,270,107,163,0.7,0.621,0.53,10650,29.348557,94,399,0.917241379310345
"3497",152530,"TAYLOR UNIVERSITY-UPLAND",1,0,1995,419,224,195,270,112,158,0.705,0.644,0.574,11914,32.960732,103,389,0.928400954653938
"3498",152530,"TAYLOR UNIVERSITY-UPLAND",1,0,1996,485,270,215,348,147,201,0.744,0.718,0.684,12774,35.274947,102,452,0.931958762886598
"3499",152530,"TAYLOR UNIVERSITY-UPLAND",1,0,1997,486,262,224,321,143,178,0.679,0.66,0.638,13484,30.660457,106,457,0.940329218106996
"3500",152530,"TAYLOR UNIVERSITY-UPLAND",1,0,1998,460,243,217,293,128,165,0.679,0.637,0.59,14456,33.603163,109,426,0.926086956521739
"3501",152530,"TAYLOR UNIVERSITY-UPLAND",1,0,1999,473,256,217,341,142,199,0.777,0.721,0.654,14900,34.275345,113,438,0.92600422832981
"3502",152530,"TAYLOR UNIVERSITY-UPLAND",1,0,2000,482,242,240,332,149,183,0.756,0.689,0.621,15600,37.56,115.5,443,0.919087136929461
"3503",152530,"TAYLOR UNIVERSITY-UPLAND",1,0,2001,491,251,240,341,160,181,0.721,0.695,0.667,16350,36.507,118,464,0.945010183299389
"3504",152530,"TAYLOR UNIVERSITY-UPLAND",1,0,2002,452,244,208,322,142,180,0.738,0.712,0.683,17270,37.296,118,414,0.915929203539823
"3505",152530,"TAYLOR UNIVERSITY-UPLAND",1,0,2003,468,270,198,331,137,194,0.718,0.707,0.692,18306,40.1742,119,438,0.935897435897436
"3506",152530,"TAYLOR UNIVERSITY-UPLAND",1,0,2004,476,265,211,334,134,200,0.755,0.702,0.635,19450,41.4588,119,446,0.936974789915966
"3507",152530,"Taylor University-Upland",1,0,2005,459,271,188,342,142,200,0.738,0.745,0.755,20520,44.006,126,427,0.930283224400871
"3508",152530,"Taylor University",1,0,2006,492,266,226,341,146,195,0.733,0.693,0.646,21800,46.072729,132,450,0.914634146341463
"3509",152530,"Taylor University",1,0,2007,472,272,200,306,129,177,0.651,0.648,0.645,23030,53.708481,122,422,0.894067796610169
"3510",152530,"Taylor University",1,0,2008,465,266,199,312,115,197,0.741,0.671,0.578,24314,57.758063,126,410,0.881720430107527
"3511",152530,"Taylor University",1,0,2009,482,263,219,342,141,201,0.764,0.71,0.644,25164,54.356078,129,426,0.883817427385892
"3512",152530,"Taylor University",1,0,2010,467,270,197,308,112,196,0.726,0.66,0.569,26150,58.648554,140,417,0.892933618843683
"3513",152600,"VALPARAISO UNIVERSITY",1,0,1991,615,340,275,327,114,213,0.626,0.532,0.415,9900,49.728515,224,565,0.91869918699187
"3514",152600,"VALPARAISO UNIVERSITY",1,0,1992,601,334,267,305,117,188,0.563,0.507,0.438,10840,51.746895,225,563,0.936772046589018
"3515",152600,"VALPARAISO UNIVERSITY",1,0,1993,487,251,236,278,109,169,0.673,0.571,0.462,11720,56.183823,204,438,0.899383983572895
"3516",152600,"VALPARAISO UNIVERSITY",1,0,1995,673,370,303,405,141,264,0.713,0.602,0.465,12860,59.756209,172,574,0.852897473997028
"3517",152600,"VALPARAISO UNIVERSITY",1,0,1996,656,348,308,381,149,232,0.667,0.581,0.484,13980,60.764914,196,558,0.850609756097561
"3518",152600,"VALPARAISO UNIVERSITY",1,0,1997,702,382,320,416,163,253,0.662,0.593,0.509,14560,53.040139,201,601,0.856125356125356
"3519",152600,"VALPARAISO UNIVERSITY",1,0,1998,685,350,335,396,162,234,0.669,0.578,0.484,15400,56.544037,207,580,0.846715328467153
"3520",152600,"VALPARAISO UNIVERSITY",1,0,1999,730,376,354,429,192,237,0.63,0.588,0.542,16280,59.459637,224,660,0.904109589041096
"3521",152600,"VALPARAISO UNIVERSITY",1,0,2000,707,388,319,450,188,262,0.675,0.636,0.589,17100,63.348543,219,624,0.882602545968883
"3522",152600,"VALPARAISO UNIVERSITY",1,0,2001,660,339,321,442,187,255,0.752,0.67,0.583,18100,66.889363,214,598,0.906060606060606
"3523",152600,"VALPARAISO UNIVERSITY",1,0,2002,715,365,350,454,197,257,0.704,0.635,0.563,19000,69.078464,225,635,0.888111888111888
"3524",152600,"VALPARAISO UNIVERSITY",1,0,2003,791,400,391,501,229,272,0.68,0.633,0.586,20000,71.776715,232,700,0.884955752212389
"3525",152600,"VALPARAISO UNIVERSITY",1,0,2004,746,376,370,446,201,245,0.652,0.598,0.543,21000,74.996761,237,637,0.853887399463807
"3526",152600,"Valparaiso University",1,0,2005,672,332,340,421,183,238,0.717,0.626,0.538,22000,81.818971,243,586,0.87202380952381
"3527",152600,"Valparaiso University",1,0,2006,760,394,366,469,206,263,0.667,0.617,0.563,23200,87.499622,254,626,0.823684210526316
"3528",152600,"Valparaiso University",1,0,2007,713,370,343,413,193,220,0.595,0.579,0.563,24360,91.724226,265,580,0.813464235624123
"3529",152600,"Valparaiso University",1,0,2008,655,336,319,390,169,221,0.658,0.595,0.53,26070,98.056987,261,556,0.848854961832061
"3530",152600,"Valparaiso University",1,0,2009,671,330,341,371,157,214,0.648,0.553,0.46,27360,107.370978,242,539,0.80327868852459
"3531",152600,"Valparaiso University",1,0,2010,691,360,331,376,148,228,0.633,0.544,0.447,28590,105.576565,254,544,0.78726483357453
"3532",153001,"BUENA VISTA COLLEGE",1,0,1991,273,110,163,107,57,50,0.454,0.392,0.35,10900,20.940896,71,263,0.963369963369963
"3533",153001,"BUENA VISTA COLLEGE",1,0,1992,290,132,158,129,56,73,0.553,0.445,0.354,11663,26.044433,70,276,0.951724137931034
"3534",153001,"BUENA VISTA COLLEGE",1,0,1993,284,143,141,130,47,83,0.58,0.458,0.333,12565,28.332401,70,274,0.964788732394366
"3535",153001,"BUENA VISTA UNIVERSITY",1,0,1995,352,167,185,168,71,97,0.581,0.477,0.384,14078,32.865908,64,341,0.96875
"3536",153001,"BUENA VISTA UNIVERSITY",1,0,1996,311,161,150,124,52,72,0.447,0.399,0.347,14458,30.068143,72,304,0.977491961414791
"3537",153001,"BUENA VISTA UNIVERSITY",1,0,1997,385,185,200,169,70,99,0.535,0.439,0.35,14848,30.907815,73,374,0.971428571428571
"3538",153001,"BUENA VISTA UNIVERSITY",1,0,1998,323,165,158,165,68,97,0.588,0.511,0.43,15292,34.249903,79,309,0.956656346749226
"3539",153001,"BUENA VISTA UNIVERSITY",1,0,1999,322,144,178,146,69,77,0.535,0.453,0.388,15751,36.881059,84,313,0.972049689440994
"3540",153001,"BUENA VISTA UNIVERSITY",1,0,2000,326,182,144,153,62,91,0.5,0.469,0.431,17176,30.567321,83,309,0.947852760736196
"3541",153001,"BUENA VISTA UNIVERSITY",1,0,2001,379,189,190,166,69,97,0.513,0.438,0.363,17846,33.123131,82,353,0.931398416886544
"3542",153001,"BUENA VISTA UNIVERSITY",1,0,2002,356,192,164,184,79,105,0.547,0.517,0.482,18738,34.368571,81,317,0.890449438202247
"3543",153001,"BUENA VISTA UNIVERSITY",1,0,2003,377,193,184,172,74,98,0.508,0.456,0.402,19862,35.420833,88,331,0.877984084880637
"3544",153001,"BUENA VISTA UNIVERSITY",1,0,2004,331,173,158,150,63,87,0.503,0.453,0.399,20854,34.286799,81,280,0.845921450151057
"3545",153001,"Buena Vista University",1,0,2005,286,143,143,121,50,71,0.496,0.423,0.35,21688,37.497411,81,256,0.895104895104895
"3546",153001,"Buena Vista University",1,0,2006,265,133,132,111,51,60,0.451,0.419,0.386,22556,37.763696,82,241,0.909433962264151
"3547",153001,"Buena Vista University",1,0,2007,226,122,104,97,35,62,0.508,0.429,0.337,23842,40.326287,86,195,0.86283185840708
"3548",153001,"Buena Vista University",1,0,2008,273,117,156,96,46,50,0.427,0.352,0.295,24796,40.861744,84,213,0.78021978021978
"3549",153001,"Buena Vista University",1,0,2009,271,123,148,116,55,61,0.496,0.428,0.372,25540,41.466284,82,216,0.797047970479705
"3550",153001,"Buena Vista University",1,0,2010,265,139,126,117,43,74,0.532,0.442,0.341,26306,41.890055,83,200,0.754716981132076
"3551",153108,"CENTRAL UNIVERSITY OF IOWA",0,1,1991,414,239,175,224,95,129,0.54,0.541,0.543,9198,25.407073,88,384,0.927536231884058
"3552",153108,"CENTRAL UNIVERSITY OF IOWA",0,1,1992,428,235,193,242,98,144,0.613,0.565,0.508,9875,25.970467,88,394,0.920560747663551
"3553",153108,"CENTRAL UNIVERSITY OF IOWA",0,1,1993,397,210,187,211,87,124,0.591,0.531,0.465,10239,26.709374,89,369,0.929471032745592
"3554",153108,"CENTRAL COLLEGE",0,1,1995,410,249,161,247,92,155,0.623,0.602,0.571,11836,26.516018,83,378,0.921951219512195
"3555",153108,"CENTRAL COLLEGE",1,0,1996,303,178,125,160,58,102,0.573,0.528,0.464,12304,27.234911,82,286,0.943894389438944
"3556",153108,"CENTRAL COLLEGE",1,0,1997,306,178,128,183,67,116,0.652,0.598,0.523,12802,27.841849,82,298,0.973856209150327
"3557",153108,"CENTRAL COLLEGE",1,0,1998,411,222,189,249,101,148,0.667,0.606,0.534,13388,21.90997,81,403,0.980535279805353
"3558",153108,"CENTRAL COLLEGE",1,0,1999,403,219,184,7,0,7,0.032,0.017,0,14070,23.696267,83,386,0.957816377171216
"3559",153108,"CENTRAL COLLEGE",1,0,2000,369,214,155,226,84,142,0.664,0.612,0.542,14638,27.11778,82.5,353,0.956639566395664
"3560",153108,"CENTRAL COLLEGE",1,0,2001,412,237,175,274,108,166,0.7,0.665,0.617,15598,28.968152,82,393,0.953883495145631
"3561",153108,"CENTRAL COLLEGE",1,0,2002,425,234,191,263,103,160,0.684,0.619,0.539,16612,32.148351,86,402,0.945882352941177
"3562",153108,"CENTRAL COLLEGE",1,0,2003,416,227,189,231,87,144,0.634,0.555,0.46,17609,33.324142,89,397,0.954326923076923
"3563",153108,"CENTRAL COLLEGE",1,0,2004,441,223,218,260,118,142,0.637,0.59,0.541,18648,37.195377,90,420,0.952380952380952
"3564",153108,"Central College",1,0,2005,366,203,163,213,93,120,0.591,0.582,0.571,19684,38.510734,87,339,0.926229508196721
"3565",153108,"Central College",1,0,2006,413,218,195,256,103,153,0.702,0.62,0.528,20972,38.179426,87,383,0.927360774818402
"3566",153108,"Central College",1,0,2007,422,219,203,260,111,149,0.68,0.616,0.547,22230,40.474658,83,389,0.921800947867299
"3567",153108,"Central College",1,0,2008,404,204,200,255,101,154,0.755,0.631,0.505,23564,42.565655,88,377,0.933168316831683
"3568",153108,"Central College",1,0,2009,442,213,229,264,117,147,0.69,0.597,0.511,24630,43.191829,88,401,0.907239819004525
"3569",153108,"Central College",1,0,2010,402,212,190,235,99,136,0.642,0.585,0.521,25862,43.599797,88,355,0.883084577114428
"3570",153269,"DRAKE UNIVERSITY",1,0,1991,744,424,320,398,154,244,0.576,0.535,0.481,11040,78.115175,271,651,0.875
"3571",153269,"DRAKE UNIVERSITY",1,0,1992,838,476,362,407,150,257,0.54,0.486,0.414,11780,84.949598,278,731,0.872315035799523
"3572",153269,"DRAKE UNIVERSITY",1,0,1993,832,492,340,422,158,264,0.537,0.507,0.465,12780,90.802325,285,742,0.891826923076923
"3573",153269,"DRAKE UNIVERSITY",1,0,1995,734,435,299,365,144,221,0.508,0.497,0.482,14100,92.959231,270,594,0.809264305177112
"3574",153269,"DRAKE UNIVERSITY",1,0,1996,638,385,253,352,145,207,0.538,0.552,0.573,14380,93.273716,267,537,0.841692789968652
"3575",153269,"DRAKE UNIVERSITY",1,0,1997,636,368,268,389,141,248,0.674,0.612,0.526,15200,76.021205,269,513,0.806603773584906
"3576",153269,"DRAKE UNIVERSITY",1,0,1998,670,379,291,378,134,244,0.644,0.564,0.46,16000,78.182509,259,563,0.840298507462687
"3577",153269,"DRAKE UNIVERSITY",1,0,1999,670,364,306,371,151,220,0.604,0.554,0.493,16480,77.74418,262,553,0.825373134328358
"3578",153269,"DRAKE UNIVERSITY",1,0,2000,760,475,285,353,127,226,0.476,0.464,0.446,17090,80.040966,258.5,628,0.826315789473684
"3579",153269,"DRAKE UNIVERSITY",1,0,2001,755,476,279,361,122,239,0.502,0.478,0.437,17580,81.404746,255,627,0.83046357615894
"3580",153269,"DRAKE UNIVERSITY",1,0,2002,775,459,316,360,148,212,0.462,0.465,0.468,18190,84.391849,244,650,0.838709677419355
"3581",153269,"DRAKE UNIVERSITY",1,0,2003,809,474,335,410,151,259,0.546,0.507,0.451,19100,85.367907,237,694,0.857849196538937
"3582",153269,"DRAKE UNIVERSITY",1,0,2004,782,462,320,408,162,246,0.532,0.522,0.506,20200,89.281469,249,653,0.835038363171355
"3583",153269,"Drake University",1,0,2005,809,465,344,438,173,265,0.57,0.541,0.503,21100,92.428651,246,688,0.850432632880099
"3584",153269,"Drake University",1,0,2006,779,470,309,429,173,256,0.545,0.551,0.56,22270,97.235343,246,638,0.818998716302953
"3585",153269,"Drake University",1,0,2007,923,557,366,484,170,314,0.564,0.524,0.464,23280,104.834618,257,778,0.842903575297941
"3586",153269,"Drake University",1,0,2008,901,544,357,507,199,308,0.566,0.563,0.557,24430,109.322553,270,797,0.88457269700333
"3587",153269,"Drake University",1,0,2009,860,512,348,482,185,297,0.58,0.56,0.532,25160,113.040885,275,744,0.865116279069767
"3588",153269,"Drake University",1,0,2010,864,474,390,513,218,295,0.622,0.594,0.559,26400,118.954937,275,754,0.872685185185185
"3589",153384,"GRINNELL COLLEGE",1,0,1991,324,184,140,248,104,144,0.783,0.765,0.743,13742,36.149033,131,256,0.790123456790123
"3590",153384,"GRINNELL COLLEGE",1,0,1992,295,168,127,234,101,133,0.792,0.793,0.795,14532,38.360167,121,223,0.75593220338983
"3591",153384,"GRINNELL COLLEGE",1,0,1993,434,224,210,321,151,170,0.759,0.74,0.719,15368,40.925471,128,341,0.785714285714286
"3592",153384,"GRINNELL COLLEGE",1,0,1995,307,168,139,238,106,132,0.786,0.775,0.763,16628,48.036148,143,243,0.791530944625407
"3593",153384,"GRINNELL COLLEGE",1,0,1996,354,210,144,271,106,165,0.786,0.766,0.736,17134,50.669598,141,268,0.757062146892655
"3594",153384,"GRINNELL COLLEGE",1,0,1997,413,234,179,330,140,190,0.812,0.799,0.782,17568,55.737473,142,319,0.772397094430993
"3595",153384,"GRINNELL COLLEGE",1,0,1998,350,194,156,282,127,155,0.799,0.806,0.814,18446,48.026,134,258,0.737142857142857
"3596",153384,"GRINNELL COLLEGE",1,0,1999,325,168,157,271,126,145,0.863,0.834,0.803,18990,49.496,136,223,0.686153846153846
"3597",153384,"GRINNELL COLLEGE",1,0,2000,363,209,154,312,127,185,0.885,0.86,0.825,19982,58.941,148,245,0.674931129476584
"3598",153384,"GRINNELL COLLEGE",1,0,2001,356,184,172,291,130,161,0.875,0.817,0.756,21700,59.816,160,242,0.679775280898876
"3599",153384,"GRINNELL COLLEGE",1,0,2002,368,202,166,297,132,165,0.817,0.807,0.795,22960,60.182,170,261,0.709239130434783
"3600",153384,"GRINNELL COLLEGE",1,0,2003,403,214,189,315,138,177,0.827,0.782,0.73,23898,67.932,179,285,0.707196029776675
"3601",153384,"GRINNELL COLLEGE",1,0,2004,434,237,197,363,155,208,0.878,0.836,0.787,25200,69.352,176,301,0.693548387096774
"3602",153384,"Grinnell College",1,0,2005,385,206,179,320,148,172,0.835,0.831,0.827,27060,72.545,180,245,0.636363636363636
"3603",153384,"Grinnell College",1,0,2006,405,206,199,348,166,182,0.883,0.859,0.834,28566,77.156,183,270,0.666666666666667
"3604",153384,"Grinnell College",1,0,2007,426,233,193,344,152,192,0.824,0.808,0.788,29710,82.365,186,260,0.610328638497653
"3605",153384,"Grinnell College",1,0,2008,462,251,211,392,171,221,0.88,0.848,0.81,34932,90.111,193,299,0.647186147186147
"3606",153384,"Grinnell College",1,0,2009,377,202,175,299,124,175,0.866,0.793,0.709,35976,94.905,189,202,0.535809018567639
"3607",153384,"Grinnell College",1,0,2010,415,231,184,336,140,196,0.848,0.81,0.761,36948,97.968,188,230,0.55421686746988
"3608",153603,"IOWA STATE UNIVERSITY",1,0,1991,3228,1368,1860,665,281,384,0.281,0.206,0.151,2072,485.211511,1207,2787,0.863382899628253
"3609",153603,"IOWA STATE UNIVERSITY",1,0,1992,3333,1432,1901,723,309,414,0.289,0.217,0.163,2228,474.079473,1197,2833,0.84998499849985
"3610",153603,"IOWA STATE UNIVERSITY",1,0,1993,3416,1435,1981,763,327,436,0.304,0.223,0.165,2352,517.405184,1188,2893,0.846896955503513
"3611",153603,"IOWA STATE UNIVERSITY",1,0,1995,3274,1490,1784,822,341,481,0.323,0.251,0.191,2574,556.478259,1029,2937,0.897067806963958
"3612",153603,"IOWA STATE UNIVERSITY",1,0,1996,3599,1592,2007,1022,455,567,0.356,0.284,0.227,2666,579.150812,1035,3170,0.880800222283968
"3613",153603,"IOWA STATE UNIVERSITY",1,0,1997,4007,1790,2217,1081,437,644,0.36,0.27,0.197,2766,593.02482,1016,3500,0.873471425006239
"3614",153603,"IOWA STATE UNIVERSITY",1,0,1998,3800,1775,2025,1111,438,673,0.379,0.292,0.216,2874,620.011993,1006,3348,0.881052631578947
"3615",153603,"IOWA STATE UNIVERSITY",1,0,1999,4020,1830,2190,1261,520,741,0.405,0.314,0.237,2786,649.052671,1327,3494,0.869154228855721
"3616",153603,"IOWA STATE UNIVERSITY",1,0,2000,4282,1928,2354,1340,515,825,0.428,0.313,0.219,2906,688.500704,1307.5,3697,0.8633815973844
"3617",153603,"IOWA STATE UNIVERSITY",1,0,2001,4589,2087,2502,1463,591,872,0.418,0.319,0.236,3116,714.865818,1288,3910,0.852037480932665
"3618",153603,"IOWA STATE UNIVERSITY",1,0,2002,4167,1915,2252,1399,566,833,0.435,0.336,0.251,3692,691.156828,1376,3557,0.853611711063115
"3619",153603,"IOWA STATE UNIVERSITY",1,0,2003,3860,1683,2177,1364,577,787,0.468,0.353,0.265,4342,721.174932,1415,3288,0.851813471502591
"3620",153603,"IOWA STATE UNIVERSITY",1,0,2004,3674,1618,2056,1348,572,776,0.48,0.367,0.278,4702,769.795178,1391,3142,0.855198693522047
"3621",153603,"Iowa State University",1,0,2005,3737,1629,2108,1248,535,713,0.438,0.334,0.254,4890,765.486372,1115,3214,0.86004816697886
"3622",153603,"Iowa State University",1,0,2006,3933,1780,2153,1525,649,876,0.492,0.388,0.301,5086,806.836319,1118,3350,0.851767098906687
"3623",153603,"Iowa State University",1,0,2007,4307,1920,2387,1622,682,940,0.49,0.377,0.286,5352,828.827218,1097,3671,0.852333410726724
"3624",153603,"Iowa State University",1,0,2008,4528,2074,2454,1787,772,1015,0.489,0.395,0.315,5524,874.843627,1368,3740,0.825971731448763
"3625",153603,"Iowa State University",1,0,2009,4320,1974,2346,1757,742,1015,0.514,0.407,0.316,5756,919.059347,1374,3501,0.810416666666667
"3626",153603,"Iowa State University",1,0,2010,4518,2077,2441,2006,847,1159,0.558,0.444,0.347,6102,929.746619,1305,3623,0.801903497122621
"3627",153834,"LUTHER COLLEGE",1,0,1991,578,349,229,368,134,234,0.67,0.637,0.585,10600,33.357543,145,538,0.930795847750865
"3628",153834,"LUTHER COLLEGE",1,0,1992,579,357,222,389,144,245,0.686,0.672,0.649,11600,37.982124,150,543,0.937823834196891
"3629",153834,"LUTHER COLLEGE",1,0,1993,586,341,245,411,176,235,0.689,0.701,0.718,12375,40.85588,155,554,0.945392491467577
"3630",153834,"LUTHER COLLEGE",1,0,1995,590,372,218,375,122,253,0.68,0.636,0.56,14100,46.369849,159,538,0.911864406779661
"3631",153834,"LUTHER COLLEGE",1,0,1996,615,347,268,437,190,247,0.712,0.711,0.709,14900,46.988443,160,557,0.905691056910569
"3632",153834,"LUTHER COLLEGE",1,0,1997,629,385,244,431,161,270,0.701,0.685,0.66,15630,37.620017,165,562,0.893481717011129
"3633",153834,"LUTHER COLLEGE",1,0,1998,678,396,282,446,179,267,0.674,0.658,0.635,16525,39.505953,166,592,0.873156342182891
"3634",153834,"LUTHER COLLEGE",1,0,1999,606,354,252,393,155,238,0.672,0.649,0.615,17290,41.826617,173,552,0.910891089108911
"3635",153834,"LUTHER COLLEGE",1,0,2000,662,396,266,420,161,259,0.654,0.634,0.605,18080,45.126303,173.5,588,0.88821752265861
"3636",153834,"LUTHER COLLEGE",1,0,2001,636,397,239,401,144,257,0.647,0.631,0.603,19325,46.857059,174,537,0.844339622641509
"3637",153834,"LUTHER COLLEGE",1,0,2002,608,365,243,371,135,236,0.647,0.61,0.556,20310,47.679828,175,541,0.889802631578947
"3638",153834,"LUTHER COLLEGE",1,0,2003,667,397,270,436,172,264,0.665,0.654,0.637,21600,48.57271,183,612,0.917541229385307
"3639",153834,"LUTHER COLLEGE",1,0,2004,661,387,274,435,183,252,0.651,0.658,0.668,23070,51.317566,186,601,0.909228441754917
"3640",153834,"Luther College",1,0,2005,629,354,275,367,140,227,0.641,0.583,0.509,24570,53.78193,182,558,0.887122416534181
"3641",153834,"Luther College",1,0,2006,610,350,260,417,180,237,0.677,0.684,0.692,26380,58.322076,188,542,0.888524590163934
"3642",153834,"Luther College",1,0,2007,659,374,285,439,177,262,0.701,0.666,0.621,28840,61.015697,182,552,0.83763277693475
"3643",153834,"Luther College",1,0,2008,630,371,259,469,194,275,0.741,0.744,0.749,30920,63.247936,182,511,0.811111111111111
"3644",153834,"Luther College",1,0,2009,657,380,277,451,190,261,0.687,0.686,0.686,32140,69.780254,181,507,0.771689497716895
"3645",153834,"Luther College",1,0,2010,611,342,269,438,177,261,0.763,0.717,0.658,33330,75.197418,182,551,0.901800327332242
"3646",154095,"UNIVERSITY OF NORTHERN IOWA",1,0,1991,1949,1181,768,470,151,319,0.27,0.241,0.197,1952,122.800808,600,1840,0.944073884043099
"3647",154095,"UNIVERSITY OF NORTHERN IOWA",1,0,1992,1659,984,675,435,143,292,0.297,0.262,0.212,2228,123.874165,615,1558,0.93911995177818
"3648",154095,"UNIVERSITY OF NORTHERN IOWA",1,0,1993,1808,1112,696,491,152,339,0.305,0.272,0.218,2352,135.711767,622,1691,0.935287610619469
"3649",154095,"UNIVERSITY OF NORTHERN IOWA",1,0,1995,2007,1244,763,604,170,434,0.349,0.301,0.223,2558,148.253527,636,1912,0.952665670154459
"3650",154095,"UNIVERSITY OF NORTHERN IOWA",1,0,1996,2012,1234,778,673,224,449,0.364,0.334,0.288,2650,157.738003,646,1899,0.943836978131213
"3651",154095,"UNIVERSITY OF NORTHERN IOWA",1,0,1997,1920,1192,728,553,169,384,0.322,0.288,0.232,2752,164.738387,646,1790,0.932291666666667
"3652",154095,"UNIVERSITY OF NORTHERN IOWA",1,0,1998,1982,1257,725,585,146,439,0.349,0.295,0.201,2860,171.032484,641,1864,0.940464177598386
"3653",154095,"UNIVERSITY OF NORTHERN IOWA",1,0,1999,2122,1303,819,713,211,502,0.385,0.336,0.258,2786,184.610956,646,1978,0.932139491046183
"3654",154095,"UNIVERSITY OF NORTHERN IOWA",1,0,2000,2218,1337,881,751,243,508,0.38,0.339,0.276,2906,192.923663,646.5,2009,0.905770964833183
"3655",154095,"UNIVERSITY OF NORTHERN IOWA",1,0,2001,2055,1310,745,665,189,476,0.363,0.324,0.254,3116,210.379377,647,1878,0.913868613138686
"3656",154095,"UNIVERSITY OF NORTHERN IOWA",1,0,2002,1821,1139,682,610,194,416,0.365,0.335,0.284,3692,211.25539,641,1674,0.919275123558484
"3657",154095,"UNIVERSITY OF NORTHERN IOWA",1,0,2003,1739,1088,651,613,182,431,0.396,0.353,0.28,4342,211.292202,587,1598,0.918918918918919
"3658",154095,"UNIVERSITY OF NORTHERN IOWA",1,0,2004,1652,995,657,581,172,409,0.411,0.352,0.262,4702,217.447628,564,1508,0.912832929782082
"3659",154095,"University of Northern Iowa",1,0,2005,1693,1062,631,618,184,434,0.409,0.365,0.292,4890,217.261417,597,1550,0.915534554046072
"3660",154095,"University of Northern Iowa",1,0,2006,1684,1010,674,648,200,448,0.444,0.385,0.297,5086,226.70317,587,1525,0.905581947743468
"3661",154095,"University of Northern Iowa",1,0,2007,1922,1177,745,708,237,471,0.4,0.368,0.318,5352,227.66329,576,1767,0.919354838709677
"3662",154095,"University of Northern Iowa",1,0,2008,1972,1206,766,747,254,493,0.409,0.379,0.332,5524,242.840251,587,1804,0.914807302231237
"3663",154095,"University of Northern Iowa",1,0,2009,1913,1194,719,721,220,501,0.42,0.377,0.306,5756,266.86241,575,1761,0.920543648719289
"3664",154095,"University of Northern Iowa",1,0,2010,1934,1214,720,759,229,530,0.437,0.392,0.318,6102,258.395561,577,1790,0.925542916235781
"3665",155089,"FRIENDS UNIVERSITY",1,0,1991,165,99,66,44,12,32,0.323,0.267,0.182,7155,12.965834,48,133,0.806060606060606
"3666",155089,"FRIENDS UNIVERSITY",1,0,1992,150,101,49,31,6,25,0.248,0.207,0.122,7655,12.274332,48,127,0.846666666666667
"3667",155089,"FRIENDS UNIVERSITY",1,0,1993,230,125,105,55,22,33,0.264,0.239,0.21,8185,13.999311,48,192,0.834782608695652
"3668",155089,"FRIENDS UNIVERSITY",1,0,1995,200,109,91,43,19,24,0.22,0.215,0.209,9017,22.018381,61,161,0.805
"3669",155089,"FRIENDS UNIVERSITY",1,0,1996,196,111,85,47,12,35,0.315,0.24,0.141,9465,23.163158,63,153,0.780612244897959
"3670",155089,"FRIENDS UNIVERSITY",1,0,1997,179,99,80,39,11,28,0.283,0.218,0.138,9974,18.943879,63,130,0.726256983240223
"3671",155089,"FRIENDS UNIVERSITY",1,0,1998,195,106,89,35,14,21,0.198,0.179,0.157,10490,21.599575,67,161,0.825641025641026
"3672",155089,"FRIENDS UNIVERSITY",1,0,1999,226,125,101,36,13,23,0.184,0.159,0.129,10920,24.629957,69,182,0.805309734513274
"3673",155089,"FRIENDS UNIVERSITY",1,0,2000,231,127,104,49,18,31,0.244,0.212,0.173,11460,27.20615,70,177,0.766233766233766
"3674",155089,"FRIENDS UNIVERSITY",1,0,2001,197,133,64,23,6,17,0.128,0.117,0.094,12210,26.592464,71,155,0.786802030456853
"3675",155089,"FRIENDS UNIVERSITY",1,0,2002,203,121,82,35,15,20,0.165,0.172,0.183,12845,28.793,78,163,0.802955665024631
"3676",155089,"FRIENDS UNIVERSITY",1,0,2003,201,102,99,38,14,24,0.235,0.189,0.141,13620,28.642,75,141,0.701492537313433
"3677",155089,"FRIENDS UNIVERSITY",1,0,2004,207,112,95,27,14,13,0.116,0.13,0.147,14430,29.096,79,132,0.63768115942029
"3678",155089,"Friends University",1,0,2005,151,72,79,16,7,9,0.125,0.106,0.089,15150,29.509,72,114,0.754966887417219
"3679",155089,"Friends University",1,0,2006,139,64,75,12,8,4,0.062,0.086,0.107,16050,30.956,80,101,0.726618705035971
"3680",155089,"Friends University",1,0,2007,139,72,67,14,7,7,0.097,0.101,0.104,17100,33.029,76,88,0.633093525179856
"3681",155089,"Friends University",1,0,2008,169,100,69,20,2,18,0.18,0.118,0.029,18200,34.116,75,121,0.715976331360947
"3682",155089,"Friends University",1,0,2009,217,114,103,62,33,29,0.254,0.286,0.32,18930,34.242,74,161,0.741935483870968
"3683",155089,"Friends University",1,0,2010,199,90,109,42,17,25,0.278,0.211,0.156,19890,35.117,74,132,0.663316582914573
"3684",155317,"UNIVERSITY OF KANSAS MAIN CAMPUS",1,0,1991,3287,1755,1532,749,291,458,0.261,0.228,0.19,1662,278.25615,942,2810,0.854882871919684
"3685",155317,"UNIVERSITY OF KANSAS MAIN CAMPUS",1,0,1992,3495,1778,1717,814,304,510,0.287,0.233,0.177,1798,293.408262,954,2987,0.854649499284692
"3686",155317,"UNIVERSITY OF KANSAS MAIN CAMPUS",1,0,1993,3603,1849,1754,843,335,508,0.275,0.234,0.191,1920,309.185927,981,3090,0.857618651124063
"3687",155317,"UNIVERSITY OF KANSAS MAIN CAMPUS",1,0,1995,3474,1857,1617,905,351,554,0.298,0.261,0.217,2182,336.061133,993,3022,0.869890616004606
"3688",155317,"UNIVERSITY OF KANSAS MAIN CAMPUS",1,0,1996,3546,1902,1644,926,349,577,0.303,0.261,0.212,2310,347.869278,978,3072,0.866328257191201
"3689",155317,"UNIVERSITY OF KANSAS MAIN CAMPUS",1,0,1997,3808,1989,1819,1093,424,669,0.336,0.287,0.233,2385,366.029543,958,3261,0.856355042016807
"3690",155317,"UNIVERSITY OF KANSAS MAIN CAMPUS",1,0,1998,3698,2069,1629,974,322,652,0.315,0.263,0.198,2470,398.18787,943,3201,0.865603028664143
"3691",155317,"UNIVERSITY OF KANSAS MAIN CAMPUS",1,0,1999,3784,2099,1685,1155,374,781,0.372,0.305,0.222,2090,431.715833,946,3281,0.867071881606765
"3692",155317,"UNIVERSITY OF KANSAS MAIN CAMPUS",1,0,2000,4119,2268,1851,1282,455,827,0.365,0.311,0.246,2267,466.607659,974,3550,0.86185967467832
"3693",155317,"UNIVERSITY OF KANSAS MAIN CAMPUS",1,0,2001,4024,2198,1826,1267,476,791,0.36,0.315,0.261,2333,493.858353,1002,3513,0.873011928429423
"3694",155317,"UNIVERSITY OF KANSAS MAIN CAMPUS",1,0,2002,4013,2181,1832,1227,477,750,0.344,0.306,0.26,2921,488.815493,994,3482,0.867680039870421
"3695",155317,"UNIVERSITY OF KANSAS MAIN CAMPUS",1,0,2003,3971,2126,1845,1261,480,781,0.367,0.318,0.26,3527,517.579663,1004,3316,0.835054142533367
"3696",155317,"UNIVERSITY OF KANSAS MAIN CAMPUS",1,0,2004,4182,2148,2034,1345,527,818,0.381,0.322,0.259,4163,557.779378,1000,3429,0.819942611190818
"3697",155317,"University of Kansas Main Campus",1,0,2005,4106,2115,1991,1332,518,814,0.385,0.324,0.26,4824,611.711806,1055,3462,0.843156356551388
"3698",155317,"University of Kansas Main Campus",1,0,2006,4092,2092,2000,1500,607,893,0.427,0.367,0.304,5513,663.500513,1080,3417,0.835043988269795
"3699",155317,"University of Kansas",1,0,2007,4028,2084,1944,1444,582,862,0.414,0.358,0.299,5844,1014.247043,1228,3332,0.82720953326713
"3700",155317,"University of Kansas",1,0,2008,4435,2260,2175,1649,670,979,0.433,0.372,0.308,6195,957.885485,1244,3609,0.813754227733935
"3701",155317,"University of Kansas",1,0,2009,3894,1984,1910,1459,599,860,0.434,0.375,0.314,6567,987.751979,1152,3067,0.787621982537237
"3702",155317,"University of Kansas",1,0,2010,3489,1743,1746,1435,603,832,0.477,0.411,0.345,7167,1025.617188,1154,2837,0.813126970478647
"3703",155335,"KANSAS NEWMAN COLLEGE",1,0,1991,82,61,21,15,3,12,0.197,0.183,0.143,6380,6.842018,46,71,0.865853658536585
"3704",155335,"KANSAS NEWMAN COLLEGE",1,0,1992,83,57,26,28,8,20,0.351,0.337,0.308,6636,8.340513,70,69,0.831325301204819
"3705",155335,"KANSAS NEWMAN COLLEGE",1,0,1993,98,72,26,20,5,15,0.208,0.204,0.192,7380,12.029615,71,78,0.795918367346939
"3706",155335,"KANSAS NEWMAN COLLEGE",1,0,1995,118,74,44,23,6,17,0.23,0.195,0.136,8100,15.092697,75,97,0.822033898305085
"3707",155335,"KANSAS NEWMAN COLLEGE",1,0,1996,96,61,35,29,10,19,0.312,0.302,0.286,8500,15.942509,76,74,0.770833333333333
"3708",155335,"KANSAS NEWMAN COLLEGE",1,0,1997,89,50,39,22,10,12,0.24,0.247,0.256,9000,12.852073,82,75,0.842696629213483
"3709",155335,"NEWMAN UNIVERSITY",1,0,1998,110,65,45,28,8,20,0.308,0.255,0.178,9000,13.783328,83,96,0.872727272727273
"3710",155335,"NEWMAN UNIVERSITY",1,0,1999,148,87,61,50,18,32,0.368,0.338,0.295,9000,15.32669,81,130,0.878378378378378
"3711",155335,"NEWMAN UNIVERSITY",1,0,2000,171,112,59,49,14,35,0.312,0.287,0.237,10148,15.072812,73,132,0.771929824561403
"3712",155335,"NEWMAN UNIVERSITY",1,0,2001,130,76,54,40,18,22,0.29,0.308,0.333,11060,15.363985,65,92,0.707692307692308
"3713",155335,"NEWMAN UNIVERSITY",1,0,2002,143,79,64,37,17,20,0.253,0.259,0.266,11890,15.385967,63,107,0.748251748251748
"3714",155335,"NEWMAN UNIVERSITY",1,0,2003,200,118,82,57,19,38,0.322,0.285,0.232,13198,15.56765,63,132,0.66
"3715",155335,"NEWMAN UNIVERSITY",1,0,2004,216,112,104,43,17,26,0.232,0.199,0.163,14650,16.1474,71,114,0.527777777777778
"3716",155335,"Newman University",1,0,2005,181,84,97,31,12,19,0.226,0.171,0.124,15822,17.721843,79,112,0.61878453038674
"3717",155335,"Newman University",1,0,2006,167,96,71,48,18,30,0.312,0.287,0.254,17008,19.317763,70,109,0.652694610778443
"3718",155335,"Newman University",1,0,2007,133,72,61,44,13,31,0.431,0.331,0.213,17688,19.371616,75,94,0.706766917293233
"3719",155335,"Newman University",1,0,2008,115,74,41,36,10,26,0.351,0.313,0.244,18574,20.16326,80,84,0.730434782608696
"3720",155335,"Newman University",1,0,2009,174,106,68,55,16,39,0.368,0.316,0.235,19200,21.752609,77,112,0.64367816091954
"3721",155335,"Newman University",1,0,2010,196,118,78,69,23,46,0.39,0.352,0.295,19872,21.481611,76,153,0.780612244897959
"3722",155399,"KANSAS STATE UNIVERSITY OF AGRICULTURE AND APP SCI",1,0,1991,2670,1322,1348,480,158,322,0.244,0.18,0.117,1699,247.234378,918,2467,0.923970037453184
"3723",155399,"KANSAS STATE UNIVERSITY OF AGRICULTURE AND APP SCI",1,0,1992,2778,1357,1421,484,189,295,0.217,0.174,0.133,1841,261.053662,904,2525,0.908927285817135
"3724",155399,"KANSAS STATE UNIVERSITY OF AGRICULTURE AND APP SCI",1,0,1993,2739,1356,1383,550,203,347,0.256,0.201,0.147,1975,254.699324,895,2503,0.913837166849215
"3725",155399,"KANSAS STATE UNIVERSITY OF AGRICULTURE AND APP SCI",1,0,1995,2877,1380,1497,558,219,339,0.246,0.194,0.146,2199,277.416388,831,2626,0.912756343413278
"3726",155399,"KANSAS STATE UNIVERSITY OF AGRICULTURE AND APP SCI",1,0,1996,2681,1326,1355,583,208,375,0.283,0.217,0.154,2373,282.00088,808,2463,0.918687057068258
"3727",155399,"KANSAS STATE UNIVERSITY",1,0,1997,2906,1382,1524,640,232,408,0.295,0.22,0.152,2467,297.780919,862,2650,0.911906400550585
"3728",155399,"KANSAS STATE UNIVERSITY",1,0,1998,2921,1388,1533,755,295,460,0.331,0.258,0.192,2544,315.542898,876,2640,0.903800068469702
"3729",155399,"KANSAS STATE UNIVERSITY",1,0,1999,3280,1574,1706,723,288,435,0.276,0.22,0.169,2090,332.141542,876,2921,0.890548780487805
"3730",155399,"KANSAS STATE UNIVERSITY",1,0,2000,3399,1711,1688,829,289,540,0.316,0.244,0.171,2267,354.765504,866.5,3035,0.892909679317446
"3731",155399,"KANSAS STATE UNIVERSITY",1,0,2001,3358,1689,1669,836,274,562,0.333,0.249,0.164,2333,369.152274,857,2973,0.885348421679571
"3732",155399,"KANSAS STATE UNIVERSITY",1,0,2002,3338,1652,1686,828,278,550,0.333,0.248,0.165,2918,410.004067,882,2988,0.895146794487717
"3733",155399,"KANSAS STATE UNIVERSITY",1,0,2003,3098,1529,1569,855,303,552,0.361,0.276,0.193,3510,435.585365,850,2794,0.901872175597159
"3734",155399,"KANSAS STATE UNIVERSITY",1,0,2004,3282,1691,1591,823,270,553,0.327,0.251,0.17,4110,453.235991,893,2869,0.874162096282754
"3735",155399,"Kansas State University",1,0,2005,3105,1561,1544,697,255,442,0.283,0.224,0.165,4560,469.722218,888,2721,0.876328502415459
"3736",155399,"Kansas State University",1,0,2006,3140,1602,1538,832,288,544,0.34,0.265,0.187,4830,493.011367,921,2748,0.87515923566879
"3737",155399,"Kansas State University",1,0,2007,3301,1629,1672,843,290,553,0.34,0.255,0.173,5625,508.912744,943,2826,0.856104210845198
"3738",155399,"Kansas State University",1,0,2008,3518,1780,1738,960,339,621,0.349,0.273,0.195,5954,552.415109,986,2850,0.810119386014781
"3739",155399,"Kansas State University",1,0,2009,3420,1686,1734,972,343,629,0.373,0.284,0.198,6186,615.479581,973,2748,0.803508771929825
"3740",155399,"Kansas State University",1,0,2010,3465,1753,1712,1068,416,652,0.372,0.308,0.243,6672,613.684756,949,2884,0.832323232323232
"3741",155520,"MID-AMERICA NAZARENE COLLEGE",1,0,1991,200,112,88,51,15,36,0.321,0.255,0.17,5250,11.660712,58,177,0.885
"3742",155520,"MID-AMERICA NAZARENE COLLEGE",1,0,1992,217,107,110,42,16,26,0.243,0.194,0.145,6006,13.490363,57,188,0.866359447004608
"3743",155520,"MID-AMERICA NAZARENE COLLEGE",1,0,1993,212,97,115,36,16,20,0.206,0.17,0.139,6483,13.543164,61,184,0.867924528301887
"3744",155520,"MIDAMERICA NAZARENE COLLEGE",1,0,1995,246,124,122,62,17,45,0.363,0.252,0.139,7440,16.577501,64,216,0.878048780487805
"3745",155520,"MIDAMERICA NAZARENE COLLEGE",1,0,1996,230,129,101,70,21,49,0.38,0.304,0.208,8668,17.155921,67,214,0.930434782608696
"3746",155520,"MIDAMERICA NAZARENE UNIVERSITY",1,0,1997,256,140,116,107,38,69,0.493,0.418,0.328,9498,15.788627,67,234,0.9140625
"3747",155520,"MIDAMERICA NAZARENE UNIVERSITY",1,0,1998,254,114,140,64,27,37,0.325,0.252,0.193,10122,18.177652,67,229,0.901574803149606
"3748",155520,"MIDAMERICA NAZARENE UNIVERSITY",1,0,1999,205,111,94,71,28,43,0.387,0.346,0.298,9580,18.594657,72,189,0.921951219512195
"3749",155520,"MIDAMERICA NAZARENE UNIVERSITY",1,0,2000,260,133,127,113,39,74,0.556,0.435,0.307,10150,19.910308,71.5,235,0.903846153846154
"3750",155520,"MIDAMERICA NAZARENE UNIVERSITY",1,0,2001,248,124,124,74,20,54,0.436,0.298,0.161,10650,20.486177,71,230,0.92741935483871
"3751",155520,"MIDAMERICA NAZARENE UNIVERSITY",1,0,2002,306,156,150,128,46,82,0.526,0.418,0.307,11270,21.369849,74,281,0.918300653594771
"3752",155520,"MIDAMERICA NAZARENE UNIVERSITY",1,0,2003,260,125,135,103,41,62,0.496,0.396,0.304,11910,21.274705,70,227,0.873076923076923
"3753",155520,"MIDAMERICA NAZARENE UNIVERSITY",1,0,2004,249,117,132,84,40,44,0.376,0.337,0.303,12630,22.409184,73,212,0.85140562248996
"3754",155520,"MidAmerica Nazarene University",1,0,2005,216,109,107,61,21,40,0.367,0.282,0.196,13754,23.631977,77,177,0.819444444444444
"3755",155520,"MidAmerica Nazarene University",1,0,2006,239,118,121,82,36,46,0.39,0.343,0.298,14968,24.460514,79,218,0.912133891213389
"3756",155520,"MidAmerica Nazarene University",1,0,2007,217,109,108,89,33,56,0.514,0.41,0.306,16090,25.93795,82,186,0.857142857142857
"3757",155520,"MidAmerica Nazarene University",1,0,2008,208,114,94,69,25,44,0.386,0.332,0.266,17216,27.584193,80,177,0.850961538461538
"3758",155520,"MidAmerica Nazarene University",1,0,2009,198,110,88,83,29,54,0.491,0.419,0.33,18146,28.084246,81,159,0.803030303030303
"3759",155520,"MidAmerica Nazarene University",1,0,2010,232,120,112,100,36,64,0.533,0.431,0.321,19250,29.152407,86,185,0.797413793103448
"3760",155627,"OTTAWA UNIVERSITY",1,0,1991,120,48,72,19,11,8,0.167,0.158,0.153,6450,12.131185,34,97,0.808333333333333
"3761",155627,"OTTAWA UNIVERSITY",1,0,1992,119,43,76,24,9,15,0.349,0.202,0.118,6900,12.293531,34,93,0.781512605042017
"3762",155627,"OTTAWA UNIVERSITY",1,0,1993,130,51,79,39,16,23,0.451,0.3,0.203,7250,14.087944,30,110,0.846153846153846
"3763",155627,"OTTAWA UNIVERSITY",1,0,1995,137,44,93,21,9,12,0.273,0.153,0.097,7960,17.050867,27,115,0.839416058394161
"3764",155627,"OTTAWA UNIVERSITY",1,0,1996,130,48,82,52,23,29,0.604,0.4,0.28,8350,13.178589,30,117,0.9
"3765",155627,"OTTAWA UNIVERSITY",1,0,1997,149,39,110,39,23,16,0.41,0.262,0.209,8850,10.978242,31,113,0.758389261744966
"3766",155627,"OTTAWA UNIVERSITY",1,0,1998,117,43,74,24,10,14,0.326,0.205,0.135,9560,8.876684,27,91,0.777777777777778
"3767",155627,"OTTAWA UNIVERSITY",1,0,1999,136,50,86,22,10,12,0.24,0.162,0.116,10040,9.537797,30,92,0.676470588235294
"3768",155627,"OTTAWA UNIVERSITY",1,0,2000,111,40,71,30,12,18,0.45,0.27,0.169,10750,10.847627,25.5,84,0.756756756756757
"3769",155627,"OTTAWA UNIVERSITY",1,0,2001,132,46,86,35,11,24,0.522,0.265,0.128,11550,11.643659,21,104,0.787878787878788
"3770",155627,"OTTAWA UNIVERSITY",1,0,2002,112,35,77,32,15,17,0.486,0.286,0.195,12200,12.279011,18,76,0.678571428571429
"3771",155627,"OTTAWA UNIVERSITY",1,0,2003,114,47,67,28,6,22,0.468,0.246,0.09,12810,12.967018,24,86,0.754385964912281
"3772",155627,"OTTAWA UNIVERSITY",1,0,2004,79,30,49,23,11,12,0.4,0.291,0.224,13850,27.805493,22,65,0.822784810126582
"3773",155627,"Ottawa University",1,0,2005,113,47,66,36,19,17,0.362,0.319,0.288,14500,26.497989,20,90,0.79646017699115
"3774",155627,"Ottawa University",1,0,2006,90,38,52,19,6,13,0.342,0.211,0.115,15500,27.254652,25,78,0.866666666666667
"3775",155627,"Ottawa University",1,0,2007,161,79,82,35,11,24,0.304,0.217,0.134,17000,31.240883,26,109,0.677018633540373
"3776",155627,"Ottawa University",1,0,2008,201,100,101,40,17,23,0.23,0.199,0.168,18070,32.137006,28,121,0.601990049751244
"3777",155627,"Ottawa University",1,0,2009,150,67,83,55,30,25,0.373,0.367,0.361,19100,33.802449,27,96,0.64
"3778",155627,"Ottawa University-Ottawa",1,0,2010,156,66,90,37,12,25,0.379,0.237,0.133,20000,37.692145,27,101,0.647435897435897
"3779",155937,"STERLING COLLEGE",1,0,1991,131,55,76,42,20,22,0.4,0.321,0.263,6800,6.1265,30,108,0.824427480916031
"3780",155937,"STERLING COLLEGE",1,0,1992,118,52,66,33,9,24,0.462,0.28,0.136,7230,7.559174,31,106,0.898305084745763
"3781",155937,"STERLING COLLEGE",1,0,1993,156,76,80,42,18,24,0.316,0.269,0.225,7890,7.62805,30,144,0.923076923076923
"3782",155937,"STERLING COLLEGE",1,0,1995,120,63,57,42,12,30,0.476,0.35,0.211,8926,8.959795,32,98,0.816666666666667
"3783",155937,"STERLING COLLEGE",1,0,1996,146,72,74,50,18,32,0.444,0.342,0.243,9596,7.88953,31,125,0.856164383561644
"3784",155937,"STERLING COLLEGE",1,0,1997,140,56,84,45,21,24,0.429,0.321,0.25,10076,8.27213,30,118,0.842857142857143
"3785",155937,"STERLING COLLEGE",1,0,1998,161,81,80,52,18,34,0.42,0.323,0.225,10504,8.328619,31,141,0.875776397515528
"3786",155937,"STERLING COLLEGE",1,0,1999,110,63,47,61,20,41,0.651,0.555,0.426,11030,8.582381,31,106,0.963636363636364
"3787",155937,"STERLING COLLEGE",1,0,2000,126,60,66,47,18,29,0.483,0.373,0.273,11582,9.32931,32.5,109,0.865079365079365
"3788",155937,"STERLING COLLEGE",1,0,2001,105,51,54,39,16,23,0.451,0.371,0.296,12100,10.0307,34,86,0.819047619047619
"3789",155937,"STERLING COLLEGE",1,0,2002,98,50,48,43,14,29,0.58,0.439,0.292,12750,11.840179,38,76,0.775510204081633
"3790",155937,"STERLING COLLEGE",1,0,2003,124,57,67,44,16,28,0.491,0.355,0.239,13150,11.806273,34,92,0.741935483870968
"3791",155937,"STERLING COLLEGE",1,0,2004,136,52,84,36,19,17,0.327,0.265,0.226,13807,8.905472,37,110,0.808823529411765
"3792",155937,"Sterling College",1,0,2005,126,57,69,38,16,22,0.386,0.302,0.232,13806,11.775703,37,104,0.825396825396825
"3793",155937,"Sterling College",1,0,2006,197,79,118,40,10,30,0.38,0.203,0.085,14300,9.845531,34,155,0.786802030456853
"3794",155937,"Sterling College",1,0,2007,165,70,95,50,25,25,0.357,0.303,0.263,15500,10.780291,37,118,0.715151515151515
"3795",155937,"Sterling College",1,0,2008,150,71,79,44,15,29,0.409,0.293,0.19,16500,11.283635,39,122,0.813333333333333
"3796",155937,"Sterling College",1,0,2009,182,82,100,49,24,25,0.305,0.269,0.24,18000,11.809942,41,143,0.785714285714286
"3797",155937,"Sterling College",1,0,2010,149,70,79,50,21,29,0.414,0.336,0.266,19000,11.885103,44,120,0.805369127516778
"3798",156213,"ASBURY COLLEGE",1,0,1991,250,144,106,78,31,47,0.326,0.312,0.292,7350,13.596039,71,236,0.944
"3799",156213,"ASBURY COLLEGE",1,0,1992,268,165,103,95,38,57,0.346,0.354,0.369,7863,14.529325,72,259,0.966417910447761
"3800",156213,"ASBURY COLLEGE",1,0,1993,268,177,91,109,36,73,0.412,0.407,0.396,8322,15.276625,69,251,0.936567164179104
"3801",156213,"ASBURY COLLEGE",1,0,1995,298,180,118,140,65,75,0.417,0.47,0.551,9819,17.745554,80,286,0.959731543624161
"3802",156213,"ASBURY COLLEGE",1,0,1996,289,184,105,133,50,83,0.451,0.46,0.476,10595,19.383831,84,272,0.941176470588235
"3803",156213,"ASBURY COLLEGE",1,0,1997,365,223,142,179,66,113,0.507,0.49,0.465,11237,18.390554,86,343,0.93972602739726
"3804",156213,"ASBURY COLLEGE",1,0,1998,333,204,129,211,82,129,0.632,0.634,0.636,12020,20.466178,86,325,0.975975975975976
"3805",156213,"ASBURY COLLEGE",1,0,1999,326,198,128,200,76,124,0.626,0.613,0.594,12810,23.19666,87,309,0.947852760736196
"3806",156213,"ASBURY COLLEGE",1,0,2000,304,180,124,166,60,106,0.589,0.546,0.484,13744,20.448385,89.5,294,0.967105263157895
"3807",156213,"ASBURY COLLEGE",1,0,2001,331,206,125,178,66,112,0.544,0.538,0.528,14624,22.553518,92,319,0.963746223564955
"3808",156213,"ASBURY COLLEGE",1,0,2002,323,200,123,195,80,115,0.575,0.604,0.65,15574,24.367655,92,313,0.969040247678019
"3809",156213,"ASBURY COLLEGE",1,0,2003,258,146,112,148,68,80,0.548,0.574,0.607,16352,24.566635,90,249,0.965116279069767
"3810",156213,"ASBURY COLLEGE",1,0,2004,302,183,119,160,68,92,0.503,0.53,0.571,17660,24.291624,88,288,0.95364238410596
"3811",156213,"Asbury College",1,0,2005,276,173,103,168,64,104,0.601,0.609,0.621,18808,25.099515,86,259,0.938405797101449
"3812",156213,"Asbury College",1,0,2006,276,161,115,178,67,111,0.689,0.645,0.583,19260,25.882592,82,263,0.952898550724638
"3813",156213,"Asbury College",1,0,2007,311,173,138,175,65,110,0.636,0.563,0.471,21132,25.698084,79,293,0.942122186495177
"3814",156213,"Asbury College",1,0,2008,313,208,105,173,57,116,0.558,0.553,0.543,22242,24.918434,80,283,0.904153354632588
"3815",156213,"Asbury College",1,0,2009,315,198,117,168,64,104,0.525,0.533,0.547,22242,27.377149,83,291,0.923809523809524
"3816",156213,"Asbury University",1,0,2010,285,187,98,149,51,98,0.524,0.523,0.52,23132,28.286798,85,252,0.884210526315789
"3817",156286,"BELLARMINE COLLEGE",1,0,1991,267,157,110,122,42,80,0.51,0.457,0.382,7160,14.675487,80,250,0.936329588014981
"3818",156286,"BELLARMINE COLLEGE",1,0,1992,283,155,128,98,40,58,0.374,0.346,0.312,7580,16.749954,81,261,0.92226148409894
"3819",156286,"BELLARMINE COLLEGE",1,0,1993,309,172,137,135,65,70,0.407,0.437,0.474,8072,17.76216,84,291,0.941747572815534
"3820",156286,"BELLARMINE COLLEGE",1,0,1995,329,189,140,151,49,102,0.54,0.459,0.35,9550,21.201807,91,312,0.948328267477204
"3821",156286,"BELLARMINE COLLEGE",1,0,1996,327,203,124,164,57,107,0.527,0.502,0.46,10320,22.223188,89,302,0.923547400611621
"3822",156286,"BELLARMINE COLLEGE",1,0,1997,318,178,140,155,62,93,0.522,0.487,0.443,10970,19.602275,86,302,0.949685534591195
"3823",156286,"BELLARMINE COLLEGE",1,0,1998,362,212,150,165,61,104,0.491,0.456,0.407,11770,20.305274,94,337,0.930939226519337
"3824",156286,"BELLARMINE COLLEGE",1,0,1999,324,223,101,182,54,128,0.574,0.562,0.535,12480,22.132471,103,304,0.938271604938272
"3825",156286,"BELLARMINE UNIVERSITY",1,0,2000,355,224,131,172,63,109,0.487,0.485,0.481,13590,23.272934,106,325,0.915492957746479
"3826",156286,"BELLARMINE UNIVERSITY",1,0,2001,376,255,121,178,47,131,0.514,0.473,0.388,14990,24.737673,109,343,0.912234042553192
"3827",156286,"BELLARMINE UNIVERSITY",1,0,2002,325,214,111,165,46,119,0.556,0.508,0.414,16340,28.569291,115,292,0.898461538461538
"3828",156286,"BELLARMINE UNIVERSITY",1,0,2003,450,289,161,235,79,156,0.54,0.522,0.491,17820,30.748502,115,410,0.911111111111111
"3829",156286,"BELLARMINE UNIVERSITY",1,0,2004,407,271,136,225,58,167,0.616,0.553,0.426,19250,34.887828,118,374,0.918918918918919
"3830",156286,"Bellarmine University",1,0,2005,435,282,153,224,69,155,0.55,0.515,0.451,20800,35.754566,114,389,0.894252873563218
"3831",156286,"Bellarmine University",1,0,2006,429,279,150,206,60,146,0.523,0.48,0.4,23300,37.318432,112,372,0.867132867132867
"3832",156286,"Bellarmine University",1,0,2007,567,351,216,304,97,207,0.59,0.536,0.449,25200,40.216194,126,495,0.873015873015873
"3833",156286,"Bellarmine University",1,0,2008,567,356,211,301,109,192,0.539,0.531,0.517,27000,44.4009,142,468,0.825396825396825
"3834",156286,"Bellarmine University",1,0,2009,600,383,217,303,98,205,0.535,0.505,0.452,27800,51.444673,138,524,0.873333333333333
"3835",156286,"Bellarmine University",1,0,2010,573,362,211,301,107,194,0.536,0.525,0.507,29160,51.624417,138,470,0.820244328097731
"3836",156295,"BEREA COLLEGE",1,0,1991,436,246,190,147,58,89,0.362,0.337,0.305,177,44.126906,113,359,0.823394495412844
"3837",156295,"BEREA COLLEGE",1,0,1992,397,206,191,148,66,82,0.398,0.373,0.346,183,47.016541,111,324,0.816120906801008
"3838",156295,"BEREA COLLEGE",1,0,1993,453,230,223,150,78,72,0.313,0.331,0.35,183,49.505608,112,382,0.84326710816777
"3839",156295,"BEREA COLLEGE",1,0,1995,416,220,196,146,64,82,0.373,0.351,0.327,188,50.554283,113,347,0.834134615384615
"3840",156295,"BEREA COLLEGE",1,0,1996,396,225,171,125,53,72,0.32,0.316,0.31,195,54.076274,116,313,0.79040404040404
"3841",156295,"BEREA COLLEGE",1,0,1997,404,239,165,118,36,82,0.343,0.292,0.218,195,45.557025,118,321,0.794554455445545
"3842",156295,"BEREA COLLEGE",1,0,1998,414,237,177,161,70,91,0.384,0.389,0.395,195,47.598812,118,312,0.753623188405797
"3843",156295,"BEREA COLLEGE",1,0,1999,423,233,190,150,57,93,0.399,0.355,0.3,0,50.297586,122,313,0.739952718676123
"3844",156295,"BEREA COLLEGE",1,0,2000,421,245,176,169,60,109,0.445,0.401,0.341,0,49.725071,126.5,315,0.748218527315915
"3845",156295,"BEREA COLLEGE",1,0,2001,424,241,183,192,76,116,0.481,0.453,0.415,0,55.712873,131,314,0.740566037735849
"3846",156295,"BEREA COLLEGE",1,0,2002,356,206,150,158,61,97,0.471,0.444,0.407,0,60.827565,134,240,0.674157303370786
"3847",156295,"BEREA COLLEGE",1,0,2003,396,240,156,203,83,120,0.5,0.513,0.532,0,63.829436,130,284,0.717171717171717
"3848",156295,"BEREA COLLEGE",1,0,2004,400,209,191,201,84,117,0.56,0.502,0.44,0,55.426358,134,265,0.6625
"3849",156295,"Berea College",1,0,2005,378,219,159,161,67,94,0.429,0.426,0.421,0,62.54145,136,261,0.69047619047619
"3850",156295,"Berea College",1,0,2006,388,220,168,185,78,107,0.486,0.477,0.464,0,63.888149,133,266,0.685567010309278
"3851",156295,"Berea College",1,0,2007,420,252,168,197,72,125,0.496,0.469,0.429,0,66.081142,132,296,0.704761904761905
"3852",156295,"Berea College",1,0,2008,413,241,172,184,72,112,0.465,0.446,0.419,0,67.964732,144,289,0.699757869249395
"3853",156295,"Berea College",1,0,2009,391,221,170,174,74,100,0.452,0.445,0.435,0,69.161495,137,266,0.680306905370844
"3854",156295,"Berea College",1,0,2010,429,230,199,204,72,132,0.574,0.476,0.362,0,70.533608,123,300,0.699300699300699
"3855",156365,"CAMPBELLSVILLE COLLEGE",1,0,1991,255,122,133,29,6,23,0.189,0.114,0.045,4900,8.298343,43,236,0.925490196078431
"3856",156365,"CAMPBELLSVILLE COLLEGE",1,0,1992,208,85,123,27,9,18,0.212,0.13,0.073,5400,9.746423,45,189,0.908653846153846
"3857",156365,"CAMPBELLSVILLE COLLEGE",1,0,1993,286,122,164,48,19,29,0.238,0.168,0.116,5720,10.506148,46,255,0.891608391608392
"3858",156365,"CAMPBELLSVILLE UNIVERSITY",1,0,1995,322,156,166,84,34,50,0.32,0.261,0.205,6420,12.962407,53,301,0.934782608695652
"3859",156365,"CAMPBELLSVILLE UNIVERSITY",1,0,1996,295,151,144,66,21,45,0.298,0.224,0.146,6800,14.460531,60,271,0.91864406779661
"3860",156365,"CAMPBELLSVILLE UNIVERSITY",1,0,1997,342,182,160,93,32,61,0.335,0.272,0.2,7200,10.719324,60,310,0.906432748538012
"3861",156365,"CAMPBELLSVILLE UNIVERSITY",1,0,1998,359,194,165,82,25,57,0.294,0.228,0.152,7400,11.806168,66,311,0.866295264623955
"3862",156365,"CAMPBELLSVILLE UNIVERSITY",1,0,1999,290,155,135,77,31,46,0.297,0.266,0.23,8000,13.75425,68,260,0.896551724137931
"3863",156365,"CAMPBELLSVILLE UNIVERSITY",1,0,2000,317,167,150,88,25,63,0.377,0.278,0.167,8790,14.114831,69,289,0.911671924290221
"3864",156365,"CAMPBELLSVILLE UNIVERSITY",1,0,2001,330,175,155,58,24,34,0.194,0.176,0.155,9800,15.930861,70,306,0.927272727272727
"3865",156365,"CAMPBELLSVILLE UNIVERSITY",1,0,2002,288,138,150,61,18,43,0.312,0.212,0.12,11160,17.722591,70,261,0.90625
"3866",156365,"CAMPBELLSVILLE UNIVERSITY",1,0,2003,351,162,189,86,37,49,0.302,0.245,0.196,12504,19.557506,73,299,0.851851851851852
"3867",156365,"CAMPBELLSVILLE UNIVERSITY",1,0,2004,381,178,203,102,39,63,0.354,0.268,0.192,13632,20.166983,82,335,0.879265091863517
"3868",156365,"Campbellsville University",1,0,2005,345,174,171,83,29,54,0.31,0.241,0.17,15140,23.497399,86,298,0.863768115942029
"3869",156365,"Campbellsville University",1,0,2006,346,182,164,81,32,49,0.269,0.234,0.195,15960,23.531093,91,294,0.84971098265896
"3870",156365,"Campbellsville University",1,0,2007,377,168,209,98,47,51,0.304,0.26,0.225,16880,24.195419,98,295,0.782493368700265
"3871",156365,"Campbellsville University",1,0,2008,442,192,250,112,56,56,0.292,0.253,0.224,17700,26.988467,105,327,0.739819004524887
"3872",156365,"Campbellsville University",1,0,2009,515,260,255,127,44,83,0.319,0.247,0.173,18410,29.333511,115,403,0.78252427184466
"3873",156365,"Campbellsville University",1,0,2010,502,247,255,122,46,76,0.308,0.243,0.18,19310,32.483261,128,374,0.745019920318725
"3874",156541,"CUMBERLAND COLLEGE",1,0,1991,460,240,220,77,29,48,0.2,0.167,0.132,5296,19.700219,108,414,0.9
"3875",156541,"CUMBERLAND COLLEGE",1,0,1992,332,185,147,97,36,61,0.33,0.292,0.245,5880,20.90336,99,305,0.918674698795181
"3876",156541,"CUMBERLAND COLLEGE",1,0,1993,397,205,192,80,24,56,0.273,0.202,0.125,6230,19.31687,97,372,0.937027707808564
"3877",156541,"CUMBERLAND COLLEGE",1,0,1995,377,204,173,107,33,74,0.363,0.284,0.191,7130,21.375136,87,355,0.941644562334218
"3878",156541,"CUMBERLAND COLLEGE",1,0,1996,421,210,211,95,40,55,0.262,0.226,0.19,7930,22.056684,90,400,0.950118764845606
"3879",156541,"CUMBERLAND COLLEGE",1,0,1997,418,227,191,87,30,57,0.251,0.208,0.157,8430,19.419014,88,391,0.935406698564593
"3880",156541,"CUMBERLAND COLLEGE",1,0,1998,412,177,235,87,30,57,0.322,0.211,0.128,8980,22.695101,95,375,0.910194174757282
"3881",156541,"CUMBERLAND COLLEGE",1,0,1999,403,201,202,114,41,73,0.363,0.283,0.203,9298,22.645095,98,382,0.947890818858561
"3882",156541,"CUMBERLAND COLLEGE",1,0,2000,403,195,208,82,37,45,0.231,0.203,0.178,9698,23.835885,98,376,0.933002481389578
"3883",156541,"CUMBERLAND COLLEGE",1,0,2001,406,203,203,93,33,60,0.296,0.229,0.163,10000,26.565784,98,364,0.896551724137931
"3884",156541,"CUMBERLAND COLLEGE",1,0,2002,386,209,177,93,31,62,0.297,0.241,0.175,10598,28.416419,98,348,0.901554404145078
"3885",156541,"CUMBERLAND COLLEGE",1,0,2003,401,191,210,98,33,65,0.34,0.244,0.157,11098,29.731639,93,354,0.882793017456359
"3886",156541,"CUMBERLAND COLLEGE",1,0,2004,418,190,228,104,36,68,0.358,0.249,0.158,11498,25.881129,89,368,0.880382775119617
"3887",156541,"University of the Cumberlands",1,0,2005,424,192,232,111,48,63,0.328,0.262,0.207,12298,25.670018,86,369,0.870283018867924
"3888",156541,"University of the Cumberlands",1,0,2006,349,177,172,99,34,65,0.367,0.284,0.198,13298,26.894106,93,300,0.859598853868195
"3889",156541,"University of the Cumberlands",1,0,2007,481,217,264,115,45,70,0.323,0.239,0.17,13298,28.08375,86,399,0.82952182952183
"3890",156541,"University of the Cumberlands",1,0,2008,478,223,255,120,38,82,0.368,0.251,0.149,14298,29.858806,94,349,0.730125523012552
"3891",156541,"University of the Cumberlands",1,0,2009,453,211,242,107,31,76,0.36,0.236,0.128,15298,33.163705,99,388,0.856512141280353
"3892",156541,"University of the Cumberlands",1,0,2010,446,202,244,144,66,78,0.386,0.323,0.27,16664,33.551865,105,369,0.827354260089686
"3893",156745,"GEORGETOWN COLLEGE",1,0,1991,309,161,148,103,38,65,0.404,0.333,0.257,6250,16.692108,68,297,0.961165048543689
"3894",156745,"GEORGETOWN COLLEGE",1,0,1992,325,174,151,109,37,72,0.414,0.335,0.245,6760,18.18444,69,318,0.978461538461538
"3895",156745,"GEORGETOWN COLLEGE",1,0,1993,285,153,132,79,20,59,0.386,0.277,0.152,7300,18.60509,69,265,0.929824561403509
"3896",156745,"GEORGETOWN COLLEGE",1,0,1995,304,201,103,134,30,104,0.517,0.441,0.291,8840,20.1658,73,294,0.967105263157895
"3897",156745,"GEORGETOWN COLLEGE",1,0,1996,326,193,133,131,41,90,0.466,0.402,0.308,9540,21.707519,76,317,0.97239263803681
"3898",156745,"GEORGETOWN COLLEGE",1,0,1997,394,239,155,208,59,149,0.623,0.528,0.381,10190,19.005835,81,385,0.977157360406091
"3899",156745,"GEORGETOWN COLLEGE",1,0,1998,408,224,184,194,61,133,0.594,0.475,0.332,10800,25.225964,86,395,0.968137254901961
"3900",156745,"GEORGETOWN COLLEGE",1,0,1999,340,205,135,158,51,107,0.522,0.465,0.378,11350,29.741671,87,333,0.979411764705882
"3901",156745,"GEORGETOWN COLLEGE",1,0,2000,331,189,142,158,49,109,0.577,0.477,0.345,12140,30.607947,89.5,319,0.963746223564955
"3902",156745,"GEORGETOWN COLLEGE",1,0,2001,356,203,153,173,69,104,0.512,0.486,0.451,13200,30.35936,92,345,0.969101123595506
"3903",156745,"GEORGETOWN COLLEGE",1,0,2002,328,199,129,150,53,97,0.487,0.457,0.411,14260,31.542614,92,312,0.951219512195122
"3904",156745,"GEORGETOWN COLLEGE",1,0,2003,368,213,155,181,54,127,0.596,0.492,0.348,15690,31.496544,87,349,0.948369565217391
"3905",156745,"GEORGETOWN COLLEGE",1,0,2004,354,192,162,205,73,132,0.688,0.579,0.451,17750,30.5248,101,332,0.937853107344633
"3906",156745,"Georgetown College",1,0,2005,416,216,200,209,83,126,0.583,0.502,0.415,19170,31.705048,101,394,0.947115384615385
"3907",156745,"Georgetown College",1,0,2006,363,226,137,185,53,132,0.584,0.51,0.387,20700,35.051907,106,346,0.953168044077135
"3908",156745,"Georgetown College",1,0,2007,366,206,160,180,59,121,0.587,0.492,0.369,22360,36.36715,111,289,0.789617486338798
"3909",156745,"Georgetown College",1,0,2008,379,209,170,169,61,108,0.517,0.446,0.359,24150,37.674084,111,334,0.881266490765171
"3910",156745,"Georgetown College",1,0,2009,378,211,167,186,63,123,0.583,0.492,0.377,26080,37.534603,110,342,0.904761904761905
"3911",156745,"Georgetown College",1,0,2010,336,191,145,172,57,115,0.602,0.512,0.393,27640,37.421793,113,297,0.883928571428571
"3912",157058,"KENTUCKY STATE UNIVERSITY",1,0,1991,390,215,175,33,9,24,0.112,0.085,0.051,1332,30.873233,124,122,0.312820512820513
"3913",157058,"KENTUCKY STATE UNIVERSITY",1,0,1992,393,226,167,16,4,12,0.053,0.041,0.024,1440,35.280678,124,90,0.229007633587786
"3914",157058,"KENTUCKY STATE UNIVERSITY",1,0,1993,335,163,172,18,7,11,0.068,0.054,0.041,1600,34.655725,122,101,0.301492537313433
"3915",157058,"KENTUCKY STATE UNIVERSITY",1,0,1995,370,189,181,13,10,3,0.016,0.035,0.055,1860,39.179304,127,96,0.259459459459459
"3916",157058,"KENTUCKY STATE UNIVERSITY",1,0,1996,364,163,201,27,7,20,0.123,0.074,0.035,1950,40.21692,123,74,0.203296703296703
"3917",157058,"KENTUCKY STATE UNIVERSITY",1,0,1997,302,172,130,33,5,28,0.163,0.109,0.038,2050,41.728527,121,65,0.21523178807947
"3918",157058,"KENTUCKY STATE UNIVERSITY",1,0,1998,379,215,164,34,9,25,0.116,0.09,0.055,2170,42.200489,125,87,0.229551451187335
"3919",157058,"KENTUCKY STATE UNIVERSITY",1,0,1999,366,186,180,40,8,32,0.172,0.109,0.044,2020,43.484197,126,61,0.166666666666667
"3920",157058,"KENTUCKY STATE UNIVERSITY",1,0,2000,340,171,169,49,17,32,0.187,0.144,0.101,2100,47.460932,146.5,64,0.188235294117647
"3921",157058,"KENTUCKY STATE UNIVERSITY",1,0,2001,387,199,188,31,4,27,0.136,0.08,0.021,2100,55.256096,167,57,0.147286821705426
"3922",157058,"KENTUCKY STATE UNIVERSITY",1,0,2002,373,203,170,34,6,28,0.138,0.091,0.035,2630,49.201089,136,50,0.134048257372654
"3923",157058,"KENTUCKY STATE UNIVERSITY",1,0,2003,309,162,147,23,9,14,0.086,0.074,0.061,2828,52.335736,148,62,0.200647249190939
"3924",157058,"KENTUCKY STATE UNIVERSITY",1,0,2004,346,196,150,37,8,29,0.148,0.107,0.053,3110,55.811436,152,66,0.190751445086705
"3925",157058,"Kentucky State University",1,0,2005,408,223,185,17,4,13,0.058,0.042,0.022,3550,55.187466,152,60,0.147058823529412
"3926",157058,"Kentucky State University",1,0,2006,569,277,292,21,6,15,0.054,0.037,0.021,3900,56.374945,129,64,0.112478031634446
"3927",157058,"Kentucky State University",1,0,2007,602,343,259,39,5,34,0.099,0.065,0.019,4270,56.14357,139,62,0.102990033222591
"3928",157058,"Kentucky State University",1,0,2008,566,293,273,32,7,25,0.085,0.057,0.026,4942,61.301794,131,58,0.102473498233216
"3929",157058,"Kentucky State University",1,0,2009,476,265,211,24,7,17,0.064,0.05,0.033,5086,66.473069,128,53,0.111344537815126
"3930",157058,"Kentucky State University",1,0,2010,569,316,253,25,8,17,0.054,0.044,0.032,4920,67.637596,129,47,0.0826010544815466
"3931",157076,"KENTUCKY WESLEYAN COLLEGE",1,0,1991,204,75,129,48,24,24,0.32,0.235,0.186,6690,8.923084,50,180,0.882352941176471
"3932",157076,"KENTUCKY WESLEYAN COLLEGE",1,0,1992,147,71,76,41,13,28,0.394,0.279,0.171,7170,9.866435,50,138,0.938775510204082
"3933",157076,"KENTUCKY WESLEYAN COLLEGE",1,0,1993,173,79,94,41,17,24,0.304,0.237,0.181,7600,9.733433,51,161,0.930635838150289
"3934",157076,"KENTUCKY WESLEYAN COLLEGE",1,0,1995,151,79,72,49,17,32,0.405,0.325,0.236,9100,11.467393,48,147,0.973509933774834
"3935",157076,"KENTUCKY WESLEYAN COLLEGE",1,0,1996,179,103,76,44,22,22,0.214,0.246,0.289,9100,10.35158,47,169,0.94413407821229
"3936",157076,"KENTUCKY WESLEYAN COLLEGE",1,0,1997,203,131,72,84,27,57,0.435,0.414,0.375,9220,8.105355,43,191,0.940886699507389
"3937",157076,"KENTUCKY WESLEYAN COLLEGE",1,0,1998,152,95,57,53,18,35,0.368,0.349,0.316,9730,8.75346,43,140,0.921052631578947
"3938",157076,"KENTUCKY WESLEYAN COLLEGE",1,0,1999,191,102,89,51,18,33,0.324,0.267,0.202,9770,8.679707,41,183,0.958115183246073
"3939",157076,"KENTUCKY WESLEYAN COLLEGE",1,0,2000,159,75,84,37,12,25,0.333,0.233,0.143,10070,9.668138,42,150,0.943396226415094
"3940",157076,"KENTUCKY WESLEYAN COLLEGE",1,0,2001,164,60,104,24,8,16,0.267,0.146,0.077,10570,10.433776,43,145,0.884146341463415
"3941",157076,"KENTUCKY WESLEYAN COLLEGE",1,0,2002,150,77,73,44,13,31,0.403,0.293,0.178,11100,8.791903,39,123,0.82
"3942",157076,"KENTUCKY WESLEYAN COLLEGE",1,0,2003,165,91,74,58,19,39,0.429,0.352,0.257,11700,10.084945,34,145,0.878787878787879
"3943",157076,"KENTUCKY WESLEYAN COLLEGE",1,0,2004,210,93,117,64,25,39,0.419,0.305,0.214,12160,10.384625,34,164,0.780952380952381
"3944",157076,"Kentucky Wesleyan College",1,0,2005,209,100,109,67,22,45,0.45,0.321,0.202,12590,10.37749,34,160,0.76555023923445
"3945",157076,"Kentucky Wesleyan College",1,0,2006,326,127,199,82,41,41,0.323,0.252,0.206,13200,11.713939,40,256,0.785276073619632
"3946",157076,"Kentucky Wesleyan College",1,0,2007,280,120,160,69,27,42,0.35,0.246,0.169,14100,13.762693,42,221,0.789285714285714
"3947",157076,"Kentucky Wesleyan College",1,0,2008,219,103,116,81,44,37,0.359,0.37,0.379,15500,14.538574,45,171,0.780821917808219
"3948",157076,"Kentucky Wesleyan College",1,0,2009,227,118,109,79,30,49,0.415,0.348,0.275,16870,14.847492,43,156,0.687224669603524
"3949",157076,"Kentucky Wesleyan College",1,0,2010,202,96,106,64,26,38,0.396,0.317,0.245,17980,13.998616,41,148,0.732673267326733
"3950",157085,"UNIVERSITY OF KENTUCKY",1,0,1991,2817,1434,1383,389,138,251,0.175,0.138,0.1,1844,632.036282,1223,2500,0.887468938587149
"3951",157085,"UNIVERSITY OF KENTUCKY",1,0,1992,2562,1374,1188,528,195,333,0.242,0.206,0.164,1998,686.842082,1200,2280,0.889929742388759
"3952",157085,"UNIVERSITY OF KENTUCKY",1,0,1993,2662,1391,1271,599,210,389,0.28,0.225,0.165,2278,689.77493,1200,2341,0.879413974455297
"3953",157085,"UNIVERSITY OF KENTUCKY",1,0,1995,2612,1383,1229,620,235,385,0.278,0.237,0.191,2594,763.774796,1238,2306,0.882848392036753
"3954",157085,"UNIVERSITY OF KENTUCKY",1,0,1996,2640,1459,1181,720,253,467,0.32,0.273,0.214,2676,825.834782,1239,2329,0.88219696969697
"3955",157085,"UNIVERSITY OF KENTUCKY",1,0,1997,2740,1499,1241,743,281,462,0.308,0.271,0.226,2736,944.743298,1222,2408,0.878832116788321
"3956",157085,"UNIVERSITY OF KENTUCKY",1,0,1998,2931,1548,1383,815,331,484,0.313,0.278,0.239,3016,968.51539,1228,2595,0.885363357215967
"3957",157085,"UNIVERSITY OF KENTUCKY",1,0,1999,2742,1499,1243,792,293,499,0.333,0.289,0.236,2960,994.07189,1239,2468,0.900072939460248
"3958",157085,"UNIVERSITY OF KENTUCKY",1,0,2000,2971,1590,1381,884,333,551,0.346,0.298,0.241,3110,1099.255061,1202,2640,0.888589700437563
"3959",157085,"UNIVERSITY OF KENTUCKY",1,0,2001,3129,1679,1450,942,374,568,0.338,0.301,0.258,3270,1162.072272,1165,2852,0.911473314157878
"3960",157085,"UNIVERSITY OF KENTUCKY",1,0,2002,3701,1999,1702,1045,362,683,0.342,0.282,0.213,3480,1173.388138,1202,3347,0.904350175628209
"3961",157085,"UNIVERSITY OF KENTUCKY",1,0,2003,3678,1951,1727,1160,460,700,0.359,0.315,0.266,4002,1225.735548,1209,3289,0.894235997824905
"3962",157085,"UNIVERSITY OF KENTUCKY",1,0,2004,3935,2097,1838,1276,486,790,0.377,0.324,0.264,4602,1376.644996,1198,3464,0.880304955527319
"3963",157085,"University of Kentucky",1,0,2005,3824,2045,1779,1291,502,789,0.386,0.338,0.282,5162,1487.991918,1211,3437,0.898797071129707
"3964",157085,"University of Kentucky",1,0,2006,4113,2201,1912,1253,443,810,0.368,0.305,0.232,5782,1646.220429,1233,3517,0.855093605640652
"3965",157085,"University of Kentucky",1,0,2007,3826,2006,1820,1276,498,778,0.388,0.334,0.274,6302,1831.421509,1251,3271,0.854939884997386
"3966",157085,"University of Kentucky",1,0,2008,4074,2086,1988,1323,513,810,0.388,0.325,0.258,6870,1930.755477,1245,3391,0.832351497299951
"3967",157085,"University of Kentucky",1,0,2009,4105,2102,2003,1438,551,887,0.422,0.35,0.275,7214,2045.197261,1276,3368,0.820462850182704
"3968",157085,"University of Kentucky",1,0,2010,4270,2203,2067,1625,615,1010,0.458,0.381,0.298,7656,2135.513798,1313,3376,0.790632318501171
"3969",157289,"UNIVERSITY OF LOUISVILLE",1,0,1991,2050,1007,1043,105,28,77,0.076,0.051,0.027,1740,308.133,676,1701,0.829756097560976
"3970",157289,"UNIVERSITY OF LOUISVILLE",1,0,1992,1745,843,902,133,45,88,0.104,0.076,0.05,1880,316.007181,681,1404,0.80458452722063
"3971",157289,"UNIVERSITY OF LOUISVILLE",1,0,1993,1743,858,885,157,57,100,0.117,0.09,0.064,2170,317.523,674,1384,0.794033275960987
"3972",157289,"UNIVERSITY OF LOUISVILLE",1,0,1995,1835,903,932,193,69,124,0.137,0.105,0.074,2470,324.474,672,1451,0.790735694822888
"3973",157289,"UNIVERSITY OF LOUISVILLE",1,0,1996,1861,950,911,197,69,128,0.135,0.106,0.076,2570,381.565,691,1463,0.786136485760344
"3974",157289,"UNIVERSITY OF LOUISVILLE",1,0,1997,1931,1024,907,241,86,155,0.151,0.125,0.095,2630,398.975,704,1528,0.791299844640083
"3975",157289,"UNIVERSITY OF LOUISVILLE",1,0,1998,2032,1011,1021,222,81,141,0.139,0.109,0.079,2920,426.697,703,1662,0.817913385826772
"3976",157289,"UNIVERSITY OF LOUISVILLE",1,0,1999,2297,1232,1065,289,90,199,0.161,0.126,0.085,2960,435.904,756,1838,0.800174140182847
"3977",157289,"UNIVERSITY OF LOUISVILLE",1,0,2000,2249,1162,1087,321,113,208,0.179,0.143,0.104,3149,472.684,738,1802,0.80124499777679
"3978",157289,"UNIVERSITY OF LOUISVILLE",1,0,2001,2209,1150,1059,351,137,214,0.186,0.159,0.129,3794,507.879,720,1786,0.808510638297872
"3979",157289,"UNIVERSITY OF LOUISVILLE",1,0,2002,2209,1153,1056,428,157,271,0.235,0.194,0.149,4082,497.31,726,1773,0.802625622453599
"3980",157289,"UNIVERSITY OF LOUISVILLE",1,0,2003,2197,1118,1079,468,173,295,0.264,0.213,0.16,4450,520.618,780,1789,0.814292216659081
"3981",157289,"UNIVERSITY OF LOUISVILLE",1,0,2004,2303,1197,1106,489,164,325,0.272,0.212,0.148,5040,559.08,796,1867,0.810681719496309
"3982",157289,"University of Louisville",1,0,2005,2255,1144,1111,497,205,292,0.255,0.22,0.185,5532,592.81,802,1799,0.797782705099778
"3983",157289,"University of Louisville",1,0,2006,2380,1230,1150,628,257,371,0.302,0.264,0.223,6252,633.497,829,1916,0.805042016806723
"3984",157289,"University of Louisville",1,0,2007,2525,1314,1211,634,262,372,0.283,0.251,0.216,6940,688.009,861,2033,0.805148514851485
"3985",157289,"University of Louisville",1,0,2008,2548,1344,1204,915,391,524,0.39,0.359,0.325,7564,746.516,862,2076,0.814756671899529
"3986",157289,"University of Louisville",1,0,2009,2441,1273,1168,622,270,352,0.276,0.255,0.231,7944,759.036,867,1943,0.795985251945924
"3987",157289,"University of Louisville",1,0,2010,2507,1266,1241,696,308,388,0.306,0.278,0.248,8424,788.836,894,1955,0.779816513761468
"3988",157386,"MOREHEAD STATE UNIVERSITY",1,0,1991,1261,674,587,99,32,67,0.099,0.079,0.055,1510,66.258056,346,1197,0.949246629659001
"3989",157386,"MOREHEAD STATE UNIVERSITY",1,0,1992,1349,769,580,133,39,94,0.122,0.099,0.067,1630,72.293403,328,1260,0.934025203854707
"3990",157386,"MOREHEAD STATE UNIVERSITY",1,0,1993,1266,706,560,143,41,102,0.144,0.113,0.073,1800,70.428174,336,1201,0.948657187993681
"3991",157386,"MOREHEAD STATE UNIVERSITY",1,0,1995,1119,646,473,104,7,97,0.15,0.093,0.015,2000,77.995871,337,1069,0.955317247542449
"3992",157386,"MOREHEAD STATE UNIVERSITY",1,0,1996,1271,687,584,157,55,102,0.148,0.124,0.094,2090,79.584309,326,1176,0.925255704169945
"3993",157386,"MOREHEAD STATE UNIVERSITY",1,0,1997,1227,674,553,160,55,105,0.156,0.13,0.099,2150,79.55202,317,1134,0.924205378973105
"3994",157386,"MOREHEAD STATE UNIVERSITY",1,0,1998,1369,739,630,157,48,109,0.148,0.115,0.076,2270,84.733204,321,1255,0.91672753834916
"3995",157386,"MOREHEAD STATE UNIVERSITY",1,0,1999,1325,756,569,156,55,101,0.134,0.118,0.097,2020,87.28027,320,1242,0.937358490566038
"3996",157386,"MOREHEAD STATE UNIVERSITY",1,0,2000,1473,849,624,181,59,122,0.144,0.123,0.095,2510,89.88705,330,1397,0.948404616429056
"3997",157386,"MOREHEAD STATE UNIVERSITY",1,0,2001,1588,894,694,185,66,119,0.133,0.116,0.095,2710,99.231281,340,1482,0.933249370277078
"3998",157386,"MOREHEAD STATE UNIVERSITY",1,0,2002,1563,882,681,172,59,113,0.128,0.11,0.087,2926,99.184298,353,1461,0.934740882917466
"3999",157386,"MOREHEAD STATE UNIVERSITY",1,0,2003,1555,867,688,185,60,125,0.144,0.119,0.087,3364,104.490255,361,1462,0.940192926045016
"4000",157386,"MOREHEAD STATE UNIVERSITY",1,0,2004,1307,737,570,125,39,86,0.117,0.096,0.068,3840,111.150836,358,1223,0.935730680948738
"4001",157386,"Morehead State University",1,0,2005,1310,745,565,162,55,107,0.144,0.124,0.097,4320,113.934298,378,1205,0.919847328244275
"4002",157386,"Morehead State University",1,0,2006,1330,741,589,201,65,136,0.184,0.151,0.11,4870,119.287006,384,1236,0.929323308270677
"4003",157386,"Morehead State University",1,0,2007,1445,803,642,257,87,170,0.212,0.178,0.136,5280,121.52127,379,1347,0.932179930795848
"4004",157386,"Morehead State University",1,0,2008,1313,777,536,235,78,157,0.202,0.179,0.146,5400,136.089464,369,1210,0.921553693830922
"4005",157386,"Morehead State University",1,0,2009,1240,708,532,231,74,157,0.222,0.186,0.139,6036,138.253157,370,1143,0.921774193548387
"4006",157386,"Morehead State University",1,0,2010,1175,662,513,294,118,176,0.266,0.25,0.23,6492,143.067085,374,1072,0.912340425531915
"4007",157401,"MURRAY STATE UNIVERSITY",1,0,1991,1147,633,514,120,34,86,0.136,0.105,0.066,1410,75.364999,363,1056,0.920662598081953
"4008",157401,"MURRAY STATE UNIVERSITY",1,0,1992,982,538,444,223,76,147,0.273,0.227,0.171,1600,77.582227,337,911,0.927698574338086
"4009",157401,"MURRAY STATE UNIVERSITY",1,0,1993,946,510,436,228,77,151,0.296,0.241,0.177,1780,75.618444,336,861,0.91014799154334
"4010",157401,"MURRAY STATE UNIVERSITY",1,0,1995,1201,661,540,262,82,180,0.272,0.218,0.152,1960,82.135863,338,1095,0.911740216486261
"4011",157401,"MURRAY STATE UNIVERSITY",1,0,1996,1366,749,617,339,105,234,0.312,0.248,0.17,2060,89.468447,347,1242,0.909224011713031
"4012",157401,"MURRAY STATE UNIVERSITY",1,0,1997,1206,691,515,184,51,133,0.192,0.153,0.099,2120,97.930532,355,1087,0.901326699834162
"4013",157401,"MURRAY STATE UNIVERSITY",1,0,1998,1275,707,568,341,122,219,0.31,0.267,0.215,2300,97.67807,369,1133,0.888627450980392
"4014",157401,"MURRAY STATE UNIVERSITY",1,0,1999,1177,666,511,345,114,231,0.347,0.293,0.223,2020,108.057766,371,1051,0.892948173322005
"4015",157401,"MURRAY STATE UNIVERSITY",1,0,2000,1210,730,480,348,108,240,0.329,0.288,0.225,2172,109.577946,373.5,1070,0.884297520661157
"4016",157401,"MURRAY STATE UNIVERSITY",1,0,2001,1409,827,582,423,135,288,0.348,0.3,0.232,2334,118.603427,376,1282,0.90986515259049
"4017",157401,"MURRAY STATE UNIVERSITY",1,0,2002,1467,879,588,439,130,309,0.352,0.299,0.221,2540,115.70167,390,1322,0.901158827539196
"4018",157401,"MURRAY STATE UNIVERSITY",1,0,2003,1500,876,624,477,160,317,0.362,0.318,0.256,2944,123.446641,393,1321,0.880666666666667
"4019",157401,"MURRAY STATE UNIVERSITY",1,0,2004,1414,804,610,531,176,355,0.442,0.376,0.289,3420,125.822523,380,1282,0.906647807637907
"4020",157401,"Murray State University",1,0,2005,1442,841,601,532,180,352,0.419,0.369,0.3,3792,133.401782,385,1310,0.908460471567268
"4021",157401,"Murray State University",1,0,2006,1390,822,568,391,123,268,0.326,0.281,0.217,4284,139.964959,396,1222,0.879136690647482
"4022",157401,"Murray State University",1,0,2007,1393,835,558,397,128,269,0.322,0.285,0.229,4650,146.306557,395,1222,0.87724335965542
"4023",157401,"Murray State University",1,0,2008,1452,875,577,415,120,295,0.337,0.286,0.208,4932,153.008332,398,1232,0.848484848484849
"4024",157401,"Murray State University",1,0,2009,1374,837,537,330,101,229,0.274,0.24,0.188,5130,157.751286,406,1127,0.820232896652111
"4025",157401,"Murray State University",1,0,2010,1363,830,533,344,104,240,0.289,0.252,0.195,5388,164.111115,401,1152,0.845194424064563
"4026",157447,"NORTHERN KENTUCKY UNIVERSITY",1,0,1991,1282,698,584,42,14,28,0.04,0.033,0.024,1410,55.877751,351,1221,0.952418096723869
"4027",157447,"NORTHERN KENTUCKY UNIVERSITY",1,0,1992,1359,714,645,49,12,37,0.052,0.036,0.019,1560,61.330506,351,1299,0.955849889624724
"4028",157447,"NORTHERN KENTUCKY UNIVERSITY",1,0,1993,1517,890,627,55,11,44,0.049,0.036,0.018,1720,65.073543,360,1450,0.955833882663151
"4029",157447,"NORTHERN KENTUCKY UNIVERSITY",1,0,1995,1545,873,672,79,22,57,0.065,0.051,0.033,1960,74.152918,373,1471,0.95210355987055
"4030",157447,"NORTHERN KENTUCKY UNIVERSITY",1,0,1996,1487,823,664,71,16,55,0.067,0.048,0.024,2020,76.953,373,1407,0.946200403496974
"4031",157447,"NORTHERN KENTUCKY UNIVERSITY",1,0,1997,1657,949,708,84,21,63,0.066,0.051,0.03,2120,77.372,378,1569,0.946891973445987
"4032",157447,"NORTHERN KENTUCKY UNIVERSITY",1,0,1998,1627,956,671,118,32,86,0.09,0.073,0.048,2248,81.971,394,1525,0.937307928703135
"4033",157447,"NORTHERN KENTUCKY UNIVERSITY",1,0,1999,1696,969,727,35,13,22,0.023,0.021,0.018,2100,90.237,424,1578,0.930424528301887
"4034",157447,"NORTHERN KENTUCKY UNIVERSITY",1,0,2000,1682,974,708,114,37,77,0.079,0.068,0.052,2328,94.901,456,1551,0.922116527942925
"4035",157447,"NORTHERN KENTUCKY UNIVERSITY",1,0,2001,1787,1008,779,149,52,97,0.096,0.083,0.067,2460,101.229,488,1635,0.91494124230554
"4036",157447,"NORTHERN KENTUCKY UNIVERSITY",1,0,2002,1907,1084,823,185,66,119,0.11,0.097,0.08,3216,103.987,488,1713,0.898269533298374
"4037",157447,"NORTHERN KENTUCKY UNIVERSITY",1,0,2003,1962,1108,854,155,35,120,0.108,0.079,0.041,3744,117.893,498,1785,0.909785932721712
"4038",157447,"NORTHERN KENTUCKY UNIVERSITY",1,0,2004,1915,1123,792,151,43,108,0.096,0.079,0.054,4368,123.531,522,1739,0.908093994778068
"4039",157447,"Northern Kentucky University",1,0,2005,1759,1000,759,185,50,135,0.135,0.105,0.066,4968,131.583,544,1588,0.902785673678226
"4040",157447,"Northern Kentucky University",1,0,2006,1908,1069,839,230,83,147,0.138,0.121,0.099,5448,142.99,575,1668,0.874213836477987
"4041",157447,"Northern Kentucky University",1,0,2007,1896,1068,828,253,84,169,0.158,0.133,0.101,5952,155.791,597,1623,0.856012658227848
"4042",157447,"Northern Kentucky University",1,0,2008,2001,1117,884,252,77,175,0.157,0.126,0.087,6528,173.262,523,1684,0.841579210394803
"4043",157447,"Northern Kentucky University",1,0,2009,2187,1219,968,340,121,219,0.18,0.155,0.125,6792,195.491,532,1837,0.839963420210334
"4044",157447,"Northern Kentucky University",1,0,2010,2230,1238,992,321,116,205,0.166,0.144,0.117,7128,194.918,525,1785,0.800448430493274
"4045",157535,"PIKEVILLE COLLEGE",1,0,1991,181,134,47,25,6,19,0.142,0.138,0.128,4200,9.505815,56,177,0.977900552486188
"4046",157535,"PIKEVILLE COLLEGE",1,0,1992,198,139,59,17,8,9,0.065,0.086,0.136,4900,9.854355,54,197,0.994949494949495
"4047",157535,"PIKEVILLE COLLEGE",1,0,1993,167,117,50,20,7,13,0.111,0.12,0.14,5500,10.238669,58,163,0.976047904191617
"4048",157535,"PIKEVILLE COLLEGE",1,0,1995,227,154,73,34,8,26,0.169,0.15,0.11,6000,9.750881,59,220,0.969162995594714
"4049",157535,"PIKEVILLE COLLEGE",1,0,1996,211,144,67,34,11,23,0.16,0.161,0.164,6500,11.680597,53,211,1
"4050",157535,"PIKEVILLE COLLEGE",1,0,1997,178,110,68,25,8,17,0.154,0.14,0.118,6500,10.855737,57,178,1
"4051",157535,"PIKEVILLE COLLEGE",1,0,1998,169,110,59,30,12,18,0.164,0.178,0.203,7500,11.573803,61,169,1
"4052",157535,"PIKEVILLE COLLEGE",1,0,1999,206,140,66,41,10,31,0.221,0.199,0.152,7500,13.086561,68,203,0.985436893203884
"4053",157535,"PIKEVILLE COLLEGE",1,0,2000,282,137,145,45,7,38,0.277,0.16,0.048,7800,16.031889,74.5,232,0.822695035460993
"4054",157535,"PIKEVILLE COLLEGE",1,0,2001,258,142,116,41,11,30,0.211,0.159,0.095,8200,16.947196,81,218,0.844961240310077
"4055",157535,"PIKEVILLE COLLEGE",1,0,2002,226,129,97,40,9,31,0.24,0.177,0.093,9000,19.199514,66,206,0.911504424778761
"4056",157535,"PIKEVILLE COLLEGE",1,0,2003,147,67,80,27,10,17,0.254,0.184,0.125,9900,20.387539,62,133,0.904761904761905
"4057",157535,"PIKEVILLE COLLEGE",1,0,2004,175,103,72,31,8,23,0.223,0.177,0.111,10500,20.56779,56,167,0.954285714285714
"4058",157535,"Pikeville College",1,0,2005,206,98,108,31,8,23,0.235,0.15,0.074,11500,19.130667,55,190,0.922330097087379
"4059",157535,"Pikeville College",1,0,2006,220,105,115,26,4,22,0.21,0.118,0.035,12750,20.624721,56,180,0.818181818181818
"4060",157535,"Pikeville College",1,0,2007,233,103,130,35,15,20,0.194,0.15,0.115,13750,21.78754,61,200,0.858369098712446
"4061",157535,"Pikeville College",1,0,2008,177,83,94,41,13,28,0.337,0.232,0.138,14250,23.111274,59,156,0.88135593220339
"4062",157535,"Pikeville College",1,0,2009,185,62,123,38,20,18,0.29,0.205,0.163,14535,23.441757,54,148,0.8
"4063",157535,"Pikeville College",1,0,2010,393,154,239,56,22,34,0.221,0.142,0.092,15250,21.632783,56,335,0.852417302798982
"4064",157951,"WESTERN KENTUCKY UNIVERSITY",1,0,1991,2263,1267,996,259,77,182,0.144,0.114,0.077,1440,102.08526,560,2044,0.903225806451613
"4065",157951,"WESTERN KENTUCKY UNIVERSITY",1,0,1992,2192,1261,931,271,80,191,0.152,0.124,0.086,1544,109.865655,560,2005,0.914689781021898
"4066",157951,"WESTERN KENTUCKY UNIVERSITY",1,0,1993,2201,1222,979,238,80,158,0.129,0.108,0.082,1704,108.036543,553,1990,0.904134484325307
"4067",157951,"WESTERN KENTUCKY UNIVERSITY",1,0,1995,2454,1364,1090,496,159,337,0.247,0.202,0.146,1910,117.7345,542,2182,0.889160554197229
"4068",157951,"WESTERN KENTUCKY UNIVERSITY",1,0,1996,2257,1234,1023,471,164,307,0.249,0.209,0.16,1970,121.956148,546,1999,0.885688967656181
"4069",157951,"WESTERN KENTUCKY UNIVERSITY",1,0,1997,2205,1244,961,445,148,297,0.239,0.202,0.154,2140,128.553,542,1955,0.886621315192744
"4070",157951,"WESTERN KENTUCKY UNIVERSITY",1,0,1998,2353,1347,1006,542,190,352,0.261,0.23,0.189,2260,136.627204,553,2058,0.874628134296643
"4071",157951,"WESTERN KENTUCKY UNIVERSITY",1,0,1999,2480,1447,1033,568,204,364,0.252,0.229,0.197,2020,149.8288,562,2201,0.8875
"4072",157951,"WESTERN KENTUCKY UNIVERSITY",1,0,2000,2477,1444,1033,634,202,432,0.299,0.256,0.196,2150,175.991,580.5,2145,0.86596689543803
"4073",157951,"WESTERN KENTUCKY UNIVERSITY",1,0,2001,2640,1563,1077,651,192,459,0.294,0.247,0.178,2290,164.533447,599,2281,0.864015151515152
"4074",157951,"WESTERN KENTUCKY UNIVERSITY",1,0,2002,2954,1714,1240,513,136,377,0.22,0.174,0.11,3120,166.029549,614,2533,0.857481381178064
"4075",157951,"WESTERN KENTUCKY UNIVERSITY",1,0,2003,3034,1782,1252,541,169,372,0.209,0.178,0.135,3232,178.317989,646,2620,0.863546473302571
"4076",157951,"WESTERN KENTUCKY UNIVERSITY",1,0,2004,2918,1647,1271,456,155,301,0.183,0.156,0.122,4596,191.549466,679,2441,0.83653187114462
"4077",157951,"Western Kentucky University",1,0,2005,3002,1680,1322,539,189,350,0.208,0.18,0.143,5316,204.39177,686,2549,0.849100599600267
"4078",157951,"Western Kentucky University",1,0,2006,3118,1768,1350,649,217,432,0.244,0.208,0.161,5952,224.213246,720,2529,0.811096856959589
"4079",157951,"Western Kentucky University",1,0,2007,3013,1716,1297,610,197,413,0.241,0.202,0.152,6416,237.142548,719,2470,0.819780949220047
"4080",157951,"Western Kentucky University",1,0,2008,3203,1821,1382,684,247,437,0.24,0.214,0.179,6930,255.001146,719,2545,0.794567592881673
"4081",157951,"Western Kentucky University",1,0,2009,3288,1783,1505,700,249,451,0.253,0.213,0.165,7200,270.488546,728,2605,0.792274939172749
"4082",157951,"Western Kentucky University",1,0,2010,3279,1865,1414,747,228,519,0.278,0.228,0.161,7560,287.98873,742,2610,0.795974382433669
"4083",158477,"CENTENARY COLLEGE OF LOUISIANA",1,0,1991,207,124,83,87,29,58,0.468,0.42,0.349,7220,13.034506,69,175,0.845410628019324
"4084",158477,"CENTENARY COLLEGE OF LOUISIANA",1,0,1992,249,146,103,84,38,46,0.315,0.337,0.369,7550,13.116711,69,214,0.859437751004016
"4085",158477,"CENTENARY COLLEGE OF LOUISIANA",1,0,1993,211,121,90,80,33,47,0.388,0.379,0.367,8406,14.372279,66,185,0.876777251184834
"4086",158477,"CENTENARY COLLEGE OF LOUISIANA",1,0,1995,213,134,79,91,26,65,0.485,0.427,0.329,10122,15.852519,68,188,0.882629107981221
"4087",158477,"CENTENARY COLLEGE OF LOUISIANA",1,0,1996,190,103,87,74,29,45,0.437,0.389,0.333,10400,17.687687,65,175,0.921052631578947
"4088",158477,"CENTENARY COLLEGE OF LOUISIANA",1,0,1997,226,116,110,88,28,60,0.517,0.389,0.255,11050,15.76372,70,190,0.84070796460177
"4089",158477,"CENTENARY COLLEGE OF LOUISIANA",1,0,1998,294,180,114,126,34,92,0.511,0.429,0.298,12100,16.392784,69,257,0.874149659863946
"4090",158477,"CENTENARY COLLEGE OF LOUISIANA",1,0,1999,270,162,108,112,34,78,0.482,0.415,0.315,13200,18.233685,71,230,0.851851851851852
"4091",158477,"CENTENARY COLLEGE OF LOUISIANA",1,0,2000,229,152,77,99,33,66,0.434,0.432,0.429,14200,20.947129,73.5,198,0.864628820960699
"4092",158477,"CENTENARY COLLEGE OF LOUISIANA",1,0,2001,256,168,88,116,31,85,0.506,0.453,0.352,15400,23.987962,76,224,0.875
"4093",158477,"CENTENARY COLLEGE OF LOUISIANA",1,0,2002,272,163,109,122,42,80,0.491,0.449,0.385,16000,25.667817,73,227,0.834558823529412
"4094",158477,"CENTENARY COLLEGE OF LOUISIANA",1,0,2003,197,113,84,101,34,67,0.593,0.513,0.405,16750,26.958633,75,155,0.786802030456853
"4095",158477,"CENTENARY COLLEGE OF LOUISIANA",1,0,2004,282,190,92,145,42,103,0.542,0.514,0.457,16750,26.380855,71,245,0.868794326241135
"4096",158477,"Centenary College of Louisiana",1,0,2005,232,145,87,104,33,71,0.49,0.448,0.379,17750,27.133887,72,198,0.853448275862069
"4097",158477,"Centenary College of Louisiana",1,0,2006,241,136,105,104,45,59,0.434,0.432,0.429,18900,28.355601,73,196,0.813278008298755
"4098",158477,"Centenary College of Louisiana",1,0,2007,200,114,86,97,35,62,0.544,0.485,0.407,19850,30.497463,72,160,0.8
"4099",158477,"Centenary College of Louisiana",1,0,2008,246,148,98,104,41,63,0.426,0.423,0.418,20940,30.924609,71,202,0.821138211382114
"4100",158477,"Centenary College of Louisiana",1,0,2009,278,162,116,128,49,79,0.488,0.46,0.422,21790,31.656741,70,205,0.737410071942446
"4101",158477,"Centenary College of Louisiana",1,0,2010,192,104,88,81,29,52,0.5,0.422,0.33,22880,28.565495,67,131,0.682291666666667
"4102",159009,"GRAMBLING STATE UNIVERSITY",1,0,1991,1325,741,584,121,30,91,0.123,0.091,0.051,1802,59.068379,269,6,0.00452830188679245
"4103",159009,"GRAMBLING STATE UNIVERSITY",1,0,1992,1385,775,610,109,30,79,0.102,0.079,0.049,1788,63.570278,284,13,0.00938628158844765
"4104",159009,"GRAMBLING STATE UNIVERSITY",1,0,1993,1620,859,761,160,34,126,0.147,0.099,0.045,2088,64.521583,267,2,0.00123456790123457
"4105",159009,"GRAMBLING STATE UNIVERSITY",1,0,1995,1121,569,552,107,23,84,0.148,0.095,0.042,2088,71.629603,286,2,0.00178412132024978
"4106",159009,"GRAMBLING STATE UNIVERSITY",1,0,1996,1091,574,517,90,27,63,0.11,0.082,0.052,2112,77.417655,292,4,0.00366636113657195
"4107",159009,"GRAMBLING STATE UNIVERSITY",1,0,1997,799,408,391,52,25,27,0.066,0.065,0.064,2022,74.452783,311,0,0
"4108",159009,"GRAMBLING STATE UNIVERSITY",1,0,1998,771,359,412,71,23,48,0.134,0.092,0.056,2208,70.592746,263,1,0.0012970168612192
"4109",159009,"GRAMBLING STATE UNIVERSITY",1,0,1999,690,367,323,88,24,64,0.174,0.128,0.074,2301,68.16807,241,3,0.00434782608695652
"4110",159009,"GRAMBLING STATE UNIVERSITY",1,0,2000,908,513,395,182,46,136,0.265,0.2,0.116,2589,67.182413,242.5,9,0.00991189427312775
"4111",159009,"GRAMBLING STATE UNIVERSITY",1,0,2001,884,479,405,94,23,71,0.148,0.106,0.057,1900,71.249766,244,3,0.00339366515837104
"4112",159009,"GRAMBLING STATE UNIVERSITY",1,0,2002,850,430,420,107,44,63,0.147,0.126,0.105,1980,68.009334,241,2,0.00235294117647059
"4113",159009,"GRAMBLING STATE UNIVERSITY",1,0,2003,1022,570,452,124,29,95,0.167,0.121,0.064,2352,70.83721,246,12,0.0117416829745597
"4114",159009,"GRAMBLING STATE UNIVERSITY",1,0,2004,1132,675,457,115,33,82,0.122,0.102,0.072,2280,72.376406,244,10,0.0088339222614841
"4115",159009,"Grambling State University",1,0,2005,1129,568,561,82,22,60,0.106,0.073,0.039,2232,75.651516,251,7,0.00620017714791851
"4116",159009,"Grambling State University",1,0,2006,1119,609,510,108,33,75,0.123,0.097,0.065,2232,77.307201,248,4,0.00357462019660411
"4117",159009,"Grambling State University",1,0,2007,1184,610,574,83,24,59,0.097,0.07,0.042,2232,85.480797,249,8,0.00675675675675676
"4118",159009,"Grambling State University",1,0,2008,1203,626,577,144,53,91,0.145,0.12,0.092,2414,107.501469,258,7,0.0058187863674148
"4119",159009,"Grambling State University",1,0,2009,910,548,362,177,65,112,0.204,0.195,0.18,2606,102.069431,242,6,0.00659340659340659
"4120",159009,"Grambling State University",1,0,2010,706,384,322,183,63,120,0.312,0.259,0.196,3018,101.296351,238,5,0.00708215297450425
"4121",159391,"LOUISIANA ST UNIV & AGRL & MECH & HEBERT LAWS CTR",1,0,1991,3342,1779,1563,579,201,378,0.212,0.173,0.129,2058,402.616255,1494,2744,0.821065230400957
"4122",159391,"LOUISIANA ST UNIV & AGRL & MECH & HEBERT LAWS CTR",1,0,1992,3503,1884,1619,651,219,432,0.229,0.186,0.135,2173,416.055012,1510,2880,0.822152440765059
"4123",159391,"LOUISIANA ST UNIV & AGRL & MECH & HEBERT LAWS CTR",1,0,1993,3178,1697,1481,586,182,404,0.238,0.184,0.123,2625,421.506967,1439,2549,0.802076777847703
"4124",159391,"LOUISIANA ST UNIV & AGRL & MECH & HEBERT LAWS CTR",1,0,1995,3646,2007,1639,746,257,489,0.244,0.205,0.157,2663,447.351823,1453,2969,0.814317059791552
"4125",159391,"LOUISIANA ST UNIV & AGRL & MECH & HEBERT LAWS CTR",1,0,1996,3992,2169,1823,867,264,603,0.278,0.217,0.145,2687,465.612405,1456,3184,0.797595190380762
"4126",159391,"LOUISIANA STATE UNIV & AG & MECH & HEBERT LAWS CTR",1,0,1997,4443,2533,1910,959,319,640,0.253,0.216,0.167,2711,481.557155,1460,3504,0.788656313301823
"4127",159391,"LOUISIANA STATE UNIV & AG & MECH & HEBERT LAW CTR",1,0,1998,5066,2874,2192,1198,399,799,0.278,0.236,0.182,2871,499.492487,1515,4076,0.804579549940782
"4128",159391,"LOUISIANA STATE UNIV & AG & MECH & HEBERT LAWS CTR",1,0,1999,5173,2956,2217,1262,398,864,0.292,0.244,0.18,2301,532.801458,1528,4159,0.803982215348927
"4129",159391,"LOUISIANA STATE UNIV & AG & MECH & HEBERT LAWS CTR",1,0,2000,5072,2803,2269,1229,431,798,0.285,0.242,0.19,2551,586.972976,1401,4148,0.81782334384858
"4130",159391,"LOUISIANA STATE UNIV & AG & MECH & HEBERT LAWS CTR",1,0,2001,5214,2873,2341,1282,424,858,0.299,0.246,0.181,2551,608.757268,1274,4297,0.824127349443805
"4131",159391,"LOUISIANA STATE UNIV & AG & MECH & HEBERT LAWS CTR",1,0,2002,5170,2842,2328,1353,464,889,0.313,0.262,0.199,2635,628.609523,1274,4282,0.828239845261122
"4132",159391,"LOUISIANA STATE UNIV & AG & MECH & HEBERT LAWS CTR",1,0,2003,5359,2938,2421,1396,468,928,0.316,0.26,0.193,2739,670.293933,1279,4402,0.821421907072215
"4133",159391,"LOUISIANA STATE UNIV & AG & MECH & HEBERT LAWS CTR",1,0,2004,5692,3099,2593,1492,539,953,0.308,0.262,0.208,2855,715.812402,1276,4607,0.809381588193956
"4134",159391,"Louisiana State University and Agricultural & Mechanical College",1,0,2005,4966,2653,2313,1440,576,864,0.326,0.29,0.249,2981,780.277638,1277,4075,0.820579943616593
"4135",159391,"Louisiana State University and Agricultural & Mechanical College",1,0,2006,4503,2449,2054,1530,584,946,0.386,0.34,0.284,2981,818.646245,1241,3711,0.824117255163225
"4136",159391,"Louisiana State University and Agricultural & Mechanical College",1,0,2007,4585,2415,2170,1737,658,1079,0.447,0.379,0.303,2981,859.169719,1267,3741,0.815921483097056
"4137",159391,"Louisiana State University and Agricultural & Mechanical College",1,0,2008,5131,2781,2350,1900,699,1201,0.432,0.37,0.297,3215,981.805747,1319,4084,0.795946209315923
"4138",159391,"Louisiana State University and Agricultural & Mechanical College",1,0,2009,4776,2516,2260,1823,665,1158,0.46,0.382,0.294,3469,1021.2033,1305,3785,0.79250418760469
"4139",159391,"Louisiana State University and Agricultural & Mechanical College",1,0,2010,5477,2904,2573,2145,777,1368,0.471,0.392,0.302,3968,983.155299,1238,4257,0.777250319517984
"4140",159647,"LOUISIANA TECH UNIVERSITY",0,1,1991,1834,827,1007,278,108,170,0.206,0.152,0.107,1841,72.416998,397,1247,0.679934569247546
"4141",159647,"LOUISIANA TECH UNIVERSITY",0,1,1992,1473,703,770,264,86,178,0.253,0.179,0.112,1868,81.502453,407,1174,0.797012898845893
"4142",159647,"LOUISIANA TECHNICAL UNIVERSITY",0,1,1993,1411,672,739,258,96,162,0.241,0.183,0.13,2169,81.589648,389,1173,0.831325301204819
"4143",159647,"LOUISIANA TECH UNIVERSITY",0,1,1995,1278,598,680,281,103,178,0.298,0.22,0.151,2274,85.773899,381,1040,0.81377151799687
"4144",159647,"LOUISIANA TECH UNIVERSITY",0,1,1996,1279,618,661,330,133,197,0.319,0.258,0.201,2352,86.806191,371,1057,0.82642689601251
"4145",159647,"LOUISIANA TECH UNIVERSITY",0,1,1997,1428,714,714,361,133,228,0.319,0.253,0.186,2517,90.813109,363,1163,0.814425770308123
"4146",159647,"LOUISIANA TECH UNIVERSITY",0,1,1998,1621,794,827,449,178,271,0.341,0.277,0.215,2532,97.085473,366,1342,0.827884022208513
"4147",159647,"LOUISIANA TECH UNIVERSITY",0,1,1999,1753,840,913,478,199,279,0.332,0.273,0.218,2379,101.947266,369,1391,0.793496862521392
"4148",159647,"LOUISIANA TECH UNIVERSITY",0,1,2000,1795,819,976,480,222,258,0.315,0.267,0.227,2778,107.751352,371,1425,0.793871866295265
"4149",159647,"LOUISIANA TECH UNIVERSITY",0,1,2001,1770,850,920,481,211,270,0.318,0.272,0.229,2922,113.789791,373,1391,0.785875706214689
"4150",159647,"LOUISIANA TECH UNIVERSITY",0,1,2002,1936,947,989,500,202,298,0.315,0.258,0.204,2919,112.538383,389,1448,0.747933884297521
"4151",159647,"LOUISIANA TECH UNIVERSITY",0,1,2003,1948,958,990,485,190,295,0.308,0.249,0.192,3462,126.5833,397,1493,0.766427104722793
"4152",159647,"LOUISIANA TECH UNIVERSITY",0,1,2004,1644,730,914,432,189,243,0.333,0.263,0.207,3795,130.894709,394,1151,0.700121654501217
"4153",159647,"Louisiana Tech University",0,1,2005,1653,762,891,446,177,269,0.353,0.27,0.199,3951,129.180173,378,1304,0.78886872353297
"4154",159647,"Louisiana Tech University",0,1,2006,1625,753,872,426,185,241,0.32,0.262,0.212,4383,133.132174,380,1204,0.740923076923077
"4155",159647,"Louisiana Tech University",0,1,2007,1522,704,818,432,180,252,0.358,0.284,0.22,4458,142.498663,432,1193,0.783837056504599
"4156",159647,"Louisiana Tech University",0,1,2008,1503,695,808,428,187,241,0.347,0.285,0.231,4911,167.341326,434,1136,0.755821689953426
"4157",159647,"Louisiana Tech University",0,1,2009,1448,622,826,438,209,229,0.368,0.302,0.253,5091,174.236371,398,948,0.654696132596685
"4158",159647,"Louisiana Tech University",0,1,2010,1530,679,851,504,220,284,0.418,0.329,0.259,3640,162.388283,374,1116,0.729411764705882
"4159",159717,"MCNEESE STATE UNIVERSITY",1,0,1991,1253,652,601,83,23,60,0.092,0.066,0.038,1626,42.642616,314,1058,0.844373503591381
"4160",159717,"MCNEESE STATE UNIVERSITY",1,0,1992,1272,705,567,64,16,48,0.068,0.05,0.028,1626,44.260668,292,1062,0.834905660377358
"4161",159717,"MCNEESE STATE UNIVERSITY",1,0,1993,1307,702,605,66,13,53,0.076,0.05,0.021,1968,46.440636,290,1024,0.783473603672532
"4162",159717,"MCNEESE STATE UNIVERSITY",1,0,1995,1376,775,601,71,22,49,0.063,0.052,0.037,1998,50.049365,287,1067,0.775436046511628
"4163",159717,"MCNEESE STATE UNIVERSITY",1,0,1996,1357,750,607,105,24,81,0.108,0.077,0.04,1998,51.080909,286,1046,0.770817980840088
"4164",159717,"MCNEESE STATE UNIVERSITY",1,0,1997,1447,779,668,116,27,89,0.114,0.08,0.04,1998,53.591835,275,1118,0.772633033863165
"4165",159717,"MCNEESE STATE UNIVERSITY",1,0,1998,1433,802,631,141,35,106,0.132,0.098,0.055,2128,51.443083,281,1088,0.759246336357292
"4166",159717,"MCNEESE STATE UNIVERSITY",1,0,1999,1275,636,639,127,34,93,0.146,0.1,0.053,1650,52.580821,280,1016,0.796862745098039
"4167",159717,"MCNEESE STATE UNIVERSITY",1,0,2000,1320,767,553,110,31,79,0.103,0.083,0.056,1900,57.116375,277,1035,0.784090909090909
"4168",159717,"MCNEESE STATE UNIVERSITY",1,0,2001,1350,745,605,151,56,95,0.128,0.112,0.093,1900,60.757174,274,1077,0.797777777777778
"4169",159717,"MCNEESE STATE UNIVERSITY",1,0,2002,1358,762,596,179,67,112,0.147,0.132,0.112,1974,62.547103,282,1024,0.754050073637702
"4170",159717,"MCNEESE STATE UNIVERSITY",1,0,2003,1506,843,663,176,51,125,0.148,0.117,0.077,2050,65.884999,293,1076,0.714475431606906
"4171",159717,"MCNEESE STATE UNIVERSITY",1,0,2004,1603,923,680,196,61,135,0.146,0.122,0.09,2134,69.164853,300,1186,0.739862757330006
"4172",159717,"McNeese State University",1,0,2005,1311,743,568,177,52,125,0.168,0.135,0.092,2226,72.01912,305,982,0.749046529366896
"4173",159717,"McNeese State University",1,0,2006,1272,741,531,195,60,135,0.182,0.153,0.113,2226,74.83178,302,996,0.783018867924528
"4174",159717,"McNeese State University",1,0,2007,1247,717,530,163,55,108,0.151,0.131,0.104,2226,85.959155,315,920,0.737770649558941
"4175",159717,"McNeese State University",1,0,2008,1272,742,530,203,62,141,0.19,0.16,0.117,2386,105.955883,322,943,0.741352201257862
"4176",159717,"McNeese State University",1,0,2009,1221,728,493,256,83,173,0.238,0.21,0.168,2556,102.557391,307,927,0.759213759213759
"4177",159717,"McNeese State University",1,0,2010,1259,756,503,261,84,177,0.234,0.207,0.167,2916,98.882391,316,943,0.74900714853058
"4178",159966,"NICHOLLS STATE UNIVERSITY",1,0,1991,1204,698,506,57,13,44,0.063,0.047,0.026,1591,37.59075,274,996,0.827242524916944
"4179",159966,"NICHOLLS STATE UNIVERSITY",1,0,1992,1059,613,446,53,10,43,0.07,0.05,0.022,1661,40.253161,279,854,0.806421152030217
"4180",159966,"NICHOLLS STATE UNIVERSITY",1,0,1993,969,586,383,33,12,21,0.036,0.034,0.031,1981,40.783585,286,756,0.780185758513932
"4181",159966,"NICHOLLS STATE UNIVERSITY",1,0,1995,1170,672,498,76,19,57,0.085,0.065,0.038,2016,43.00556,280,866,0.74017094017094
"4182",159966,"NICHOLLS STATE UNIVERSITY",1,0,1996,1008,603,405,54,13,41,0.068,0.054,0.032,2016,43.907186,275,741,0.735119047619048
"4183",159966,"NICHOLLS STATE UNIVERSITY",1,0,1997,1075,646,429,81,14,67,0.104,0.075,0.033,2136,45.293075,274,760,0.706976744186047
"4184",159966,"NICHOLLS STATE UNIVERSITY",1,0,1998,1351,781,570,117,22,95,0.122,0.087,0.039,2136,47.393413,272,1009,0.746854182087343
"4185",159966,"NICHOLLS STATE UNIVERSITY",1,0,1999,1445,860,585,129,30,99,0.115,0.089,0.051,1645,52.621384,267,1109,0.767474048442907
"4186",159966,"NICHOLLS STATE UNIVERSITY",1,0,2000,1460,882,578,118,26,92,0.104,0.081,0.045,1895,52.758398,271,1075,0.736301369863014
"4187",159966,"NICHOLLS STATE UNIVERSITY",1,0,2001,1408,841,567,121,28,93,0.111,0.086,0.049,1895,53.939196,275,1007,0.715198863636364
"4188",159966,"NICHOLLS STATE UNIVERSITY",1,0,2002,1404,821,583,120,27,93,0.113,0.085,0.046,1967,52.194511,268,1000,0.712250712250712
"4189",159966,"NICHOLLS STATE UNIVERSITY",1,0,2003,1391,813,578,121,36,85,0.105,0.087,0.062,2045,55.551589,283,955,0.686556434219986
"4190",159966,"NICHOLLS STATE UNIVERSITY",1,0,2004,1574,939,635,146,44,102,0.109,0.093,0.069,2135,63.150731,285,1068,0.678526048284625
"4191",159966,"Nicholls State University",1,0,2005,1171,703,468,163,62,101,0.144,0.139,0.132,2231,64.729509,289,893,0.762596071733561
"4192",159966,"Nicholls State University",1,0,2006,1069,650,419,170,44,126,0.194,0.159,0.105,2231,66.003685,285,788,0.737137511693171
"4193",159966,"Nicholls State University",1,0,2007,1156,696,460,196,59,137,0.197,0.17,0.128,2231,70.273922,288,905,0.782871972318339
"4194",159966,"Nicholls State University",1,0,2008,1217,712,505,207,60,147,0.206,0.17,0.119,2411,90.863874,297,861,0.707477403451109
"4195",159966,"Nicholls State University",1,0,2009,1212,707,505,200,67,133,0.188,0.165,0.133,2603,95.568802,275,880,0.726072607260726
"4196",159966,"Nicholls State University",1,0,2010,1048,652,396,201,63,138,0.212,0.192,0.159,3024,89.883322,256,774,0.738549618320611
"4197",160038,"NORTHWESTERN STATE UNIVERSITY OF LOUISIANA",1,0,1991,1179,710,469,110,24,86,0.121,0.093,0.051,1771,39.464726,209,850,0.720949957591179
"4198",160038,"NORTHWESTERN STATE UNIVERSITY OF LOUISIANA",1,0,1992,1227,737,490,108,30,78,0.106,0.088,0.061,1771,43.274761,253,878,0.715566422167889
"4199",160038,"NORTHWESTERN STATE UNIVERSITY OF LOUISIANA",1,0,1993,1380,824,556,112,28,84,0.102,0.081,0.05,2071,48.842036,248,918,0.665217391304348
"4200",160038,"NORTHWESTERN STATE UNIVERSITY OF LOUISIANA",1,0,1995,1556,947,609,165,41,124,0.131,0.106,0.067,2067,54.445772,262,1023,0.65745501285347
"4201",160038,"NORTHWESTERN STATE UNIVERSITY OF LOUISIANA",1,0,1996,1480,891,589,22,5,17,0.019,0.015,0.008,2067,56.920091,265,942,0.636486486486487
"4202",160038,"NORTHWESTERN STATE UNIVERSITY OF LOUISIANA",1,0,1997,1415,878,537,129,35,94,0.107,0.091,0.065,2057,60.172585,277,857,0.60565371024735
"4203",160038,"NORTHWESTERN STATE UNIVERSITY OF LOUISIANA",1,0,1998,1364,857,507,157,43,114,0.133,0.115,0.085,2177,60.390222,257,808,0.592375366568915
"4204",160038,"NORTHWESTERN STATE UNIVERSITY OF LOUISIANA",1,0,1999,1656,988,668,184,71,113,0.114,0.111,0.106,2030,62.074813,316,1037,0.626207729468599
"4205",160038,"NORTHWESTERN STATE UNIVERSITY OF LOUISIANA",1,0,2000,1555,959,596,194,56,138,0.144,0.125,0.094,2086,66.182561,288.5,979,0.629581993569132
"4206",160038,"NORTHWESTERN STATE UNIVERSITY OF LOUISIANA",1,0,2001,1543,951,592,198,43,155,0.163,0.128,0.073,1970,69.657087,261,948,0.614387556707712
"4207",160038,"NORTHWESTERN STATE UNIVERSITY OF LOUISIANA",1,0,2002,1875,1093,782,216,80,136,0.124,0.115,0.102,1976,70.530094,274,993,0.5296
"4208",160038,"NORTHWESTERN STATE UNIVERSITY OF LOUISIANA",1,0,2003,1826,1117,709,227,71,156,0.14,0.124,0.1,2054,76.663032,287,961,0.526286966046002
"4209",160038,"NORTHWESTERN STATE UNIVERSITY OF LOUISIANA",1,0,2004,1793,1084,709,187,55,132,0.122,0.104,0.078,2144,83.058568,311,902,0.503067484662577
"4210",160038,"Northwestern State University of Louisiana",1,0,2005,1417,869,548,218,71,147,0.169,0.154,0.13,2240,86.177964,309,791,0.558221594918843
"4211",160038,"Northwestern State University of Louisiana",1,0,2006,1324,854,470,214,62,152,0.178,0.162,0.132,2240,84.292543,304,777,0.586858006042296
"4212",160038,"Northwestern State University of Louisiana",1,0,2007,1281,812,469,223,69,154,0.19,0.174,0.147,2240,90.264137,321,769,0.600312256049961
"4213",160038,"Northwestern State University of Louisiana",1,0,2008,1183,736,447,225,69,156,0.212,0.19,0.154,2412,112.123775,341,664,0.561284868977177
"4214",160038,"Northwestern State University of Louisiana",1,0,2009,1235,781,454,231,64,167,0.214,0.187,0.141,2594,114.857472,320,677,0.548178137651822
"4215",160038,"Northwestern State University of Louisiana",1,0,2010,1056,678,378,213,60,153,0.226,0.202,0.159,3002,106.544175,275,583,0.552083333333333
"4216",160612,"SOUTHEASTERN LOUISIANA UNIVERSITY",1,0,1991,1898,1075,823,53,9,44,0.041,0.028,0.011,1607,50.604031,341,1739,0.91622760800843
"4217",160612,"SOUTHEASTERN LOUISIANA UNIVERSITY",1,0,1992,2199,1285,914,86,21,65,0.051,0.039,0.023,1610,55.77877,372,1960,0.89131423374261
"4218",160612,"SOUTHEASTERN LOUISIANA UNIVERSITY",1,0,1993,2192,1222,970,77,19,58,0.048,0.035,0.02,1760,64.288431,389,1950,0.889598540145985
"4219",160612,"SOUTHEASTERN LOUISIANA UNIVERSITY",1,0,1995,2367,1387,980,94,21,73,0.053,0.04,0.021,2050,75.234286,432,2037,0.860583016476553
"4220",160612,"SOUTHEASTERN LOUISIANA UNIVERSITY",1,0,1996,2337,1273,1064,107,33,74,0.058,0.046,0.031,2050,78.116307,438,2014,0.861788617886179
"4221",160612,"SOUTHEASTERN LOUISIANA UNIVERSITY",1,0,1997,2487,1371,1116,107,24,83,0.06,0.043,0.022,2050,84.376714,437,2090,0.840369923602734
"4222",160612,"SOUTHEASTERN LOUISIANA UNIVERSITY",1,0,1998,2588,1471,1117,156,50,106,0.072,0.06,0.045,2150,90.724202,456,2148,0.829984544049459
"4223",160612,"SOUTHEASTERN LOUISIANA UNIVERSITY",1,0,1999,2315,1361,954,170,44,126,0.093,0.073,0.046,2210,92.675726,450,1910,0.825053995680346
"4224",160612,"SOUTHEASTERN LOUISIANA UNIVERSITY",1,0,2000,2220,1351,869,176,59,117,0.087,0.079,0.068,2490,100.131527,466.5,1839,0.828378378378378
"4225",160612,"SOUTHEASTERN LOUISIANA UNIVERSITY",1,0,2001,2007,1209,798,199,51,148,0.122,0.099,0.064,2607,104.076298,483,1657,0.825610363726956
"4226",160612,"SOUTHEASTERN LOUISIANA UNIVERSITY",1,0,2002,2382,1370,1012,168,49,119,0.087,0.071,0.048,2618,109.360179,479,1879,0.788832913518052
"4227",160612,"SOUTHEASTERN LOUISIANA UNIVERSITY",1,0,2003,2539,1451,1088,221,72,149,0.103,0.087,0.066,2951,123.689933,488,1933,0.761323355651831
"4228",160612,"SOUTHEASTERN LOUISIANA UNIVERSITY",1,0,2004,2137,1250,887,210,68,142,0.114,0.098,0.077,3191,147.069343,487,1700,0.795507721104352
"4229",160612,"Southeastern Louisiana University",1,0,2005,2228,1388,840,252,74,178,0.128,0.113,0.088,3341,140.949373,503,1689,0.758078994614004
"4230",160612,"Southeastern Louisiana University",1,0,2006,2665,1604,1061,320,93,227,0.142,0.12,0.088,2216,143.074532,508,1968,0.738461538461539
"4231",160612,"Southeastern Louisiana University",1,0,2007,2524,1458,1066,336,102,234,0.16,0.133,0.096,2216,149.634536,528,1895,0.750792393026941
"4232",160612,"Southeastern Louisiana University",1,0,2008,2613,1538,1075,358,112,246,0.16,0.137,0.104,2376,186.159005,540,1915,0.732874091083046
"4233",160612,"Southeastern Louisiana University",1,0,2009,2508,1497,1011,359,118,241,0.161,0.143,0.117,2546,189.496337,541,1851,0.738038277511962
"4234",160612,"Southeastern Louisiana University",1,0,2010,2414,1408,1006,408,133,275,0.195,0.169,0.132,2993,175.198883,477,1853,0.767605633802817
"4235",160621,"SOUTHERN UNIVERSITY AND A & M COL AT BATON ROUGE",1,0,1991,1907,985,922,59,10,49,0.05,0.031,0.011,1580,79.024501,471,23,0.0120608285264814
"4236",160621,"SOUTHERN UNIVERSITY AND A & M COL AT BATON ROUGE",1,0,1992,2033,1066,967,91,20,71,0.067,0.045,0.021,1588,85.73082,433,30,0.014756517461879
"4237",160621,"SOUTHERN UNIVERSITY AND A & M COLLEGE-BATON ROUGE",1,0,1993,1658,862,796,80,16,64,0.074,0.048,0.02,2028,89.627819,446,56,0.0337756332931242
"4238",160621,"SOUTHERN UNIVERSITY AND A & M COLLEGE",1,0,1995,1846,991,855,101,21,80,0.081,0.055,0.025,2028,100.635987,434,9,0.00487540628385699
"4239",160621,"SOUTHERN UNIVERSITY AND A & M COLLEGE",1,0,1996,1910,1041,869,129,24,105,0.101,0.068,0.028,2028,105.348239,469,10,0.00523560209424084
"4240",160621,"SOUTHERN UNIVERSITY AND A & M COLLEGE",1,0,1997,1853,997,856,106,28,78,0.078,0.057,0.033,2068,109.70344,451,12,0.00647598488936859
"4241",160621,"SOUTHERN UNIVERSITY AND A & M COLLEGE",1,0,1998,1715,911,804,110,25,85,0.093,0.064,0.031,2208,114.765492,460,6,0.00349854227405248
"4242",160621,"SOUTHERN UNIVERSITY AND A & M COLLEGE",1,0,1999,1287,693,594,86,19,67,0.097,0.067,0.032,2286,115.979191,465,4,0.00310800310800311
"4243",160621,"SOUTHERN UNIVERSITY AND A & M COLLEGE",1,0,2000,1766,996,770,2,2,0,0,0.001,0.003,2286,119.238226,439,7,0.00396375990939977
"4244",160621,"SOUTHERN UNIVERSITY AND A & M COLLEGE",1,0,2001,1206,690,516,75,14,61,0.088,0.062,0.027,2682,121.745121,413,9,0.00746268656716418
"4245",160621,"SOUTHERN UNIVERSITY AND A & M COLLEGE",1,0,2002,1176,673,503,77,14,63,0.094,0.065,0.028,2702,124.139614,425,7,0.00595238095238095
"4246",160621,"SOUTHERN UNIVERSITY AND A & M COLLEGE",1,0,2003,1351,782,569,77,16,61,0.078,0.057,0.028,3066,136.873368,436,11,0.00814211695040711
"4247",160621,"SOUTHERN UNIVERSITY AND A & M COLLEGE",1,0,2004,1575,931,644,115,30,85,0.091,0.073,0.047,3440,143.729476,420,6,0.00380952380952381
"4248",160621,"Southern University and A & M College",1,0,2005,1434,797,637,290,93,197,0.247,0.202,0.146,3592,156.441425,404,6,0.00418410041841004
"4249",160621,"Southern University and A & M College",1,0,2006,1136,659,477,132,33,99,0.15,0.116,0.069,3602,153.186768,446,2,0.00176056338028169
"4250",160621,"Southern University and A & M College",1,0,2007,1178,658,520,95,18,77,0.117,0.081,0.035,3666,161.780043,437,7,0.00594227504244482
"4251",160621,"Southern University and A & M College",1,0,2008,1034,605,429,62,19,43,0.071,0.06,0.044,3906,185.123526,434,10,0.00967117988394584
"4252",160621,"Southern University and A & M College",1,0,2009,992,539,453,96,31,65,0.121,0.097,0.068,4100,184.955867,373,18,0.0181451612903226
"4253",160621,"Southern University and A & M College",1,0,2010,852,488,364,60,18,42,0.086,0.07,0.049,4584,159.537048,379,15,0.0176056338028169
"4254",160658,"UNIVERSITY OF SOUTHWESTERN LOUISIANA",1,0,1991,2383,1300,1083,88,26,62,0.048,0.037,0.024,1568,98.149561,576,1705,0.715484683172472
"4255",160658,"UNIVERSITY OF SOUTHWESTERN LOUISIANA",1,0,1992,2563,1396,1167,77,25,52,0.037,0.03,0.021,1597,106.728592,582,1797,0.701131486539212
"4256",160658,"UNIVERSITY OF SOUTHWESTERN LOUISIANA",1,0,1993,2524,1378,1146,110,32,78,0.057,0.044,0.028,1897,114.463907,531,1787,0.708003169572108
"4257",160658,"UNIVERSITY OF SOUTHWESTERN LOUISIANA",1,0,1995,2609,1453,1156,110,24,86,0.059,0.042,0.021,1897,119.265206,563,1799,0.689536220774243
"4258",160658,"UNIVERSITY OF SOUTHWESTERN LOUISIANA",1,0,1996,2674,1461,1213,161,41,120,0.082,0.06,0.034,1885,122.114194,553,1801,0.673522812266268
"4259",160658,"UNIVERSITY OF SOUTHWESTERN LOUISIANA",1,0,1997,2764,1543,1221,169,44,125,0.081,0.061,0.036,1885,126.699897,545,1796,0.649782923299566
"4260",160658,"UNIVERSITY OF SOUTHWESTERN LOUISIANA",1,0,1998,2931,1621,1310,249,69,180,0.111,0.085,0.053,2010,134.499106,536,1962,0.669396110542477
"4261",160658,"UNIVERSITY OF LOUISIANA AT LAFAYETTE",1,0,1999,2402,1300,1102,298,94,204,0.157,0.124,0.085,2013,139.628632,525,1777,0.739800166527893
"4262",160658,"UNIVERSITY OF LOUISIANA AT LAFAYETTE",1,0,2000,2291,1302,989,314,103,211,0.162,0.137,0.104,2277,147.136143,527.5,1742,0.76036665211698
"4263",160658,"UNIVERSITY OF LOUISIANA AT LAFAYETTE",1,0,2001,2301,1306,995,322,93,229,0.175,0.14,0.093,2314,143.546632,530,1775,0.771403737505432
"4264",160658,"UNIVERSITY OF LOUISIANA AT LAFAYETTE",1,0,2002,2385,1326,1059,293,77,216,0.163,0.123,0.073,2386,145.622672,532,1817,0.761844863731656
"4265",160658,"UNIVERSITY OF LOUISIANA AT LAFAYETTE",1,0,2003,2576,1437,1139,333,86,247,0.172,0.129,0.076,2700,152.569481,536,1976,0.767080745341615
"4266",160658,"UNIVERSITY OF LOUISIANA AT LAFAYETTE",1,0,2004,2643,1517,1126,345,101,244,0.161,0.131,0.09,3228,158.339559,534,1974,0.746878547105562
"4267",160658,"University of Louisiana at Lafayette",1,0,2005,2730,1538,1192,329,102,227,0.148,0.121,0.086,3324,166.642568,531,2027,0.742490842490843
"4268",160658,"University of Louisiana at Lafayette",1,0,2006,2799,1604,1195,362,108,254,0.158,0.129,0.09,3382,173.090796,530,2053,0.733476241514827
"4269",160658,"University of Louisiana at Lafayette",1,0,2007,2691,1554,1137,361,111,250,0.161,0.134,0.098,3402,184.522052,576,2026,0.752879970271275
"4270",160658,"University of Louisiana at Lafayette",1,0,2008,2566,1435,1131,373,128,245,0.171,0.145,0.113,3574,235.166322,591,1927,0.750974279033515
"4271",160658,"University of Louisiana at Lafayette",1,0,2009,2553,1427,1126,373,126,247,0.173,0.146,0.112,4016,238.122102,600,1818,0.712103407755582
"4272",160658,"University of Louisiana-Lafayette",1,0,2010,2914,1629,1285,465,141,324,0.199,0.16,0.11,4426,239.919721,596,1997,0.685312285518188
"4273",161004,"BOWDOIN COLLEGE",1,0,1991,398,185,213,341,182,159,0.86,0.857,0.854,16070,49.809495,123,335,0.841708542713568
"4274",161004,"BOWDOIN COLLEGE",1,0,1992,409,224,185,347,154,193,0.862,0.848,0.832,17035,45.96,122,350,0.855745721271394
"4275",161004,"BOWDOIN COLLEGE",1,0,1993,418,218,200,356,163,193,0.885,0.852,0.815,18300,48.907,123,347,0.830143540669856
"4276",161004,"BOWDOIN COLLEGE",1,0,1995,446,225,221,369,180,189,0.84,0.827,0.814,20555,55.658,131,328,0.73542600896861
"4277",161004,"BOWDOIN COLLEGE",1,0,1996,443,223,220,369,175,194,0.87,0.833,0.795,21750,59.698,131,374,0.844243792325056
"4278",161004,"BOWDOIN COLLEGE",1,0,1997,473,246,227,384,175,209,0.85,0.812,0.771,22460,55.583,137,314,0.66384778012685
"4279",161004,"BOWDOIN COLLEGE",1,0,1998,433,213,220,361,181,180,0.845,0.834,0.823,23895,60.746,140,352,0.812933025404157
"4280",161004,"BOWDOIN COLLEGE",1,0,1999,464,259,205,418,183,235,0.907,0.901,0.893,24435,67.789,146,389,0.838362068965517
"4281",161004,"BOWDOIN COLLEGE",1,0,2000,452,221,231,379,188,191,0.864,0.838,0.814,25345,74.768,148.5,347,0.767699115044248
"4282",161004,"BOWDOIN COLLEGE",1,0,2001,452,228,224,374,191,183,0.803,0.827,0.853,26700,84.034,151,344,0.761061946902655
"4283",161004,"BOWDOIN COLLEGE",1,0,2002,457,237,220,384,196,188,0.793,0.84,0.891,28070,89.873,165,321,0.702407002188184
"4284",161004,"BOWDOIN COLLEGE",1,0,2003,464,236,228,412,202,210,0.89,0.888,0.886,29470,89.673,168,333,0.717672413793103
"4285",161004,"BOWDOIN COLLEGE",1,0,2004,470,235,235,421,212,209,0.889,0.896,0.902,30944,91.847,152,312,0.663829787234043
"4286",161004,"Bowdoin College",1,0,2005,477,257,220,420,189,231,0.899,0.881,0.859,32650,96.269,177,327,0.685534591194969
"4287",161004,"Bowdoin College",1,0,2006,474,253,221,430,193,237,0.937,0.907,0.873,34280,103.618,172,334,0.704641350210971
"4288",161004,"Bowdoin College",1,0,2007,475,250,225,416,196,220,0.88,0.876,0.871,35990,109.074,185,314,0.661052631578947
"4289",161004,"Bowdoin College",1,0,2008,488,232,256,420,203,217,0.935,0.861,0.793,37790,117.198,199,312,0.639344262295082
"4290",161004,"Bowdoin College",1,0,2009,493,253,240,422,200,222,0.878,0.856,0.833,39605,121.979,198,320,0.649087221095335
"4291",161004,"Bowdoin College",1,0,2010,507,249,258,453,230,223,0.896,0.893,0.891,41150,122.241,204,320,0.631163708086785
"4292",161226,"UNIVERSITY OF MAINE AT FARMINGTON",1,0,1991,457,337,120,157,30,127,0.377,0.344,0.25,2340,21.609197,95,444,0.971553610503282
"4293",161226,"UNIVERSITY OF MAINE AT FARMINGTON",1,0,1992,441,302,139,126,31,95,0.315,0.286,0.223,2670,22.158523,105,423,0.959183673469388
"4294",161226,"UNIVERSITY OF MAINE AT FARMINGTON",1,0,1993,419,317,102,169,24,145,0.457,0.403,0.235,2910,22.29374,101,408,0.973747016706444
"4295",161226,"UNIVERSITY OF MAINE AT FARMINGTON",1,0,1995,473,335,138,153,35,118,0.352,0.323,0.254,3220,23.850591,105,451,0.953488372093023
"4296",161226,"UNIVERSITY OF MAINE AT FARMINGTON",1,0,1996,477,332,145,147,32,115,0.346,0.308,0.221,3370,24.554484,99,435,0.911949685534591
"4297",161226,"UNIVERSITY OF MAINE AT FARMINGTON",1,0,1997,466,308,158,148,28,120,0.39,0.318,0.177,3520,26.334493,96,440,0.944206008583691
"4298",161226,"UNIVERSITY OF MAINE AT FARMINGTON",1,0,1998,484,333,151,155,41,114,0.342,0.32,0.272,3686,26.558577,98,435,0.898760330578512
"4299",161226,"UNIVERSITY OF MAINE AT FARMINGTON",1,0,1999,470,344,126,197,48,149,0.433,0.419,0.381,3390,28.975837,103,368,0.782978723404255
"4300",161226,"UNIVERSITY OF MAINE AT FARMINGTON",1,0,2000,475,329,146,176,40,136,0.413,0.371,0.274,3540,30.376972,107,412,0.867368421052632
"4301",161226,"UNIVERSITY OF MAINE AT FARMINGTON",1,0,2001,479,323,156,174,45,129,0.399,0.363,0.288,3735,32.50936,111,423,0.883089770354906
"4302",161226,"UNIVERSITY OF MAINE AT FARMINGTON",1,0,2002,453,295,158,156,40,116,0.393,0.344,0.253,3990,31.402,111,437,0.964679911699779
"4303",161226,"UNIVERSITY OF MAINE AT FARMINGTON",1,0,2003,482,339,143,221,59,162,0.478,0.459,0.413,4290,32.212,102,454,0.941908713692946
"4304",161226,"UNIVERSITY OF MAINE AT FARMINGTON",1,0,2004,510,342,168,196,46,150,0.439,0.384,0.274,4650,34.167,102,494,0.968627450980392
"4305",161226,"University of Maine at Farmington",1,0,2005,559,387,172,229,60,169,0.437,0.41,0.349,5010,35.36,102,334,0.597495527728086
"4306",161226,"University of Maine at Farmington",1,0,2006,511,351,160,209,49,160,0.456,0.409,0.306,5824,37.606,130,454,0.888454011741683
"4307",161226,"University of Maine at Farmington",1,0,2007,479,327,152,181,45,136,0.416,0.378,0.296,6528,39.111,129,432,0.90187891440501
"4308",161226,"University of Maine at Farmington",1,0,2008,512,335,177,184,47,137,0.409,0.359,0.266,7296,41.437,123,431,0.841796875
"4309",161226,"University of Maine at Farmington",1,0,2009,487,312,175,210,64,146,0.468,0.431,0.366,7712,43.09,120,427,0.876796714579055
"4310",161226,"University of Maine at Farmington",1,0,2010,555,352,203,242,68,174,0.494,0.436,0.335,8032,43.013,120,488,0.879279279279279
"4311",161235,"UNIVERSITY OF MAINE AT FORT KENT",1,0,1991,86,53,33,11,3,8,0.151,0.128,0.091,2250,5.376767,28,65,0.755813953488372
"4312",161235,"UNIVERSITY OF MAINE AT FORT KENT",1,0,1992,97,43,54,8,3,5,0.116,0.082,0.056,2580,5.547817,31,95,0.979381443298969
"4313",161235,"UNIVERSITY OF MAINE AT FORT KENT",1,0,1993,81,46,35,6,0,6,0.13,0.074,0,2760,5.939786,33,81,1
"4314",161235,"UNIVERSITY OF MAINE AT FORT KENT",1,0,1995,74,34,40,6,2,4,0.118,0.081,0.05,2930,6.050798,33,72,0.972972972972973
"4315",161235,"UNIVERSITY OF MAINE AT FORT KENT",1,0,1996,84,49,35,9,1,8,0.163,0.107,0.029,2990,5.865832,30,82,0.976190476190476
"4316",161235,"UNIVERSITY OF MAINE AT FORT KENT",1,0,1997,77,47,30,5,0,5,0.106,0.065,0,3140,6.712218,33,77,1
"4317",161235,"UNIVERSITY OF MAINE AT FORT KENT",1,0,1998,93,40,53,9,1,8,0.2,0.097,0.019,3284,6.497048,30,24,0.258064516129032
"4318",161235,"UNIVERSITY OF MAINE AT FORT KENT",1,0,1999,109,64,45,17,3,14,0.219,0.156,0.067,3090,7.153876,30,19,0.174311926605505
"4319",161235,"UNIVERSITY OF MAINE AT FORT KENT",1,0,2000,82,38,44,4,1,3,0.079,0.049,0.023,3150,8.396205,32,80,0.975609756097561
"4320",161235,"UNIVERSITY OF MAINE AT FORT KENT",1,0,2001,99,49,50,24,8,16,0.326,0.242,0.16,3270,9.053341,34,89,0.898989898989899
"4321",161235,"UNIVERSITY OF MAINE AT FORT KENT",1,0,2002,130,61,69,30,15,15,0.246,0.231,0.217,3420,10.456,35,119,0.915384615384615
"4322",161235,"UNIVERSITY OF MAINE AT FORT KENT",1,0,2003,126,62,64,19,4,15,0.242,0.151,0.062,3690,11.042,30,112,0.888888888888889
"4323",161235,"UNIVERSITY OF MAINE AT FORT KENT",1,0,2004,166,85,81,17,2,15,0.176,0.102,0.025,3960,10.443,33,157,0.94578313253012
"4324",161235,"University of Maine at Fort Kent",1,0,2005,129,69,60,22,9,13,0.188,0.171,0.15,4290,11.993,36,121,0.937984496124031
"4325",161235,"University of Maine at Fort Kent",1,0,2006,116,67,49,2,1,1,0.015,0.017,0.02,4650,12.554,41,106,0.913793103448276
"4326",161235,"University of Maine at Fort Kent",1,0,2007,110,60,50,36,18,18,0.3,0.327,0.36,5100,13.545,41,89,0.809090909090909
"4327",161235,"University of Maine at Fort Kent",1,0,2008,111,60,51,27,14,13,0.217,0.243,0.275,5700,14.48,38,91,0.81981981981982
"4328",161235,"University of Maine at Fort Kent",1,0,2009,118,69,49,20,5,15,0.217,0.169,0.102,6030,14.442,36,101,0.855932203389831
"4329",161235,"University of Maine at Fort Kent",1,0,2010,153,94,59,27,6,21,0.223,0.176,0.102,6330,14.002,35,139,0.908496732026144
"4330",161244,"UNIVERSITY OF MAINE AT MACHIAS",1,0,1991,146,91,55,11,4,7,0.077,0.075,0.073,2275,7.544089,41,139,0.952054794520548
"4331",161244,"UNIVERSITY OF MAINE AT MACHIAS",1,0,1992,139,98,41,12,3,9,0.092,0.086,0.073,2605,7.883451,42,119,0.856115107913669
"4332",161244,"UNIVERSITY OF MAINE AT MACHIAS",1,0,1993,133,84,49,10,6,4,0.048,0.075,0.122,2785,8.087405,39,115,0.864661654135338
"4333",161244,"UNIVERSITY OF MAINE AT MACHIAS",1,0,1995,129,73,56,10,5,5,0.068,0.078,0.089,2935,8.6469,36,121,0.937984496124031
"4334",161244,"UNIVERSITY OF MAINE AT MACHIAS",1,0,1996,143,86,57,9,3,6,0.07,0.063,0.053,3035,8.529142,37,123,0.86013986013986
"4335",161244,"UNIVERSITY OF MAINE AT MACHIAS",1,0,1997,121,63,58,9,3,6,0.095,0.074,0.052,3225,9.451005,41,107,0.884297520661157
"4336",161244,"UNIVERSITY OF MAINE AT MACHIAS",1,0,1998,148,95,53,8,2,6,0.063,0.054,0.038,3345,10.014973,38,135,0.912162162162162
"4337",161244,"UNIVERSITY OF MAINE AT MACHIAS",1,0,1999,121,83,38,15,4,11,0.132,0.124,0.105,3090,10.128015,33,112,0.925619834710744
"4338",161244,"UNIVERSITY OF MAINE AT MACHIAS",1,0,2000,127,85,42,13,4,9,0.106,0.102,0.095,3150,9.809702,34.5,116,0.913385826771654
"4339",161244,"UNIVERSITY OF MAINE AT MACHIAS",1,0,2001,155,105,50,32,6,26,0.248,0.206,0.12,3270,10.024383,36,130,0.838709677419355
"4340",161244,"UNIVERSITY OF MAINE AT MACHIAS",1,0,2002,132,81,51,19,9,10,0.124,0.144,0.176,3420,10.103,35,124,0.939393939393939
"4341",161244,"UNIVERSITY OF MAINE AT MACHIAS",1,0,2003,142,92,50,17,1,16,0.174,0.12,0.02,3636,10.97,30,120,0.845070422535211
"4342",161244,"UNIVERSITY OF MAINE AT MACHIAS",1,0,2004,80,54,26,14,3,11,0.204,0.175,0.115,3960,11.172,29,71,0.8875
"4343",161244,"University of Maine at Machias",1,0,2005,106,71,35,17,5,12,0.169,0.16,0.143,4290,10.761,30,92,0.867924528301887
"4344",161244,"University of Maine at Machias",1,0,2006,99,59,40,10,6,4,0.068,0.101,0.15,4650,11.051,30,96,0.96969696969697
"4345",161244,"University of Maine at Machias",1,0,2007,110,72,38,15,6,9,0.125,0.136,0.158,5100,11.636,33,100,0.909090909090909
"4346",161244,"University of Maine at Machias",1,0,2008,105,62,43,23,8,15,0.242,0.219,0.186,5700,12.573,33,91,0.866666666666667
"4347",161244,"University of Maine at Machias",1,0,2009,101,67,34,16,4,12,0.179,0.158,0.118,6030,12.675,31,83,0.821782178217822
"4348",161244,"University of Maine at Machias",1,0,2010,105,61,44,18,6,12,0.197,0.171,0.136,6330,12.744,31,83,0.79047619047619
"4349",161253,"UNIVERSITY OF MAINE AT ORONO",1,0,1991,1589,710,879,324,140,184,0.259,0.204,0.159,2718,169.349026,468,1513,0.95217117684078
"4350",161253,"UNIVERSITY OF MAINE",1,0,1992,1413,630,783,293,128,165,0.262,0.207,0.163,3086,169.343619,446,1317,0.932059447983015
"4351",161253,"UNIVERSITY OF MAINE",1,0,1993,1211,522,689,320,131,189,0.362,0.264,0.19,3406,171.50794,452,1144,0.94467382328654
"4352",161253,"UNIVERSITY OF MAINE",1,0,1995,1118,526,592,322,148,174,0.331,0.288,0.25,3925,181.078683,397,1054,0.942754919499106
"4353",161253,"UNIVERSITY OF MAINE",1,0,1996,1264,549,715,340,156,184,0.335,0.269,0.218,4139,180.390423,380,1186,0.938291139240506
"4354",161253,"UNIVERSITY OF MAINE",1,0,1997,1091,513,578,327,144,183,0.357,0.3,0.249,4339,185.363419,370,1008,0.923923006416132
"4355",161253,"UNIVERSITY OF MAINE",1,0,1998,1342,671,671,418,165,253,0.377,0.311,0.246,4551,186.516142,347,1248,0.929955290611028
"4356",161253,"UNIVERSITY OF MAINE",1,0,1999,1521,718,803,430,176,254,0.354,0.283,0.219,3960,203.938082,361,1411,0.927679158448389
"4357",161253,"UNIVERSITY OF MAINE",1,0,2000,1589,781,808,536,222,314,0.402,0.337,0.275,4050,221.07342,376.5,1507,0.948395217117684
"4358",161253,"UNIVERSITY OF MAINE",1,0,2001,1545,737,808,495,214,281,0.381,0.32,0.265,5116,236.826534,392,1436,0.929449838187702
"4359",161253,"UNIVERSITY OF MAINE",1,0,2002,1651,808,843,554,246,308,0.381,0.336,0.292,4380,247.778,393,1552,0.940036341611145
"4360",161253,"UNIVERSITY OF MAINE",1,0,2003,1599,812,787,538,235,303,0.373,0.336,0.299,4710,260.322,380,1399,0.874921826141338
"4361",161253,"UNIVERSITY OF MAINE",1,0,2004,1607,777,830,550,236,314,0.404,0.342,0.284,5040,271.282,369,1414,0.879900435594275
"4362",161253,"University of Maine",1,0,2005,1703,842,861,615,262,353,0.419,0.361,0.304,5520,280.032,372,1513,0.888432178508514
"4363",161253,"University of Maine",1,0,2006,1807,875,932,648,296,352,0.402,0.359,0.318,5970,289.288,398,1692,0.936358605423354
"4364",161253,"University of Maine",1,0,2007,1816,863,953,648,301,347,0.402,0.357,0.316,6540,293.588,632,1583,0.871696035242291
"4365",161253,"University of Maine",1,0,2008,1931,947,984,717,320,397,0.419,0.371,0.325,7170,316.237,635,1634,0.846193682030036
"4366",161253,"University of Maine",1,0,2009,1654,756,898,550,288,262,0.347,0.333,0.321,7590,326.441,602,1399,0.845828295042322
"4367",161253,"University of Maine",1,0,2010,1713,828,885,622,283,339,0.409,0.363,0.32,8010,326.575,589,1447,0.844716870986573
"4368",161554,"UNIVERSITY OF SOUTHERN MAINE",1,0,1991,763,419,344,68,23,45,0.107,0.089,0.067,2454,73.568548,306,737,0.965923984272608
"4369",161554,"UNIVERSITY OF SOUTHERN MAINE",1,0,1992,682,365,317,51,17,34,0.093,0.075,0.054,2814,77.227596,298,659,0.966275659824047
"4370",161554,"UNIVERSITY OF SOUTHERN MAINE",1,0,1993,732,390,342,48,18,30,0.077,0.066,0.053,3054,79.300884,291,699,0.954918032786885
"4371",161554,"UNIVERSITY OF SOUTHERN MAINE",1,0,1995,620,358,262,66,23,43,0.12,0.106,0.088,3500,88.358164,305,606,0.97741935483871
"4372",161554,"UNIVERSITY OF SOUTHERN MAINE",1,0,1996,683,383,300,56,17,39,0.102,0.082,0.057,3710,94.121783,315,664,0.972181551976574
"4373",161554,"UNIVERSITY OF SOUTHERN MAINE",1,0,1997,760,450,310,90,31,59,0.131,0.118,0.1,3938,98.724365,313,732,0.963157894736842
"4374",161554,"UNIVERSITY OF SOUTHERN MAINE",1,0,1998,789,463,326,66,18,48,0.104,0.084,0.055,4102,103.403079,307,765,0.96958174904943
"4375",161554,"UNIVERSITY OF SOUTHERN MAINE",1,0,1999,815,477,338,96,24,72,0.151,0.118,0.071,3630,111.190096,293,777,0.953374233128834
"4376",161554,"UNIVERSITY OF SOUTHERN MAINE",1,0,2000,855,489,366,81,21,60,0.123,0.095,0.057,3720,118.491746,324.5,825,0.964912280701754
"4377",161554,"UNIVERSITY OF SOUTHERN MAINE",1,0,2001,922,538,384,93,26,67,0.124,0.101,0.068,3855,130.293713,356,897,0.972885032537961
"4378",161554,"UNIVERSITY OF SOUTHERN MAINE",1,0,2002,895,519,376,118,39,79,0.152,0.132,0.104,4020,136.107,352,863,0.964245810055866
"4379",161554,"UNIVERSITY OF SOUTHERN MAINE",1,0,2003,851,496,355,106,24,82,0.165,0.125,0.068,4320,151.264,339,816,0.958871915393655
"4380",161554,"UNIVERSITY OF SOUTHERN MAINE",1,0,2004,871,524,347,146,39,107,0.204,0.168,0.112,4620,161.068,334,793,0.91044776119403
"4381",161554,"University of Southern Maine",1,0,2005,911,518,393,88,31,57,0.11,0.097,0.079,4980,162.202,344,622,0.682766190998902
"4382",161554,"University of Southern Maine",1,0,2006,888,511,377,84,25,59,0.116,0.095,0.066,5400,170.428,385,830,0.934684684684685
"4383",161554,"University of Southern Maine",1,0,2007,900,499,401,87,32,55,0.11,0.097,0.08,5940,181.355,384,738,0.82
"4384",161554,"University of Southern Maine",1,0,2008,991,531,460,126,53,73,0.138,0.127,0.115,6540,185.794,372,811,0.818365287588295
"4385",161554,"University of Southern Maine",1,0,2009,825,447,378,107,27,80,0.179,0.13,0.071,6930,183.6,345,685,0.83030303030303
"4386",161554,"University of Southern Maine",1,0,2010,763,394,369,104,43,61,0.155,0.136,0.117,7260,181.629,355,632,0.828309305373526
"4387",162007,"BOWIE STATE UNIVERSITY",1,0,1991,310,189,121,37,7,30,0.159,0.119,0.058,2254,31.612733,117,20,0.0645161290322581
"4388",162007,"BOWIE STATE UNIVERSITY",1,0,1992,329,199,130,35,6,29,0.146,0.106,0.046,2514,31.378087,126,15,0.0455927051671733
"4389",162007,"BOWIE STATE UNIVERSITY",1,0,1993,257,152,105,30,9,21,0.138,0.117,0.086,2736,32.361288,127,6,0.0233463035019455
"4390",162007,"BOWIE STATE UNIVERSITY",1,0,1995,435,260,175,62,11,51,0.196,0.143,0.063,3019,37.072473,146,22,0.0505747126436782
"4391",162007,"BOWIE STATE UNIVERSITY",1,0,1996,301,169,132,41,9,32,0.189,0.136,0.068,3103,40.030002,139,21,0.0697674418604651
"4392",162007,"BOWIE STATE UNIVERSITY",1,0,1997,357,190,167,44,8,36,0.19,0.123,0.048,3357,40.495295,137,18,0.0504201680672269
"4393",162007,"BOWIE STATE UNIVERSITY",1,0,1998,418,225,193,49,7,42,0.187,0.117,0.036,3467,43.430478,159,23,0.0550239234449761
"4394",162007,"BOWIE STATE UNIVERSITY",1,0,1999,343,189,154,45,12,33,0.175,0.131,0.078,2828,45.038693,155,23,0.0670553935860058
"4395",162007,"BOWIE STATE UNIVERSITY",1,0,2000,361,195,166,47,13,34,0.174,0.13,0.078,2940,49.713511,152,10,0.0277008310249307
"4396",162007,"BOWIE STATE UNIVERSITY",1,0,2001,594,356,238,89,21,68,0.191,0.15,0.088,2941,54.761142,149,12,0.0202020202020202
"4397",162007,"BOWIE STATE UNIVERSITY",1,0,2002,566,352,214,102,24,78,0.222,0.18,0.112,3102,53.069509,145,15,0.0265017667844523
"4398",162007,"BOWIE STATE UNIVERSITY",1,0,2003,762,479,283,98,18,80,0.167,0.129,0.064,3551,64.881484,164,18,0.0236220472440945
"4399",162007,"BOWIE STATE UNIVERSITY",1,0,2004,627,408,219,94,16,78,0.191,0.15,0.073,4047,66.949947,191,18,0.0287081339712919
"4400",162007,"Bowie State University",1,0,2005,923,567,356,203,53,150,0.265,0.22,0.149,4286,65.028604,192,21,0.0227518959913326
"4401",162007,"Bowie State University",1,0,2006,765,475,290,83,20,63,0.133,0.108,0.069,4286,69.351088,206,6,0.00784313725490196
"4402",162007,"Bowie State University",1,0,2007,820,506,314,106,19,87,0.172,0.129,0.061,4286,72.755856,215,10,0.0121951219512195
"4403",162007,"Bowie State University",1,0,2008,664,393,271,52,12,40,0.102,0.078,0.044,4286,77.055585,219,11,0.016566265060241
"4404",162007,"Bowie State University",1,0,2009,635,401,234,71,18,53,0.132,0.112,0.077,4286,80.328685,230,8,0.0125984251968504
"4405",162007,"Bowie State University",1,0,2010,608,353,255,73,17,56,0.159,0.12,0.067,4415,83.351564,229,9,0.0148026315789474
"4406",162210,"COLUMBIA UNION COLLEGE",1,0,1991,78,45,33,19,6,13,0.289,0.244,0.182,8200,13.405469,50,39,0.5
"4407",162210,"COLUMBIA UNION COLLEGE",1,0,1992,69,46,23,12,1,11,0.239,0.174,0.043,9180,14.25171,45,24,0.347826086956522
"4408",162210,"COLUMBIA UNION COLLEGE",1,0,1993,94,52,42,17,7,10,0.192,0.181,0.167,9500,13.1073,42,27,0.287234042553192
"4409",162210,"COLUMBIA UNION COLLEGE",1,0,1995,137,84,53,24,9,15,0.179,0.175,0.17,10775,13.715591,57,82,0.598540145985402
"4410",162210,"COLUMBIA UNION COLLEGE",1,0,1996,154,79,75,20,6,14,0.177,0.13,0.08,11240,15.57186,50,52,0.337662337662338
"4411",162210,"COLUMBIA UNION COLLEGE",1,0,1997,164,99,65,34,11,23,0.232,0.207,0.169,11790,16.624842,45,67,0.408536585365854
"4412",162210,"COLUMBIA UNION COLLEGE",1,0,1998,140,67,73,17,7,10,0.149,0.121,0.096,12275,16.823254,51,64,0.457142857142857
"4413",162210,"COLUMBIA UNION COLLEGE",1,0,1999,175,115,60,25,6,19,0.165,0.143,0.1,12200,18.312327,43,63,0.36
"4414",162210,"COLUMBIA UNION COLLEGE",1,0,2000,158,89,69,22,4,18,0.202,0.139,0.058,12810,18.707489,46,41,0.259493670886076
"4415",162210,"COLUMBIA UNION COLLEGE",1,0,2001,153,95,58,26,3,23,0.242,0.17,0.052,13450,23.069466,49,52,0.339869281045752
"4416",162210,"COLUMBIA UNION COLLEGE",1,0,2002,176,104,72,17,2,15,0.144,0.097,0.028,13998,24.668715,55,36,0.204545454545455
"4417",162210,"COLUMBIA UNION COLLEGE",1,0,2003,187,120,67,24,6,18,0.15,0.128,0.09,14698,27.516444,54,30,0.160427807486631
"4418",162210,"COLUMBIA UNION COLLEGE",1,0,2004,208,130,78,26,4,22,0.169,0.125,0.051,15433,29.09297,52,37,0.177884615384615
"4419",162210,"Columbia Union College",1,0,2005,172,113,59,23,9,14,0.124,0.134,0.153,16514,29.499724,54,23,0.133720930232558
"4420",162210,"Columbia Union College",1,0,2006,144,84,60,18,5,13,0.155,0.125,0.083,17339,23.808817,50,23,0.159722222222222
"4421",162210,"Columbia Union College",1,0,2007,126,83,43,22,5,17,0.205,0.175,0.116,18200,22.047652,51,17,0.134920634920635
"4422",162210,"Columbia Union College",1,0,2008,98,61,37,16,4,12,0.197,0.163,0.108,18200,23.988467,48,9,0.0918367346938776
"4423",162210,"Washington Adventist University",1,0,2009,144,83,61,21,7,14,0.169,0.146,0.115,18200,23.384169,44,16,0.111111111111111
"4424",162210,"Washington Adventist University",1,0,2010,123,83,40,21,2,19,0.229,0.171,0.05,18900,25.457776,48,19,0.154471544715447
"4425",162283,"COPPIN STATE COLLEGE",1,0,1991,311,195,116,29,6,23,0.118,0.093,0.052,2281,23.457342,105,19,0.0610932475884244
"4426",162283,"COPPIN STATE COLLEGE",1,0,1992,350,183,167,14,1,13,0.071,0.04,0.006,2533,22.521129,101,12,0.0342857142857143
"4427",162283,"COPPIN STATE COLLEGE",1,0,1993,500,264,236,26,6,20,0.076,0.052,0.025,2605,25.009587,104,33,0.066
"4428",162283,"COPPIN STATE COLLEGE",1,0,1995,439,303,136,31,8,23,0.076,0.071,0.059,2749,28.776637,106,1,0.00227790432801822
"4429",162283,"COPPIN STATE COLLEGE",1,0,1996,513,357,156,33,11,22,0.062,0.064,0.071,2867,29.565063,110,8,0.0155945419103314
"4430",162283,"COPPIN STATE COLLEGE",1,0,1997,382,268,114,17,3,14,0.052,0.045,0.026,3012,33.952846,110,7,0.0183246073298429
"4431",162283,"COPPIN STATE COLLEGE",1,0,1998,457,337,120,32,10,22,0.065,0.07,0.083,3164,34.934968,114,7,0.0153172866520788
"4432",162283,"COPPIN STATE COLLEGE",1,0,1999,441,306,135,39,12,27,0.088,0.088,0.089,3261,36.673056,113,2,0.00453514739229025
"4433",162283,"COPPIN STATE COLLEGE",1,0,2000,417,289,128,20,4,16,0.055,0.048,0.031,2503,38.595683,110,1,0.00239808153477218
"4434",162283,"COPPIN STATE COLLEGE",1,0,2001,540,384,156,36,4,32,0.083,0.067,0.026,2856,42.771652,107,4,0.00740740740740741
"4435",162283,"COPPIN STATE COLLEGE",1,0,2002,578,430,148,30,3,27,0.063,0.052,0.02,2877,48.274027,115,1,0.00173010380622837
"4436",162283,"COPPIN STATE COLLEGE",1,0,2003,571,432,139,29,9,20,0.046,0.051,0.065,3142,47.508124,125,4,0.00700525394045534
"4437",162283,"COPPIN STATE UNIVERSITY",1,0,2004,588,446,142,27,5,22,0.049,0.046,0.035,3330,47.455002,130,2,0.00340136054421769
"4438",162283,"Coppin State University",1,0,2005,661,502,159,24,4,20,0.04,0.036,0.025,4530,58.408,131,0,0
"4439",162283,"Coppin State University",1,0,2006,494,390,104,28,3,25,0.064,0.057,0.029,3527,54.766468,133,2,0.00404858299595142
"4440",162283,"Coppin State University",1,0,2007,555,421,134,23,9,14,0.033,0.041,0.067,3527,68.167736,143,0,0
"4441",162283,"Coppin State University",1,0,2008,570,428,142,28,6,22,0.051,0.049,0.042,3527,64.786192,162,0,0
"4442",162283,"Coppin State University",1,0,2009,541,392,149,29,2,27,0.069,0.054,0.013,3527,73.13583,158,1,0.00184842883548983
"4443",162283,"Coppin State University",1,0,2010,511,357,154,29,7,22,0.062,0.057,0.045,3633,76.587898,155,9,0.0176125244618395
"4444",162584,"FROSTBURG STATE UNIVERSITY",1,0,1991,762,381,381,187,67,120,0.315,0.245,0.176,2247,43.549998,245,654,0.858267716535433
"4445",162584,"FROSTBURG STATE UNIVERSITY",1,0,1992,839,454,385,236,68,168,0.37,0.281,0.177,2396,43.345642,233,735,0.876042908224076
"4446",162584,"FROSTBURG STATE UNIVERSITY",1,0,1993,910,433,477,210,87,123,0.284,0.231,0.182,2666,42.983861,228,779,0.856043956043956
"4447",162584,"FROSTBURG STATE UNIVERSITY",1,0,1995,909,433,476,194,68,126,0.291,0.213,0.143,3072,49.51784,238,783,0.861386138613861
"4448",162584,"FROSTBURG STATE UNIVERSITY",1,0,1996,975,482,493,195,70,125,0.259,0.2,0.142,3290,50.774248,237,793,0.813333333333333
"4449",162584,"FROSTBURG STATE UNIVERSITY",1,0,1997,865,444,421,210,71,139,0.313,0.243,0.169,3544,53.373236,239,720,0.832369942196532
"4450",162584,"FROSTBURG STATE UNIVERSITY",1,0,1998,932,486,446,181,66,115,0.237,0.194,0.148,3776,55.674251,237,721,0.773605150214592
"4451",162584,"FROSTBURG STATE UNIVERSITY",1,0,1999,932,508,424,165,52,113,0.222,0.177,0.123,3216,59.263701,236,714,0.766094420600858
"4452",162584,"FROSTBURG STATE UNIVERSITY",1,0,2000,1028,499,529,199,64,135,0.27,0.194,0.121,3342,62.829553,242.5,796,0.77431906614786
"4453",162584,"FROSTBURG STATE UNIVERSITY",1,0,2001,923,471,452,204,65,139,0.295,0.221,0.144,3444,69.759568,249,740,0.801733477789816
"4454",162584,"FROSTBURG STATE UNIVERSITY",1,0,2002,999,492,507,220,67,153,0.311,0.22,0.132,3632,67.551344,243,800,0.800800800800801
"4455",162584,"FROSTBURG STATE UNIVERSITY",1,0,2003,988,450,538,216,85,131,0.291,0.219,0.158,4316,70.824451,236,781,0.790485829959514
"4456",162584,"FROSTBURG STATE UNIVERSITY",1,0,2004,955,427,528,207,78,129,0.302,0.217,0.148,4720,70.520726,227,739,0.773821989528796
"4457",162584,"Frostburg State University",1,0,2005,928,448,480,181,60,121,0.27,0.195,0.125,5000,71.885665,231,654,0.704741379310345
"4458",162584,"Frostburg State University",1,0,2006,1011,459,552,175,65,110,0.24,0.173,0.118,5000,76.649141,235,702,0.694362017804154
"4459",162584,"Frostburg State University",1,0,2007,1057,520,537,233,92,141,0.271,0.22,0.171,5000,80.297421,233,680,0.643330179754021
"4460",162584,"Frostburg State University",1,0,2008,1030,478,552,201,86,115,0.241,0.195,0.156,5000,83.472374,242,653,0.633980582524272
"4461",162584,"Frostburg State University",1,0,2009,1028,505,523,217,67,150,0.297,0.211,0.128,5000,88.702438,240,606,0.589494163424125
"4462",162584,"Frostburg State University",1,0,2010,1028,472,556,223,93,130,0.275,0.217,0.167,5150,88.476904,243,649,0.631322957198444
"4463",162654,"GOUCHER COLLEGE",1,0,1991,203,142,61,121,31,90,0.634,0.596,0.508,12685,22.257216,74,167,0.822660098522167
"4464",162654,"GOUCHER COLLEGE",1,0,1992,223,155,68,131,27,104,0.671,0.587,0.397,13446,23.24017,77,184,0.825112107623318
"4465",162654,"GOUCHER COLLEGE",1,0,1993,242,168,74,138,34,104,0.619,0.57,0.459,14300,25.945634,75,177,0.731404958677686
"4466",162654,"GOUCHER COLLEGE",1,0,1995,277,193,84,154,41,113,0.586,0.556,0.488,16630,32.031202,74,196,0.707581227436823
"4467",162654,"GOUCHER COLLEGE",1,0,1996,268,188,80,165,38,127,0.675,0.616,0.475,17635,35.625531,76,194,0.723880597014925
"4468",162654,"GOUCHER COLLEGE",1,0,1997,335,255,80,212,49,163,0.639,0.633,0.613,18525,27.744995,78,250,0.746268656716418
"4469",162654,"GOUCHER COLLEGE",1,0,1998,302,213,89,169,36,133,0.624,0.56,0.404,19565,30.247381,78,233,0.771523178807947
"4470",162654,"GOUCHER COLLEGE",1,0,1999,322,224,98,176,54,122,0.545,0.547,0.551,20200,31.89277,78,222,0.68944099378882
"4471",162654,"GOUCHER COLLEGE",1,0,2000,365,258,107,227,57,170,0.659,0.622,0.533,21000,35.768095,78,218,0.597260273972603
"4472",162654,"GOUCHER COLLEGE",1,0,2001,341,247,94,197,45,152,0.615,0.578,0.479,22000,39.55038,78,203,0.595307917888563
"4473",162654,"GOUCHER COLLEGE",1,0,2002,365,265,100,208,48,160,0.604,0.57,0.48,22950,41.206,96,211,0.578082191780822
"4474",162654,"GOUCHER COLLEGE",1,0,2003,342,207,135,207,60,147,0.71,0.605,0.444,24150,43.345,98,246,0.719298245614035
"4475",162654,"GOUCHER COLLEGE",1,0,2004,401,270,131,241,62,179,0.663,0.601,0.473,25570,44.381,104,282,0.703241895261845
"4476",162654,"Goucher College",1,0,2005,340,217,123,210,68,142,0.654,0.618,0.553,27100,47.759,113,241,0.708823529411765
"4477",162654,"Goucher College",1,0,2006,450,303,147,255,70,185,0.611,0.567,0.476,28900,53.484,130,324,0.72
"4478",162654,"Goucher College",1,0,2007,399,277,122,236,67,169,0.61,0.591,0.549,30636,55.512,127,299,0.74937343358396
"4479",162654,"Goucher College",1,0,2008,360,262,98,205,54,151,0.576,0.569,0.551,32168,58.515,130,225,0.625
"4480",162654,"Goucher College",1,0,2009,398,276,122,227,53,174,0.63,0.57,0.434,33294,61.099155,130,255,0.64070351758794
"4481",162654,"Goucher College",1,0,2010,388,259,129,185,50,135,0.521,0.477,0.388,34626,61.046,131,271,0.698453608247423
"4482",162760,"HOOD COLLEGE",1,0,1991,145,143,2,70,1,69,0.482,0.483,0.5,12208,22.071968,74,85,0.586206896551724
"4483",162760,"HOOD COLLEGE",1,0,1992,150,143,7,91,4,87,0.608,0.607,0.571,12208,22.428064,74,92,0.613333333333333
"4484",162760,"HOOD COLLEGE",1,0,1993,163,161,2,102,0,102,0.634,0.626,0,13258,21.274067,76,108,0.662576687116564
"4485",162760,"HOOD COLLEGE",1,0,1995,177,172,5,103,2,101,0.587,0.582,0.4,14930,23.601007,77,117,0.661016949152542
"4486",162760,"HOOD COLLEGE",1,0,1996,129,128,1,73,0,73,0.57,0.566,0,15522,24.846259,77,74,0.573643410852713
"4487",162760,"HOOD COLLEGE",1,0,1997,162,158,4,109,3,106,0.671,0.673,0.75,16418,28.984541,75,105,0.648148148148148
"4488",162760,"HOOD COLLEGE",1,0,1998,149,144,5,97,2,95,0.66,0.651,0.4,17010,25.59081,69,80,0.536912751677852
"4489",162760,"HOOD COLLEGE",1,0,1999,156,152,4,100,1,99,0.651,0.641,0.25,17275,27.199973,73,85,0.544871794871795
"4490",162760,"HOOD COLLEGE",1,0,2000,131,128,3,90,3,87,0.68,0.687,1,18295,27.683836,73,85,0.648854961832061
"4491",162760,"HOOD COLLEGE",1,0,2001,112,110,2,76,2,74,0.673,0.679,1,18795,27.390404,73,83,0.741071428571429
"4492",162760,"HOOD COLLEGE",1,0,2002,179,172,7,108,3,105,0.61,0.603,0.429,19360,26.247305,78,114,0.636871508379888
"4493",162760,"HOOD COLLEGE",1,0,2003,181,143,38,110,20,90,0.629,0.608,0.526,19940,30.817918,76,113,0.624309392265193
"4494",162760,"HOOD COLLEGE",1,0,2004,242,189,53,160,31,129,0.682,0.661,0.585,20940,31.201984,76,183,0.756198347107438
"4495",162760,"Hood College",1,0,2005,236,156,80,142,44,98,0.628,0.602,0.55,22000,32.426668,81,169,0.716101694915254
"4496",162760,"Hood College",1,0,2006,278,185,93,137,38,99,0.535,0.493,0.409,23320,33.822104,81,201,0.723021582733813
"4497",162760,"Hood College",1,0,2007,295,193,102,163,48,115,0.596,0.553,0.471,24720,34.6903,81,211,0.715254237288136
"4498",162760,"Hood College",1,0,2008,308,200,108,179,57,122,0.61,0.581,0.528,26200,36.378043,80,220,0.714285714285714
"4499",162760,"Hood College",1,0,2009,251,168,83,136,46,90,0.536,0.542,0.554,27770,38.765775,80,164,0.653386454183267
"4500",162760,"Hood College",1,0,2010,327,210,117,165,52,113,0.538,0.505,0.444,29440,37.834952,83,217,0.663608562691132
"4501",162928,"JOHNS HOPKINS UNIVERSITY",1,0,1991,846,304,542,707,444,263,0.865,0.836,0.819,16400,1172.183,743,582,0.687943262411348
"4502",162928,"JOHNS HOPKINS UNIVERSITY",1,0,1992,847,325,522,685,402,283,0.871,0.809,0.77,17420,1250.451716,759,586,0.69185360094451
"4503",162928,"JOHNS HOPKINS UNIVERSITY",1,0,1993,64,32,32,37,16,21,0.656,0.578,0.5,17900,1310.065,767,43,0.671875
"4504",162928,"JOHNS HOPKINS UNIVERSITY",1,0,1995,873,332,541,683,401,282,0.849,0.782,0.741,19750,1442.145,848,584,0.668957617411226
"4505",162928,"JOHNS HOPKINS UNIVERSITY",1,0,1996,1018,408,610,826,483,343,0.841,0.811,0.792,20740,1494.790201,860,646,0.634577603143418
"4506",162928,"JOHNS HOPKINS UNIVERSITY",1,0,1997,941,411,530,749,411,338,0.822,0.796,0.775,21700,1542.076,867,620,0.658873538788523
"4507",162928,"JOHNS HOPKINS UNIVERSITY",1,0,1998,1077,467,610,864,469,395,0.846,0.802,0.769,22680,1634.582,966,719,0.667595171773445
"4508",162928,"JOHNS HOPKINS UNIVERSITY",1,0,1999,1098,441,657,868,503,365,0.828,0.791,0.766,23660,1695.94,998,760,0.692167577413479
"4509",162928,"JOHNS HOPKINS UNIVERSITY",1,0,2000,1067,456,611,876,483,393,0.862,0.821,0.791,24930,1794.167,1032,684,0.641049671977507
"4510",162928,"JOHNS HOPKINS UNIVERSITY",1,0,2001,1077,435,642,884,510,374,0.86,0.821,0.794,26210,1964.832,1066,729,0.676880222841226
"4511",162928,"JOHNS HOPKINS UNIVERSITY",1,0,2002,1203,539,664,960,501,459,0.852,0.798,0.755,27390,2231.521,1089,766,0.636741479634248
"4512",162928,"JOHNS HOPKINS UNIVERSITY",1,0,2003,1122,499,623,919,488,431,0.864,0.819,0.783,28730,2485.895,1094,706,0.629233511586453
"4513",162928,"JOHNS HOPKINS UNIVERSITY",1,0,2004,1127,525,602,928,480,448,0.853,0.823,0.797,30140,2712.507,1144,661,0.586512866015972
"4514",162928,"Johns Hopkins University",1,0,2005,1228,587,641,1036,523,513,0.874,0.844,0.816,31620,2900.839,1171,774,0.63029315960912
"4515",162928,"Johns Hopkins University",1,0,2006,1304,643,661,1127,563,564,0.877,0.864,0.852,33900,3082.842,1123,786,0.602760736196319
"4516",162928,"Johns Hopkins University",1,0,2007,1260,607,653,1095,545,550,0.906,0.869,0.835,35900,3310.391,1127,675,0.535714285714286
"4517",162928,"Johns Hopkins University",1,0,2008,1315,612,703,1140,587,553,0.904,0.867,0.835,37700,3485.281,1203,693,0.526996197718631
"4518",162928,"Johns Hopkins University",1,0,2009,1427,663,764,1240,643,597,0.9,0.869,0.842,39150,3789.862,1060,703,0.492641906096706
"4519",162928,"Johns Hopkins University",1,0,2010,1322,646,676,1150,577,573,0.887,0.87,0.854,40680,4019.378,936,744,0.562783661119516
"4520",163046,"LOYOLA COLLEGE",1,0,1991,700,400,300,475,171,304,0.76,0.679,0.57,10490,69.323734,213,617,0.881428571428571
"4521",163046,"LOYOLA COLLEGE",1,0,1992,792,452,340,565,229,336,0.743,0.713,0.674,11270,71.334202,220,690,0.871212121212121
"4522",163046,"LOYOLA COLLEGE",1,0,1993,739,436,303,515,181,334,0.766,0.697,0.597,12165,75.109147,222,672,0.909336941813261
"4523",163046,"LOYOLA COLLEGE",1,0,1995,798,450,348,581,240,341,0.758,0.728,0.69,14260,85.321985,221,687,0.860902255639098
"4524",163046,"LOYOLA COLLEGE",1,0,1996,812,443,369,592,245,347,0.783,0.729,0.664,15460,89.565081,218,707,0.870689655172414
"4525",163046,"LOYOLA COLLEGE",1,0,1997,833,478,355,650,258,392,0.82,0.78,0.727,16560,80.920032,225,734,0.881152460984394
"4526",163046,"LOYOLA COLLEGE",1,0,1998,854,485,369,668,276,392,0.808,0.782,0.748,18460,81.292559,232,741,0.86768149882904
"4527",163046,"LOYOLA COLLEGE",1,0,1999,941,530,411,734,292,442,0.834,0.78,0.71,19660,96.807419,235,853,0.906482465462274
"4528",163046,"LOYOLA COLLEGE",1,0,2000,909,520,389,699,277,422,0.812,0.769,0.712,21230,92.89213,250,818,0.8998899889989
"4529",163046,"LOYOLA COLLEGE",1,0,2001,880,517,363,679,252,427,0.826,0.772,0.694,21462,94.422862,265,796,0.904545454545455
"4530",163046,"LOYOLA COLLEGE",1,0,2002,901,527,374,733,295,438,0.831,0.814,0.789,23200,106.85419,272,781,0.866814650388457
"4531",163046,"LOYOLA COLLEGE IN MARYLAND",1,0,2003,915,545,370,704,277,427,0.783,0.769,0.749,25140,120.609917,284,796,0.869945355191257
"4532",163046,"LOYOLA COLLEGE IN MARYLAND",1,0,2004,951,579,372,726,277,449,0.775,0.763,0.745,26803,120.298564,294,825,0.867507886435331
"4533",163046,"Loyola College in Maryland",1,0,2005,898,526,372,711,291,420,0.798,0.792,0.782,28683,128.017928,303,757,0.842984409799555
"4534",163046,"Loyola College in Maryland",1,0,2006,946,596,350,749,263,486,0.815,0.792,0.751,30615,138.228798,305,818,0.864693446088795
"4535",163046,"Loyola College in Maryland",1,0,2007,979,545,434,777,320,457,0.838,0.794,0.737,32838,147.329632,324,823,0.840653728294178
"4536",163046,"Loyola College in Maryland",1,0,2008,1066,637,429,825,307,518,0.813,0.774,0.716,35055,153.398831,334,896,0.840525328330206
"4537",163046,"Loyola University Maryland",1,0,2009,968,592,376,740,275,465,0.785,0.764,0.731,36510,166.176815,292,831,0.858471074380165
"4538",163046,"Loyola University-Baltimore",1,0,2010,1019,630,389,818,311,507,0.805,0.803,0.799,37950,166.406786,328,838,0.822374877330716
"4539",163268,"UNIVERSITY OF MARYLAND BALTIMORE COUNTY CAMPUS",1,0,1991,910,467,443,185,71,114,0.244,0.203,0.16,2672,104.418466,364,558,0.613186813186813
"4540",163268,"UNIVERSITY OF MARYLAND BALTIMORE COUNTY CAMPUS",1,0,1992,884,437,447,200,79,121,0.277,0.226,0.177,2856,101.588308,349,599,0.677601809954751
"4541",163268,"UNIVERSITY OF MARYLAND BALTIMORE COUNTY",1,0,1993,929,419,510,215,97,118,0.282,0.231,0.19,3338,110.946656,353,646,0.695371367061356
"4542",163268,"UNIVERSITY OF MARYLAND-BALTIMORE COUNTY",1,0,1995,968,485,483,295,115,180,0.371,0.305,0.238,3852,131.886365,359,601,0.620867768595041
"4543",163268,"UNIVERSITY OF MARYLAND-BALTIMORE COUNTY",1,0,1996,1005,505,500,280,106,174,0.345,0.279,0.212,4136,141.039977,381,638,0.634825870646766
"4544",163268,"UNIVERSITY OF MARYLAND-BALTIMORE COUNTY",1,0,1997,1135,605,530,343,133,210,0.347,0.302,0.251,4570,156.160187,384,658,0.579735682819383
"4545",163268,"UNIVERSITY OF MARYLAND-BALTIMORE COUNTY",1,0,1998,1246,609,637,347,138,209,0.343,0.278,0.217,4846,167.189438,401,746,0.598715890850722
"4546",163268,"UNIVERSITY OF MARYLAND-BALTIMORE COUNTY",1,0,1999,1396,638,758,417,188,229,0.359,0.299,0.248,4046,185.12422,410,855,0.612464183381089
"4547",163268,"UNIVERSITY OF MARYLAND-BALTIMORE COUNTY",1,0,2000,1307,601,706,362,150,212,0.353,0.277,0.212,4206,207.63864,428,794,0.607498087222647
"4548",163268,"UNIVERSITY OF MARYLAND-BALTIMORE COUNTY",1,0,2001,1332,603,729,461,204,257,0.426,0.346,0.28,4374,240.871262,446,827,0.620870870870871
"4549",163268,"UNIVERSITY OF MARYLAND-BALTIMORE COUNTY",1,0,2002,1356,572,784,437,210,227,0.397,0.322,0.268,4614,249.159013,469,856,0.631268436578171
"4550",163268,"UNIVERSITY OF MARYLAND-BALTIMORE COUNTY",1,0,2003,1487,657,830,506,215,291,0.443,0.34,0.259,5570,257.623501,464,881,0.592468056489576
"4551",163268,"UNIVERSITY OF MARYLAND-BALTIMORE COUNTY",1,0,2004,1403,560,843,472,249,223,0.398,0.336,0.295,6120,257.969325,456,864,0.615823235923022
"4552",163268,"University of Maryland-Baltimore County",1,0,2005,1414,584,830,466,237,229,0.392,0.33,0.286,6484,271.172586,458,818,0.578500707213578
"4553",163268,"University of Maryland-Baltimore County",1,0,2006,1419,626,793,523,233,290,0.463,0.369,0.294,6484,277.977793,482,756,0.53276955602537
"4554",163268,"University of Maryland-Baltimore County",1,0,2007,1423,655,768,523,230,293,0.447,0.368,0.299,6484,293.637677,473,740,0.520028109627547
"4555",163268,"University of Maryland-Baltimore County",1,0,2008,1555,650,905,531,237,294,0.452,0.341,0.262,6484,306.78745,483,774,0.497749196141479
"4556",163268,"University of Maryland-Baltimore County",1,0,2009,1522,656,866,574,257,317,0.483,0.377,0.297,6484,326.045873,480,797,0.52365308804205
"4557",163268,"University of Maryland-Baltimore County",1,0,2010,1484,599,885,558,275,283,0.473,0.376,0.311,6679,325.148879,481,735,0.495283018867925
"4558",163286,"UNIVERSITY OF MARYLAND COLLEGE PARK CAMPUS",1,0,1991,3069,1406,1663,928,361,567,0.403,0.302,0.217,2429,611.115345,1298,2003,0.652655588139459
"4559",163286,"UNIVERSITY OF MARYLAND COLLEGE PARK CAMPUS",1,0,1992,3032,1470,1562,966,379,587,0.399,0.319,0.243,2778,521.842645,1276,2002,0.660290237467018
"4560",163286,"UNIVERSITY OF MARYLAND COLLEGE PARK CAMPUS",1,0,1993,3153,1461,1692,1051,447,604,0.413,0.333,0.264,3179,556.12104,1285,1920,0.608943862987631
"4561",163286,"UNIVERSITY OF MARYLAND COLLEGE PARK CAMPUS",1,0,1995,3577,1722,1855,1343,539,804,0.467,0.375,0.291,3794,634.895161,1484,2188,0.61168577019849
"4562",163286,"UNIVERSITY OF MARYLAND COLLEGE PARK CAMPUS",1,0,1996,3539,1720,1819,1449,585,864,0.502,0.409,0.322,4169,673.070966,1496,2198,0.621079400960723
"4563",163286,"UNIVERSITY OF MARYLAND-COLLEGE PARK",1,0,1997,3950,1873,2077,1699,731,968,0.517,0.43,0.352,4460,726.928155,1519,2449,0.62
"4564",163286,"UNIVERSITY OF MARYLAND-COLLEGE PARK",1,0,1998,4039,2007,2032,1858,801,1057,0.527,0.46,0.394,4699,767.86246,1363,2528,0.625897499381035
"4565",163286,"UNIVERSITY OF MARYLAND-COLLEGE PARK",1,0,1999,3871,1796,2075,1943,884,1059,0.59,0.502,0.426,4050,846.862931,1389,2447,0.632136398863343
"4566",163286,"UNIVERSITY OF MARYLAND-COLLEGE PARK",1,0,2000,3929,1896,2033,2141,933,1208,0.637,0.545,0.459,4172,908.650545,1467.5,2463,0.626877067956223
"4567",163286,"UNIVERSITY OF MARYLAND-COLLEGE PARK",1,0,2001,4341,2063,2278,2535,1169,1366,0.662,0.584,0.513,4334,1017.727987,1546,2755,0.634646394839899
"4568",163286,"UNIVERSITY OF MARYLAND-COLLEGE PARK",1,0,2002,3886,1961,1925,2452,1128,1324,0.675,0.631,0.586,4572,1120.722744,1589,2493,0.641533710756562
"4569",163286,"UNIVERSITY OF MARYLAND-COLLEGE PARK",1,0,2003,4045,2031,2014,2539,1158,1381,0.68,0.628,0.575,5568,1079.969945,1539,2444,0.604202719406675
"4570",163286,"UNIVERSITY OF MARYLAND-COLLEGE PARK",1,0,2004,4174,2055,2119,2607,1173,1434,0.698,0.625,0.554,6200,1094.683388,1527,2435,0.58337326305702
"4571",163286,"University of Maryland-College Park",1,0,2005,4192,2081,2111,2769,1273,1496,0.719,0.661,0.603,6566,1159.263059,1523,2421,0.577528625954199
"4572",163286,"University of Maryland-College Park",1,0,2006,3944,1896,2048,2493,1179,1314,0.693,0.632,0.576,6566,1234.445186,1580,2189,0.555020283975659
"4573",163286,"University of Maryland-College Park",1,0,2007,4229,2028,2201,2772,1300,1472,0.726,0.655,0.591,6566,1250.072141,1597,2566,0.606762828091747
"4574",163286,"University of Maryland-College Park",1,0,2008,3907,1824,2083,2610,1298,1312,0.719,0.668,0.623,6566,1371.423157,1642,2287,0.585359610954697
"4575",163286,"University of Maryland-College Park",1,0,2009,4199,1953,2246,2912,1448,1464,0.75,0.693,0.645,6566,1405.879489,1618,2630,0.626339604667778
"4576",163286,"University of Maryland-College Park",1,0,2010,3930,1856,2074,2700,1314,1386,0.747,0.687,0.634,6763,1418.558134,1613,2175,0.553435114503817
"4577",163453,"MORGAN STATE UNIVERSITY",1,0,1991,919,552,367,139,29,110,0.199,0.151,0.079,2198,57.718803,223,6,0.00652883569096844
"4578",163453,"MORGAN STATE UNIVERSITY",1,0,1992,967,572,395,168,37,131,0.229,0.174,0.094,2438,60.212386,230,7,0.00723888314374354
"4579",163453,"MORGAN STATE UNIVERSITY",1,0,1993,944,567,377,138,26,112,0.198,0.146,0.069,2526,63.984504,235,12,0.0127118644067797
"4580",163453,"MORGAN STATE UNIVERSITY",1,0,1995,959,580,379,166,30,136,0.234,0.173,0.079,2832,79.812793,240,9,0.00938477580813347
"4581",163453,"MORGAN STATE UNIVERSITY",1,0,1996,917,546,371,162,27,135,0.247,0.177,0.073,3126,84.70814,220,5,0.0054525627044711
"4582",163453,"MORGAN STATE UNIVERSITY",1,0,1997,1016,588,428,176,30,146,0.248,0.173,0.07,3412,93.90247,243,7,0.00688976377952756
"4583",163453,"MORGAN STATE UNIVERSITY",1,0,1998,1136,674,462,166,42,124,0.184,0.146,0.091,3706,95.0609,195,6,0.00528169014084507
"4584",163453,"MORGAN STATE UNIVERSITY",1,0,1999,1152,661,491,208,41,167,0.253,0.181,0.084,2906,102.411071,198,6,0.00520833333333333
"4585",163453,"MORGAN STATE UNIVERSITY",1,0,2000,1107,689,418,204,60,144,0.209,0.184,0.144,3030,122.164928,279,4,0.003613369467028
"4586",163453,"MORGAN STATE UNIVERSITY",1,0,2001,1125,663,462,172,39,133,0.201,0.153,0.084,3150,126.454295,360,2,0.00177777777777778
"4587",163453,"MORGAN STATE UNIVERSITY",1,0,2002,1247,741,506,139,26,113,0.152,0.111,0.051,4698,142.198224,296,6,0.00481154771451484
"4588",163453,"MORGAN STATE UNIVERSITY",1,0,2003,1220,699,521,138,34,104,0.149,0.113,0.065,5078,138.135278,299,5,0.00409836065573771
"4589",163453,"MORGAN STATE UNIVERSITY",1,0,2004,1336,750,586,153,32,121,0.161,0.115,0.055,4000,133.161113,265,10,0.00748502994011976
"4590",163453,"Morgan State University",1,0,2005,764,408,356,89,22,67,0.164,0.116,0.062,4280,144.53805,323,8,0.0104712041884817
"4591",163453,"Morgan State University",1,0,2006,1368,773,595,165,46,119,0.154,0.121,0.077,4280,150.774977,319,13,0.00950292397660819
"4592",163453,"Morgan State University",1,0,2007,1286,698,588,143,42,101,0.145,0.111,0.071,4280,166.626947,425,10,0.00777604976671851
"4593",163453,"Morgan State University",1,0,2008,1430,808,622,169,46,123,0.152,0.118,0.074,4280,174.231093,436,14,0.00979020979020979
"4594",163453,"Morgan State University",1,0,2009,1261,715,546,121,35,86,0.12,0.096,0.064,4280,177.331803,437,11,0.00872323552735924
"4595",163453,"Morgan State University",1,0,2010,1208,663,545,115,32,83,0.125,0.095,0.059,4408,179.528591,464,5,0.00413907284768212
"4596",163462,"MOUNT SAINT MARYS COLLEGE",1,0,1991,320,170,150,195,85,110,0.647,0.609,0.567,9875,26.526454,90,289,0.903125
"4597",163462,"MOUNT SAINT MARYS COLLEGE",1,0,1992,346,190,156,209,89,120,0.632,0.604,0.571,10675,27.305365,86,310,0.895953757225434
"4598",163462,"MOUNT SAINT MARYS COLLEGE",1,0,1993,325,166,159,218,99,119,0.717,0.671,0.623,11725,29.347459,85,287,0.883076923076923
"4599",163462,"MOUNT SAINT MARYS COLLEGE",1,0,1995,315,169,146,205,95,110,0.651,0.651,0.651,14120,34.25308,94,272,0.863492063492064
"4600",163462,"MOUNT SAINT MARYS COLLEGE",1,0,1996,367,207,160,214,80,134,0.647,0.583,0.5,14885,36.700676,97,307,0.836512261580381
"4601",163462,"MOUNT SAINT MARYS COLLEGE",1,0,1997,325,179,146,221,95,126,0.704,0.68,0.651,15650,31.238055,100,277,0.852307692307692
"4602",163462,"MOUNT SAINT MARYS COLLEGE",1,0,1998,410,213,197,249,113,136,0.639,0.607,0.574,16100,31.757864,97,345,0.841463414634146
"4603",163462,"MOUNT SAINT MARYS COLLEGE",1,0,1999,369,221,148,238,94,144,0.652,0.645,0.635,16520,30.613273,97,319,0.86449864498645
"4604",163462,"MOUNT SAINT MARYS COLLEGE",1,0,2000,383,223,160,255,109,146,0.655,0.666,0.681,17200,30.89873,101,326,0.851174934725849
"4605",163462,"MOUNT SAINT MARYS COLLEGE",1,0,2001,355,197,158,230,105,125,0.635,0.648,0.665,18480,32.585815,105,316,0.890140845070423
"4606",163462,"MOUNT SAINT MARYS COLLEGE",1,0,2002,399,211,188,233,97,136,0.645,0.584,0.516,19700,34.504469,103,346,0.867167919799499
"4607",163462,"MOUNT SAINT MARYS COLLEGE",1,0,2003,395,237,158,279,110,169,0.713,0.706,0.696,20800,38.389289,103,347,0.878481012658228
"4608",163462,"MOUNT ST MARY'S UNIVERSITY",1,0,2004,391,243,148,270,99,171,0.704,0.691,0.669,21430,42.516621,103,323,0.826086956521739
"4609",163462,"Mount St Mary's University",1,0,2005,437,267,170,315,127,188,0.704,0.721,0.747,22500,43.037009,105,363,0.830663615560641
"4610",163462,"Mount St Mary's University",1,0,2006,426,244,182,265,97,168,0.689,0.622,0.533,23630,45.614695,112,347,0.814553990610329
"4611",163462,"Mount St Mary's University",1,0,2007,448,256,192,275,114,161,0.629,0.614,0.594,25290,48.153943,116,363,0.810267857142857
"4612",163462,"Mount St Mary's University",1,0,2008,410,218,192,236,99,137,0.628,0.576,0.516,26960,53.217005,117,325,0.792682926829268
"4613",163462,"Mount St. Mary's University",1,0,2009,464,268,196,298,126,172,0.642,0.642,0.643,28420,55.893925,114,353,0.760775862068966
"4614",163462,"Mount St Mary's University",1,0,2010,424,241,183,275,101,174,0.722,0.649,0.552,29650,58.49158,111,307,0.724056603773585
"4615",163851,"SALISBURY STATE UNIVERSITY",1,0,1991,711,387,324,293,99,194,0.501,0.412,0.306,2544,43.929499,238,658,0.925457102672293
"4616",163851,"SALISBURY STATE UNIVERSITY",1,0,1992,634,372,262,264,78,186,0.5,0.416,0.298,2754,43.886676,236,569,0.897476340694006
"4617",163851,"SALISBURY STATE UNIVERSITY",1,0,1993,726,405,321,297,92,205,0.506,0.409,0.287,3026,49.51772,240,653,0.899449035812672
"4618",163851,"SALISBURY STATE UNIVERSITY",1,0,1995,642,412,230,322,101,221,0.536,0.502,0.439,3440,56.942936,245,591,0.920560747663551
"4619",163851,"SALISBURY STATE UNIVERSITY",1,0,1996,689,393,296,311,98,213,0.542,0.451,0.331,3608,60.128428,254,611,0.886792452830189
"4620",163851,"SALISBURY STATE UNIVERSITY",1,0,1997,886,515,371,418,133,285,0.553,0.472,0.358,3842,61.150013,254,818,0.923250564334086
"4621",163851,"SALISBURY STATE UNIVERSITY",1,0,1998,935,534,401,438,139,299,0.56,0.468,0.347,4002,66.403218,263,778,0.832085561497326
"4622",163851,"SALISBURY STATE UNIVERSITY",1,0,1999,877,537,340,458,149,309,0.575,0.522,0.438,2856,65.700325,261,765,0.872291904218928
"4623",163851,"SALISBURY STATE UNIVERSITY",1,0,2000,939,546,393,488,163,325,0.595,0.52,0.415,3092,74.529683,276,827,0.880724174653887
"4624",163851,"SALISBURY UNIVERSITY",1,0,2001,945,542,403,429,135,294,0.542,0.454,0.335,3216,83.85234,291,749,0.792592592592593
"4625",163851,"SALISBURY UNIVERSITY",1,0,2002,908,529,379,417,121,296,0.559,0.459,0.319,3394,85.267161,298,722,0.795154185022026
"4626",163851,"SALISBURY UNIVERSITY",1,0,2003,947,531,416,433,142,291,0.548,0.457,0.341,4134,88.939443,299,714,0.753959873284055
"4627",163851,"SALISBURY UNIVERSITY",1,0,2004,981,536,445,457,148,309,0.577,0.466,0.333,4546,85.96239,314,797,0.81243628950051
"4628",163851,"Salisbury University",1,0,2005,952,525,427,442,146,296,0.564,0.464,0.342,4814,90.153143,323,786,0.82563025210084
"4629",163851,"Salisbury University",1,0,2006,1028,588,440,502,171,331,0.563,0.488,0.389,4814,95.573012,337,822,0.799610894941634
"4630",163851,"Salisbury University",1,0,2007,1142,646,496,533,172,361,0.559,0.467,0.347,4814,103.933255,363,926,0.810858143607706
"4631",163851,"Salisbury University",1,0,2008,1198,694,504,533,151,382,0.55,0.445,0.3,4814,109.621348,379,994,0.829716193656094
"4632",163851,"Salisbury University",1,0,2009,1273,738,535,577,169,408,0.553,0.453,0.316,4814,120.534709,380,1032,0.810683424980361
"4633",163851,"Salisbury University",1,0,2010,1248,770,478,595,176,419,0.544,0.477,0.368,4960,119.5577,388,949,0.760416666666667
"4634",163912,"SAINT MARYS COLLEGE OF MARYLAND",1,0,1991,227,132,95,147,51,96,0.727,0.648,0.537,3210,22.049468,96,178,0.784140969162996
"4635",163912,"SAINT MARYS COLLEGE OF MARYLAND",1,0,1992,234,133,101,129,53,76,0.571,0.551,0.525,3880,20.553679,96,185,0.790598290598291
"4636",163912,"SAINT MARYS COLLEGE OF MARYLAND",1,0,1993,284,153,131,166,68,98,0.64,0.585,0.519,4400,21.548296,97,225,0.792253521126761
"4637",163912,"SAINT MARYS COLLEGE OF MARYLAND",1,0,1995,352,201,151,207,81,126,0.627,0.588,0.536,5435,25.375535,104,289,0.821022727272727
"4638",163912,"SAINT MARYS COLLEGE OF MARYLAND",1,0,1996,312,180,132,221,93,128,0.711,0.708,0.705,6005,27.710775,108,253,0.810897435897436
"4639",163912,"SAINT MARYS COLLEGE OF MARYLAND",1,0,1997,345,194,151,232,92,140,0.722,0.672,0.609,6575,29.227523,109,286,0.828985507246377
"4640",163912,"SAINT MARYS COLLEGE OF MARYLAND",1,0,1998,331,181,150,211,77,134,0.74,0.637,0.513,6875,31.953231,111,264,0.797583081570997
"4641",163912,"ST MARY'S COLLEGE OF MARYLAND",1,0,1999,276,157,119,176,70,106,0.675,0.638,0.588,6100,32.960936,116,221,0.800724637681159
"4642",163912,"ST MARY'S COLLEGE OF MARYLAND",1,0,2000,375,220,155,262,94,168,0.764,0.699,0.606,6285,35.314971,121.5,318,0.848
"4643",163912,"ST MARY'S COLLEGE OF MARYLAND",1,0,2001,457,287,170,344,114,230,0.801,0.753,0.671,6474,38.357128,127,372,0.814004376367615
"4644",163912,"ST MARY'S COLLEGE OF MARYLAND",1,0,2002,425,243,182,286,113,173,0.712,0.673,0.621,6925,41.101344,130,338,0.795294117647059
"4645",163912,"ST MARY'S COLLEGE OF MARYLAND",1,0,2003,421,249,172,300,106,194,0.779,0.713,0.616,7550,42.240429,126,322,0.764845605700713
"4646",163912,"ST MARY'S COLLEGE OF MARYLAND",1,0,2004,431,233,198,303,122,181,0.777,0.703,0.616,8092,43.793113,128,338,0.784222737819026
"4647",163912,"St Mary's College of Maryland",1,0,2005,488,295,193,341,130,211,0.715,0.699,0.674,9063,48.809942,137,369,0.756147540983607
"4648",163912,"St Mary's College of Maryland",1,0,2006,428,249,179,309,118,191,0.767,0.722,0.659,9498,51.981293,145,320,0.747663551401869
"4649",163912,"St Mary's College of Maryland",1,0,2007,464,256,208,331,134,197,0.77,0.713,0.644,9973,56.665591,152,360,0.775862068965517
"4650",163912,"St Mary's College of Maryland",1,0,2008,458,279,179,332,119,213,0.763,0.725,0.665,10472,60.426082,154,361,0.7882096069869
"4651",163912,"St. Mary's College of Maryland",1,0,2009,486,273,213,327,121,206,0.755,0.673,0.568,10995,62.387166,143,384,0.790123456790123
"4652",163912,"St Mary's College of Maryland",1,0,2010,443,277,166,289,96,193,0.697,0.652,0.578,11325,62.451307,144,333,0.751693002257336
"4653",164076,"TOWSON STATE UNIVERSITY",1,0,1991,1237,735,502,335,78,257,0.35,0.271,0.155,2458,107.493165,483,1014,0.819725141471301
"4654",164076,"TOWSON STATE UNIVERSITY",1,0,1992,1336,824,512,365,99,266,0.323,0.273,0.193,2828,112.997546,481,1131,0.846556886227545
"4655",164076,"TOWSON STATE UNIVERSITY",1,0,1993,1215,721,494,348,90,258,0.358,0.286,0.182,3122,113.685049,471,990,0.814814814814815
"4656",164076,"TOWSON STATE UNIVERSITY",1,0,1995,1488,934,554,468,121,347,0.372,0.315,0.218,3530,124.364731,465,1237,0.831317204301075
"4657",164076,"TOWSON STATE UNIVERSITY",1,0,1996,1851,1127,724,513,127,386,0.342,0.277,0.175,3822,130.803972,454,1550,0.837385197190708
"4658",164076,"TOWSON UNIVERSITY",1,0,1997,1808,1079,729,557,166,391,0.362,0.308,0.228,4120,147.883957,450,1480,0.81858407079646
"4659",164076,"TOWSON UNIVERSITY",1,0,1998,1923,1175,748,573,183,390,0.332,0.298,0.245,4336,164.218856,458,1570,0.816432657306292
"4660",164076,"TOWSON UNIVERSITY",1,0,1999,2103,1277,826,610,170,440,0.345,0.29,0.206,3332,181.951182,521,1692,0.804564907275321
"4661",164076,"TOWSON UNIVERSITY",1,0,2000,1981,1198,783,630,190,440,0.367,0.318,0.243,3466,199.298712,546,1613,0.814235234729934
"4662",164076,"TOWSON UNIVERSITY",1,0,2001,1910,1245,665,681,169,512,0.411,0.357,0.254,3605,218.254223,571,1505,0.787958115183246
"4663",164076,"TOWSON UNIVERSITY",1,0,2002,2198,1385,813,815,229,586,0.423,0.371,0.282,3804,205.980472,585,1765,0.803002729754322
"4664",164076,"TOWSON UNIVERSITY",1,0,2003,1756,1192,564,763,181,582,0.488,0.435,0.321,4528,216.872185,611,1262,0.718678815489749
"4665",164076,"TOWSON UNIVERSITY",1,0,2004,2082,1376,706,835,229,606,0.44,0.401,0.324,4890,212.704856,622,1485,0.713256484149856
"4666",164076,"Towson University",1,0,2005,2314,1455,859,910,270,640,0.44,0.393,0.314,5180,227.346768,663,1688,0.729472774416595
"4667",164076,"Towson University",1,0,2006,2688,1697,991,1047,307,740,0.436,0.39,0.31,5180,238.501755,691,1905,0.708705357142857
"4668",164076,"Towson University",1,0,2007,2649,1670,979,1069,314,755,0.452,0.404,0.321,5180,262.740874,728,2027,0.765194412986032
"4669",164076,"Towson University",1,0,2008,2825,1786,1039,1210,385,825,0.462,0.428,0.371,5180,284.943244,788,2052,0.726371681415929
"4670",164076,"Towson University",1,0,2009,2395,1564,831,1076,275,801,0.512,0.449,0.331,5180,303.69577,822,1693,0.706889352818372
"4671",164076,"Towson University",1,0,2010,2427,1593,834,1125,310,815,0.512,0.464,0.372,5336,305.15637,830,1786,0.735887927482489
"4672",164173,"VILLA JULIE COLLEGE",1,0,1991,269,233,36,44,6,38,0.163,0.164,0.167,5770,9.147891,43,211,0.784386617100372
"4673",164173,"VILLA JULIE COLLEGE",1,0,1992,200,154,46,44,7,37,0.24,0.22,0.152,6320,10.166349,40,172,0.86
"4674",164173,"VILLA JULIE COLLEGE",1,0,1993,218,171,47,53,10,43,0.252,0.243,0.213,6880,11.399255,42,164,0.752293577981651
"4675",164173,"VILLA JULIE COLLEGE",1,0,1995,253,180,73,94,26,68,0.378,0.372,0.356,8200,13.905926,65,210,0.8300395256917
"4676",164173,"VILLA JULIE COLLEGE",1,0,1996,286,205,81,89,20,69,0.337,0.311,0.247,8610,14.597812,67,214,0.748251748251748
"4677",164173,"VILLA JULIE COLLEGE",1,0,1997,367,259,108,122,21,101,0.39,0.332,0.194,9240,16.466052,64,312,0.850136239782016
"4678",164173,"VILLA JULIE COLLEGE",1,0,1998,443,305,138,163,46,117,0.384,0.368,0.333,9976,18.550235,68,394,0.889390519187359
"4679",164173,"VILLA JULIE COLLEGE",1,0,1999,421,288,133,211,60,151,0.524,0.501,0.451,10250,18.365223,72,373,0.885985748218527
"4680",164173,"VILLA JULIE COLLEGE",1,0,2000,425,313,112,220,51,169,0.54,0.518,0.455,10750,20.681814,75.5,345,0.811764705882353
"4681",164173,"VILLA JULIE COLLEGE",1,0,2001,512,374,138,246,56,190,0.508,0.48,0.406,11300,22.486157,79,412,0.8046875
"4682",164173,"VILLA JULIE COLLEGE",1,0,2002,487,365,122,281,63,218,0.597,0.577,0.516,11978,25.095035,80,406,0.833675564681725
"4683",164173,"VILLA JULIE COLLEGE",1,0,2003,539,384,155,247,63,184,0.479,0.458,0.406,12816,28.577218,85,422,0.782931354359926
"4684",164173,"VILLA JULIE COLLEGE",1,0,2004,561,378,183,252,81,171,0.452,0.449,0.443,13715,31.223812,91,428,0.762923351158645
"4685",164173,"Villa Julie College",1,0,2005,537,373,164,236,61,175,0.469,0.439,0.372,14674,38.856267,93,395,0.735567970204842
"4686",164173,"Villa Julie College",1,0,2006,643,454,189,315,85,230,0.507,0.49,0.45,15700,45.304849,105,455,0.707620528771384
"4687",164173,"Villa Julie College",1,0,2007,604,436,168,254,61,193,0.443,0.421,0.363,16800,53.118539,112,444,0.735099337748344
"4688",164173,"Stevenson University",1,0,2008,626,436,190,301,81,220,0.505,0.481,0.426,17976,59.156382,111,473,0.755591054313099
"4689",164173,"Stevenson University",1,0,2009,522,346,176,220,62,158,0.457,0.421,0.352,19234,63.087323,110,338,0.647509578544061
"4690",164173,"Stevenson University",1,0,2010,877,535,342,331,98,233,0.436,0.377,0.287,20580,66.398508,111,481,0.548460661345496
"4691",164216,"WASHINGTON COLLEGE",1,0,1991,182,99,83,105,40,65,0.657,0.577,0.482,12312,19.785989,58,161,0.884615384615385
"4692",164216,"WASHINGTON COLLEGE",1,0,1992,276,145,131,160,70,90,0.621,0.58,0.534,13226,20.322397,62,237,0.858695652173913
"4693",164216,"WASHINGTON COLLEGE",1,0,1993,213,123,90,132,46,86,0.699,0.62,0.511,13952,22.39636,66,178,0.835680751173709
"4694",164216,"WASHINGTON COLLEGE",1,0,1995,241,134,107,144,60,84,0.627,0.598,0.561,16440,23.769159,64,197,0.817427385892116
"4695",164216,"WASHINGTON COLLEGE",1,0,1996,312,198,114,203,67,136,0.687,0.651,0.588,16800,25.11693,63,261,0.836538461538462
"4696",164216,"WASHINGTON COLLEGE",1,0,1997,290,162,128,182,79,103,0.636,0.628,0.617,17800,21.01628,65,244,0.841379310344828
"4697",164216,"WASHINGTON COLLEGE",1,0,1998,278,174,104,163,53,110,0.632,0.586,0.51,18750,23.31344,68,234,0.841726618705036
"4698",164216,"WASHINGTON COLLEGE",1,0,1999,282,175,107,175,54,121,0.691,0.621,0.505,19750,24.899239,72,235,0.833333333333333
"4699",164216,"WASHINGTON COLLEGE",1,0,2000,374,236,138,255,80,175,0.742,0.682,0.58,20750,26.629089,75.5,328,0.877005347593583
"4700",164216,"WASHINGTON COLLEGE",1,0,2001,338,204,134,234,89,145,0.711,0.692,0.664,21750,29.424178,79,263,0.77810650887574
"4701",164216,"WASHINGTON COLLEGE",1,0,2002,368,243,125,276,88,188,0.774,0.75,0.704,22740,31.872097,80,309,0.839673913043478
"4702",164216,"WASHINGTON COLLEGE",1,0,2003,361,228,133,272,93,179,0.785,0.753,0.699,24240,34.308595,76,308,0.853185595567867
"4703",164216,"WASHINGTON COLLEGE",1,0,2004,304,185,119,205,71,134,0.724,0.674,0.597,25990,36.310104,79,262,0.861842105263158
"4704",164216,"Washington College",1,0,2005,345,201,144,247,90,157,0.781,0.716,0.625,28230,38.616067,79,297,0.860869565217391
"4705",164216,"Washington College",1,0,2006,312,179,133,202,80,122,0.682,0.647,0.602,29640,43.513707,82,266,0.852564102564103
"4706",164216,"Washington College",1,0,2007,324,197,127,210,69,141,0.716,0.648,0.543,31570,45.707051,93,270,0.833333333333333
"4707",164216,"Washington College",1,0,2008,415,248,167,291,108,183,0.738,0.701,0.647,33385,49.954332,95,354,0.853012048192771
"4708",164216,"Washington College",1,0,2009,378,215,163,269,111,158,0.735,0.712,0.681,34690,48.903881,90,329,0.87037037037037
"4709",164216,"Washington College",1,0,2010,421,238,183,293,109,184,0.773,0.696,0.596,36078,55.138924,91,353,0.838479809976247
"4710",164270,"WESTERN MARYLAND COLLEGE",1,0,1991,278,132,146,160,71,89,0.674,0.576,0.486,12505,26.945,85,234,0.841726618705036
"4711",164270,"WESTERN MARYLAND COLLEGE",1,0,1992,300,160,140,164,62,102,0.638,0.547,0.443,13130,27.016,84,270,0.9
"4712",164270,"WESTERN MARYLAND COLLEGE",1,0,1993,258,132,126,145,62,83,0.629,0.562,0.492,13750,27.947,79,225,0.872093023255814
"4713",164270,"WESTERN MARYLAND COLLEGE",1,0,1995,316,163,153,206,80,126,0.773,0.652,0.523,15300,30.749,77,294,0.930379746835443
"4714",164270,"WESTERN MARYLAND COLLEGE",1,0,1996,385,199,186,236,100,136,0.683,0.613,0.538,16125,33.878,82,340,0.883116883116883
"4715",164270,"WESTERN MARYLAND COLLEGE",1,0,1997,427,241,186,274,98,176,0.73,0.642,0.527,16850,29.09,89,363,0.850117096018735
"4716",164270,"WESTERN MARYLAND COLLEGE",1,0,1998,331,173,158,210,86,124,0.717,0.634,0.544,17730,31.284,83,274,0.827794561933535
"4717",164270,"WESTERN MARYLAND COLLEGE",1,0,1999,412,204,208,261,107,154,0.755,0.633,0.514,18650,32.251,84,338,0.820388349514563
"4718",164270,"WESTERN MARYLAND COLLEGE",1,0,2000,442,247,195,293,109,184,0.745,0.663,0.559,19600,36.073,88.5,376,0.850678733031674
"4719",164270,"WESTERN MARYLAND COLLEGE",1,0,2001,368,209,159,244,88,156,0.746,0.663,0.553,20550,39.527,93,293,0.796195652173913
"4720",164270,"MCDANIEL COLLEGE",1,0,2002,440,253,187,307,124,183,0.723,0.698,0.663,21760,40.544,92,342,0.777272727272727
"4721",164270,"MCDANIEL COLLEGE",1,0,2003,451,249,202,274,94,180,0.723,0.608,0.465,22860,43.603,133,383,0.849223946784922
"4722",164270,"MCDANIEL COLLEGE",1,0,2004,357,196,161,237,100,137,0.699,0.664,0.621,24500,44.37,128,296,0.829131652661064
"4723",164270,"McDaniel College",1,0,2005,447,246,201,314,136,178,0.724,0.702,0.677,25710,46.883,123,379,0.847874720357942
"4724",164270,"McDaniel College",1,0,2006,476,260,216,324,126,198,0.762,0.681,0.583,26980,50.143,121,404,0.848739495798319
"4725",164270,"McDaniel College",1,0,2007,439,226,213,279,118,161,0.712,0.636,0.554,28640,54.722,130,378,0.861047835990888
"4726",164270,"McDaniel College",1,0,2008,426,223,203,263,117,146,0.655,0.617,0.576,30780,57.99,135,345,0.809859154929577
"4727",164270,"McDaniel College",1,0,2009,420,195,225,266,124,142,0.728,0.633,0.551,32000,60.058,127,329,0.783333333333333
"4728",164270,"McDaniel College",1,0,2010,408,213,195,250,93,157,0.737,0.613,0.477,33280,60.125,128,319,0.781862745098039
"4729",164447,"AMERICAN INTERNATIONAL COLLEGE",1,0,1991,250,110,140,84,43,41,0.373,0.336,0.307,8117,14.93931,67,196,0.784
"4730",164447,"AMERICAN INTERNATIONAL COLLEGE",1,0,1992,225,95,130,71,38,33,0.347,0.316,0.292,8298,16.320672,69,164,0.728888888888889
"4731",164447,"AMERICAN INTERNATIONAL COLLEGE",1,0,1993,240,110,130,68,32,36,0.327,0.283,0.246,8690,17.252327,72,165,0.6875
"4732",164447,"AMERICAN INTERNATIONAL COLLEGE",1,0,1995,260,104,156,84,37,47,0.452,0.323,0.237,9714,20.150466,74,176,0.676923076923077
"4733",164447,"AMERICAN INTERNATIONAL COLLEGE",1,0,1996,253,133,120,79,30,49,0.368,0.312,0.25,10276,22.522034,76,165,0.652173913043478
"4734",164447,"AMERICAN INTERNATIONAL COLLEGE",1,0,1997,253,133,120,79,30,49,0.368,0.312,0.25,11244,16.873828,81,165,0.652173913043478
"4735",164447,"AMERICAN INTERNATIONAL COLLEGE",1,0,1998,226,96,130,57,22,35,0.365,0.252,0.169,11800,18.462458,83,149,0.65929203539823
"4736",164447,"AMERICAN INTERNATIONAL COLLEGE",1,0,1999,240,92,148,77,33,44,0.478,0.321,0.223,12338,19.522991,83,106,0.441666666666667
"4737",164447,"AMERICAN INTERNATIONAL COLLEGE",1,0,2000,239,123,116,112,63,49,0.398,0.469,0.543,13600,20.548986,81.5,115,0.481171548117155
"4738",164447,"AMERICAN INTERNATIONAL COLLEGE",1,0,2001,197,98,99,91,34,57,0.582,0.462,0.343,14800,21.210928,80,105,0.532994923857868
"4739",164447,"AMERICAN INTERNATIONAL COLLEGE",1,0,2002,256,117,139,55,21,34,0.291,0.215,0.151,15700,22.448612,79,116,0.453125
"4740",164447,"AMERICAN INTERNATIONAL COLLEGE",1,0,2003,327,174,153,105,45,60,0.345,0.321,0.294,16700,27.095333,78,172,0.525993883792049
"4741",164447,"AMERICAN INTERNATIONAL COLLEGE",1,0,2004,321,167,154,83,35,48,0.287,0.259,0.227,18000,24.078358,75,174,0.542056074766355
"4742",164447,"American International College",1,0,2005,328,160,168,65,32,33,0.206,0.198,0.19,19800,28.862628,77,177,0.539634146341463
"4743",164447,"American International College",1,0,2006,282,148,134,81,29,52,0.351,0.287,0.216,20990,27.968286,79,130,0.460992907801418
"4744",164447,"American International College",1,0,2007,390,202,188,111,55,56,0.277,0.285,0.293,22500,31.406807,76,167,0.428205128205128
"4745",164447,"American International College",1,0,2008,371,185,186,102,46,56,0.303,0.275,0.247,24100,35.316046,80,145,0.390835579514825
"4746",164447,"American International College",1,0,2009,354,165,189,88,40,48,0.291,0.249,0.212,25550,44.023022,88,112,0.31638418079096
"4747",164447,"American International College",1,0,2010,367,168,199,107,47,60,0.357,0.292,0.236,26700,45.603061,81,143,0.389645776566757
"4748",164492,"ANNA MARIA COLLEGE",1,0,1991,116,87,29,54,9,45,0.517,0.466,0.31,9880,7.692627,32,100,0.862068965517241
"4749",164492,"ANNA MARIA COLLEGE",1,0,1992,80,48,32,35,16,19,0.396,0.438,0.5,10380,7.809764,32,71,0.8875
"4750",164492,"ANNA MARIA COLLEGE",1,0,1993,94,62,32,50,17,33,0.532,0.532,0.531,10800,8.363408,33,86,0.914893617021277
"4751",164492,"ANNA MARIA COLLEGE",1,0,1995,69,43,26,28,7,21,0.488,0.406,0.269,11780,9.491741,31,55,0.797101449275362
"4752",164492,"ANNA MARIA COLLEGE",1,0,1996,112,69,43,53,24,29,0.42,0.473,0.558,11780,10.530849,31,105,0.9375
"4753",164492,"ANNA MARIA COLLEGE",1,0,1997,135,90,45,54,19,35,0.389,0.4,0.422,12240,11.182477,34,119,0.881481481481482
"4754",164492,"ANNA MARIA COLLEGE",1,0,1998,153,116,37,70,19,51,0.44,0.458,0.514,12690,9.549798,25,123,0.803921568627451
"4755",164492,"ANNA MARIA COLLEGE",1,0,1999,134,90,44,64,23,41,0.456,0.478,0.523,12200,10.459913,36,110,0.82089552238806
"4756",164492,"ANNA MARIA COLLEGE",1,0,2000,149,110,39,81,18,63,0.573,0.544,0.462,13495,9.899029,35,128,0.859060402684564
"4757",164492,"ANNA MARIA COLLEGE",1,0,2001,140,97,43,69,24,45,0.464,0.493,0.558,15250,10.391854,34,119,0.85
"4758",164492,"ANNA MARIA COLLEGE",1,0,2002,159,108,51,82,29,53,0.491,0.516,0.569,16410,10.701031,37,142,0.893081761006289
"4759",164492,"ANNA MARIA COLLEGE",1,0,2003,154,102,52,76,19,57,0.559,0.494,0.365,17495,11.538671,39,131,0.850649350649351
"4760",164492,"ANNA MARIA COLLEGE",1,0,2004,189,107,82,69,32,37,0.346,0.365,0.39,18545,10.608283,34,152,0.804232804232804
"4761",164492,"Anna Maria College",1,0,2005,156,79,77,58,27,31,0.392,0.372,0.351,19900,11.203825,38,127,0.814102564102564
"4762",164492,"Anna Maria College",1,0,2006,181,105,76,71,24,47,0.448,0.392,0.316,21094,12.33394,40,145,0.801104972375691
"4763",164492,"Anna Maria College",1,0,2007,258,137,121,112,45,67,0.489,0.434,0.372,22360,14.917657,47,195,0.755813953488372
"4764",164492,"Anna Maria College",1,0,2008,245,135,110,81,38,43,0.318,0.331,0.345,23500,18.312184,50,190,0.775510204081633
"4765",164492,"Anna Maria College",1,0,2009,373,172,201,95,46,49,0.285,0.255,0.229,24192,20.005165,52,245,0.656836461126005
"4766",164492,"Anna Maria College",1,0,2010,287,140,147,95,43,52,0.371,0.331,0.293,25632,21.573406,49,165,0.574912891986063
"4767",164562,"ASSUMPTION COLLEGE",1,0,1991,447,286,161,298,110,188,0.657,0.667,0.683,9835,26.574386,108,440,0.984340044742729
"4768",164562,"ASSUMPTION COLLEGE",1,0,1992,446,287,159,304,102,202,0.704,0.682,0.642,10320,28.791164,111,428,0.959641255605381
"4769",164562,"ASSUMPTION COLLEGE",1,0,1993,491,302,189,299,108,191,0.633,0.609,0.571,11595,30.986784,107,478,0.973523421588595
"4770",164562,"ASSUMPTION COLLEGE",1,0,1995,446,262,184,295,119,176,0.672,0.661,0.647,12825,33.888073,108,354,0.79372197309417
"4771",164562,"ASSUMPTION COLLEGE",1,0,1996,431,266,165,296,112,184,0.692,0.687,0.679,13845,35.681539,109,391,0.907192575406032
"4772",164562,"ASSUMPTION COLLEGE",1,0,1997,582,365,217,386,137,249,0.682,0.663,0.631,14845,37.704241,116,515,0.884879725085911
"4773",164562,"ASSUMPTION COLLEGE",1,0,1998,522,334,188,402,138,264,0.79,0.77,0.734,15905,31.865908,113,474,0.908045977011494
"4774",164562,"ASSUMPTION COLLEGE",1,0,1999,592,361,231,404,150,254,0.704,0.682,0.649,17320,32.624654,111,482,0.814189189189189
"4775",164562,"ASSUMPTION COLLEGE",1,0,2000,593,367,226,409,114,295,0.804,0.69,0.504,17950,35.474185,119,518,0.873524451939292
"4776",164562,"ASSUMPTION COLLEGE",1,0,2001,604,369,235,402,148,254,0.688,0.666,0.63,18800,39.495982,127,418,0.69205298013245
"4777",164562,"ASSUMPTION COLLEGE",1,0,2002,618,381,237,451,168,283,0.743,0.73,0.709,19835,43.490872,144,534,0.864077669902913
"4778",164562,"ASSUMPTION COLLEGE",1,0,2003,640,408,232,409,140,269,0.659,0.639,0.603,21000,46.812137,130,535,0.8359375
"4779",164562,"ASSUMPTION COLLEGE",1,0,2004,633,364,269,447,170,277,0.761,0.706,0.632,22260,48.172014,134,536,0.846761453396525
"4780",164562,"Assumption College",1,0,2005,565,328,237,369,132,237,0.723,0.653,0.557,23930,50.047546,135,426,0.753982300884956
"4781",164562,"Assumption College",1,0,2006,675,397,278,484,183,301,0.758,0.717,0.658,25985,53.315504,148,533,0.78962962962963
"4782",164562,"Assumption College",1,0,2007,594,331,263,417,176,241,0.728,0.702,0.669,27320,57.023417,153,460,0.774410774410774
"4783",164562,"Assumption College",1,0,2008,606,357,249,402,151,251,0.703,0.663,0.606,28686,61.789151,157,439,0.724422442244224
"4784",164562,"Assumption College",1,0,2009,515,294,221,363,135,228,0.775,0.705,0.611,29806,63.288523,155,379,0.735922330097087
"4785",164562,"Assumption College",1,0,2010,590,369,221,423,141,282,0.764,0.717,0.638,30940,62.889671,156,449,0.761016949152542
"4786",165015,"BRANDEIS UNIVERSITY",1,0,1991,745,392,353,546,247,299,0.763,0.733,0.7,16475,127.07484,340,585,0.785234899328859
"4787",165015,"BRANDEIS UNIVERSITY",1,0,1992,757,413,344,556,250,306,0.741,0.734,0.727,17726,132.391788,328,597,0.788639365918098
"4788",165015,"BRANDEIS UNIVERSITY",1,0,1993,704,379,325,531,238,293,0.773,0.754,0.732,18955,140.433744,299,547,0.776988636363636
"4789",165015,"BRANDEIS UNIVERSITY",1,0,1995,874,483,391,702,306,396,0.82,0.803,0.783,20935,157.954525,317,697,0.797482837528604
"4790",165015,"BRANDEIS UNIVERSITY",1,0,1996,761,393,368,608,275,333,0.847,0.799,0.747,21917,166.522936,308,617,0.810775295663601
"4791",165015,"BRANDEIS UNIVERSITY",1,0,1997,794,470,324,633,250,383,0.815,0.797,0.772,22360,139.407567,309,628,0.790931989924433
"4792",165015,"BRANDEIS UNIVERSITY",1,0,1998,850,477,373,715,293,422,0.885,0.841,0.786,23360,148.028643,309,662,0.778823529411765
"4793",165015,"BRANDEIS UNIVERSITY",1,0,1999,793,446,347,663,275,388,0.87,0.836,0.793,24421,158.884523,316,569,0.717528373266078
"4794",165015,"BRANDEIS UNIVERSITY",1,0,2000,858,475,383,714,301,413,0.87,0.832,0.786,25392,165.136928,321,568,0.662004662004662
"4795",165015,"BRANDEIS UNIVERSITY",1,0,2001,735,416,319,629,261,368,0.885,0.856,0.818,26281,175.932405,326,499,0.67891156462585
"4796",165015,"BRANDEIS UNIVERSITY",1,0,2002,837,456,381,708,316,392,0.86,0.846,0.829,27345,180.743705,339,591,0.706093189964158
"4797",165015,"BRANDEIS UNIVERSITY",1,0,2003,824,486,338,692,285,407,0.837,0.84,0.843,28999,193.082746,336,541,0.656553398058252
"4798",165015,"BRANDEIS UNIVERSITY",1,0,2004,761,417,344,655,287,368,0.883,0.861,0.834,30160,201.898106,333,496,0.651773981603154
"4799",165015,"Brandeis University",1,0,2005,737,397,340,647,287,360,0.907,0.878,0.844,31532,217.21201,343,453,0.614654002713704
"4800",165015,"Brandeis University",1,0,2006,764,416,348,656,291,365,0.877,0.859,0.836,32951,233.926343,352,407,0.532722513089005
"4801",165015,"Brandeis University",1,0,2007,701,391,310,604,264,340,0.87,0.862,0.852,34566,246.208976,351,377,0.537803138373752
"4802",165015,"Brandeis University",1,0,2008,754,426,328,643,274,369,0.866,0.853,0.835,36122,269.662065,360,341,0.452254641909814
"4803",165015,"Brandeis University",1,0,2009,775,434,341,621,255,366,0.843,0.801,0.748,37530,314.260142,358,331,0.427096774193548
"4804",165015,"Brandeis University",1,0,2010,686,370,316,569,247,322,0.87,0.829,0.782,38994,277.500897,363,354,0.516034985422741
"4805",165024,"BRIDGEWATER STATE COLLEGE",1,0,1991,982,568,414,265,67,198,0.349,0.27,0.162,2882,36.898953,306,910,0.926680244399185
"4806",165024,"BRIDGEWATER STATE COLLEGE",1,0,1992,963,567,396,213,54,159,0.28,0.221,0.136,2952,38.790516,244,857,0.889927310488058
"4807",165024,"BRIDGEWATER STATE COLLEGE",1,0,1993,1045,590,455,196,68,128,0.217,0.188,0.149,3373,44.524027,255,927,0.887081339712919
"4808",165024,"BRIDGEWATER STATE COLLEGE",1,0,1995,1087,620,467,211,57,154,0.248,0.194,0.122,3462,67.426809,258,928,0.853725850965961
"4809",165024,"BRIDGEWATER STATE COLLEGE",1,0,1996,1155,697,458,222,52,170,0.244,0.192,0.114,3392,62.211809,260,972,0.841558441558442
"4810",165024,"BRIDGEWATER STATE COLLEGE",1,0,1997,1147,672,475,206,46,160,0.238,0.18,0.097,3324,64.112283,262,964,0.840453356582389
"4811",165024,"BRIDGEWATER STATE COLLEGE",1,0,1998,1128,695,433,260,75,185,0.266,0.23,0.173,3134,67.010707,259,967,0.857269503546099
"4812",165024,"BRIDGEWATER STATE COLLEGE",1,0,1999,1079,657,422,208,43,165,0.251,0.193,0.102,1032,70.044575,249,897,0.831325301204819
"4813",165024,"BRIDGEWATER STATE COLLEGE",1,0,2000,1244,760,484,290,87,203,0.267,0.233,0.18,1030,77.274082,255.5,1030,0.827974276527331
"4814",165024,"BRIDGEWATER STATE COLLEGE",1,0,2001,1139,695,444,255,59,196,0.282,0.224,0.133,910,80.889285,262,961,0.843722563652327
"4815",165024,"BRIDGEWATER STATE COLLEGE",1,0,2002,1272,769,503,277,72,205,0.267,0.218,0.143,910,76.713562,252,1031,0.810534591194969
"4816",165024,"BRIDGEWATER STATE COLLEGE",1,0,2003,1285,745,540,320,93,227,0.305,0.249,0.172,910,76.199114,258,1078,0.838910505836576
"4817",165024,"BRIDGEWATER STATE COLLEGE",1,0,2004,1266,713,553,306,99,207,0.29,0.242,0.179,910,88.104794,262,1040,0.821484992101106
"4818",165024,"Bridgewater State College",1,0,2005,1314,746,568,339,113,226,0.303,0.258,0.199,910,95.275977,273,1066,0.811263318112633
"4819",165024,"Bridgewater State College",1,0,2006,1321,737,584,368,135,233,0.316,0.279,0.231,910,104.749797,292,1099,0.831945495836487
"4820",165024,"Bridgewater State College",1,0,2007,1551,935,616,445,139,306,0.327,0.287,0.226,910,115.961552,299,1272,0.820116054158607
"4821",165024,"Bridgewater State College",1,0,2008,1464,915,549,412,134,278,0.304,0.281,0.244,910,134.865199,306,1239,0.846311475409836
"4822",165024,"Bridgewater State College",1,0,2009,1453,866,587,420,162,258,0.298,0.289,0.276,910,127.788105,304,1194,0.821748107364074
"4823",165024,"Bridgewater State University",1,0,2010,1431,812,619,458,174,284,0.35,0.32,0.281,910,138.084409,309,1208,0.844164919636618
"4824",165334,"CLARK UNIVERSITY",1,0,1991,561,307,254,344,137,207,0.674,0.613,0.539,15380,57.024,161,322,0.57397504456328
"4825",165334,"CLARK UNIVERSITY",1,0,1992,527,317,210,280,106,174,0.549,0.531,0.505,16200,59.449,159,344,0.652751423149905
"4826",165334,"CLARK UNIVERSITY",1,0,1993,443,257,186,251,102,149,0.58,0.567,0.548,17000,59.614,160,273,0.616252821670429
"4827",165334,"CLARK UNIVERSITY",1,0,1995,505,318,187,311,103,208,0.654,0.616,0.551,19140,65.214,153,299,0.592079207920792
"4828",165334,"CLARK UNIVERSITY",1,0,1996,527,301,226,336,128,208,0.691,0.638,0.566,20040,66.321,158,350,0.664136622390892
"4829",165334,"CLARK UNIVERSITY",1,0,1997,520,313,207,313,110,203,0.649,0.602,0.531,20940,0.051975,156,351,0.675
"4830",165334,"CLARK UNIVERSITY",1,0,1998,501,305,196,323,119,204,0.669,0.645,0.607,21740,54.965,151,321,0.640718562874252
"4831",165334,"CLARK UNIVERSITY",1,0,1999,486,304,182,308,112,196,0.645,0.634,0.615,22400,57.085,150,315,0.648148148148148
"4832",165334,"CLARK UNIVERSITY",1,0,2000,497,292,205,315,120,195,0.668,0.634,0.585,23300,58.709,157,329,0.661971830985915
"4833",165334,"CLARK UNIVERSITY",1,0,2001,511,330,181,354,123,231,0.7,0.693,0.68,24400,61.513,164,342,0.669275929549902
"4834",165334,"CLARK UNIVERSITY",1,0,2002,576,357,219,387,148,239,0.67,0.672,0.676,25600,64.207,166,379,0.657986111111111
"4835",165334,"CLARK UNIVERSITY",1,0,2003,537,324,213,391,150,241,0.744,0.728,0.704,26700,69.623,167,342,0.636871508379888
"4836",165334,"CLARK UNIVERSITY",1,0,2004,523,328,195,383,137,246,0.75,0.732,0.703,28000,70.291,171,327,0.625239005736138
"4837",165334,"Clark University",1,0,2005,557,338,219,422,161,261,0.772,0.758,0.735,29300,74.795,167,383,0.687612208258528
"4838",165334,"Clark University",1,0,2006,563,345,218,425,159,266,0.771,0.755,0.729,31200,80.286,174,399,0.708703374777975
"4839",165334,"Clark University",1,0,2007,572,361,211,432,157,275,0.762,0.755,0.744,32600,82.228,178,402,0.702797202797203
"4840",165334,"Clark University",1,0,2008,586,348,238,424,162,262,0.753,0.724,0.681,33900,90.76,189,408,0.696245733788396
"4841",165334,"Clark University",1,0,2009,548,356,192,422,144,278,0.781,0.77,0.75,34900,91.548,202,401,0.731751824817518
"4842",165334,"Clark University",1,0,2010,575,328,247,411,172,239,0.729,0.715,0.696,36100,91.841,194,404,0.702608695652174
"4843",165662,"EMERSON COLLEGE",1,0,1991,399,269,130,217,89,128,0.476,0.544,0.685,13273,38.036197,91,345,0.864661654135338
"4844",165662,"EMERSON COLLEGE",1,0,1992,408,276,132,198,70,128,0.464,0.485,0.53,13817,40.033024,92,348,0.852941176470588
"4845",165662,"EMERSON COLLEGE",1,0,1993,427,263,164,256,100,156,0.593,0.6,0.61,14743,43.919081,92,369,0.864168618266979
"4846",165662,"EMERSON COLLEGE",1,0,1995,526,313,213,310,121,189,0.604,0.589,0.568,16259,52.677284,93,405,0.769961977186312
"4847",165662,"EMERSON COLLEGE",1,0,1996,547,318,229,358,161,197,0.62,0.654,0.703,17085,56.100206,94,423,0.773308957952468
"4848",165662,"EMERSON COLLEGE",1,0,1997,547,333,214,343,130,213,0.64,0.627,0.607,18242,47.889247,103,447,0.817184643510055
"4849",165662,"EMERSON COLLEGE",1,0,1998,612,368,244,377,150,227,0.617,0.616,0.615,19028,52.966777,106,517,0.844771241830065
"4850",165662,"EMERSON COLLEGE",1,0,1999,653,361,292,433,192,241,0.668,0.663,0.658,18816,54.441654,109,495,0.758039816232772
"4851",165662,"EMERSON COLLEGE",1,0,2000,641,396,245,461,179,282,0.712,0.719,0.731,19520,57.153851,112.5,550,0.858034321372855
"4852",165662,"EMERSON COLLEGE",1,0,2001,643,406,237,440,163,277,0.682,0.684,0.688,20224,60.460179,116,490,0.762052877138414
"4853",165662,"EMERSON COLLEGE",1,0,2002,656,419,237,473,179,294,0.702,0.721,0.755,21120,63.635355,122,513,0.782012195121951
"4854",165662,"EMERSON COLLEGE",1,0,2003,706,413,293,525,229,296,0.717,0.744,0.782,22144,66.627727,128,554,0.784702549575071
"4855",165662,"EMERSON COLLEGE",1,0,2004,700,402,298,533,242,291,0.724,0.761,0.812,22976,76.189345,138,523,0.747142857142857
"4856",165662,"Emerson College",1,0,2005,715,417,298,571,243,328,0.787,0.799,0.815,24064,84.200285,143,557,0.779020979020979
"4857",165662,"Emerson College",1,0,2006,728,409,319,578,254,324,0.792,0.794,0.796,25248,87.787565,149,540,0.741758241758242
"4858",165662,"Emerson College",1,0,2007,842,477,365,671,274,397,0.832,0.797,0.751,26880,91.124352,159,651,0.773159144893112
"4859",165662,"Emerson College",1,0,2008,772,466,306,598,243,355,0.762,0.775,0.794,28352,105.124319,163,429,0.555699481865285
"4860",165662,"Emerson College",1,0,2009,764,486,278,593,215,378,0.778,0.776,0.773,29408,110.349302,177,376,0.492146596858639
"4861",165662,"Emerson College",1,0,2010,824,529,295,634,219,415,0.785,0.769,0.742,30752,111.360949,183,499,0.605582524271845
"4862",165671,"EMMANUEL COLLEGE",1,0,2001,277,189,88,128,32,96,0.508,0.462,0.364,16800,21.069662,48,136,0.490974729241877
"4863",165671,"EMMANUEL COLLEGE",1,0,2002,322,258,64,179,31,148,0.574,0.556,0.484,17800,21.054286,51,215,0.667701863354037
"4864",165671,"EMMANUEL COLLEGE",1,0,2003,406,299,107,222,47,175,0.585,0.547,0.439,18900,25.811517,53,270,0.665024630541872
"4865",165671,"EMMANUEL COLLEGE",1,0,2004,455,332,123,237,58,179,0.539,0.521,0.472,20100,27.583778,57,288,0.632967032967033
"4866",165671,"Emmanuel College",1,0,2005,438,327,111,237,63,174,0.532,0.541,0.568,21900,33.157302,66,318,0.726027397260274
"4867",165671,"Emmanuel College",1,0,2006,467,344,123,233,55,178,0.517,0.499,0.447,23800,38.115173,76,368,0.788008565310492
"4868",165671,"Emmanuel College",1,0,2007,582,436,146,299,74,225,0.516,0.514,0.507,26100,43.035409,86,421,0.723367697594502
"4869",165671,"Emmanuel College",1,0,2008,480,346,134,268,73,195,0.564,0.558,0.545,28200,50.727563,92,344,0.716666666666667
"4870",165671,"Emmanuel College",1,0,2009,423,308,115,235,60,175,0.568,0.556,0.522,29200,50.080725,82,322,0.761229314420804
"4871",165671,"Emmanuel College",1,0,2010,528,386,142,318,81,237,0.614,0.602,0.57,30600,51.816005,91,326,0.617424242424242
"4872",165820,"FITCHBURG STATE COLLEGE",1,0,1991,759,462,297,183,55,128,0.277,0.241,0.185,3134,25.925592,223,706,0.930171277997365
"4873",165820,"FITCHBURG STATE COLLEGE",1,0,1992,538,297,241,128,32,96,0.323,0.238,0.133,3206,28.959056,225,463,0.860594795539034
"4874",165820,"FITCHBURG STATE COLLEGE",1,0,1993,550,304,246,97,18,79,0.26,0.176,0.073,3234,29.922936,224,499,0.907272727272727
"4875",165820,"FITCHBURG STATE COLLEGE",1,0,1995,574,329,245,106,20,86,0.261,0.185,0.082,3316,37.047156,213,468,0.815331010452962
"4876",165820,"FITCHBURG STATE COLLEGE",1,0,1996,436,265,171,95,19,76,0.287,0.218,0.111,3246,43.901192,208,360,0.825688073394495
"4877",165820,"FITCHBURG STATE COLLEGE",1,0,1997,488,270,218,104,29,75,0.278,0.213,0.133,3346,44.491647,203,310,0.635245901639344
"4878",165820,"FITCHBURG STATE COLLEGE",1,0,1998,503,281,222,81,24,57,0.203,0.161,0.108,3198,47.067279,204,369,0.733598409542744
"4879",165820,"FITCHBURG STATE COLLEGE",1,0,1999,345,202,143,73,23,50,0.248,0.212,0.161,1090,47.527792,200,295,0.855072463768116
"4880",165820,"FITCHBURG STATE COLLEGE",1,0,2000,448,275,173,119,30,89,0.324,0.266,0.173,1030,49.473059,200.5,383,0.854910714285714
"4881",165820,"FITCHBURG STATE COLLEGE",1,0,2001,405,220,185,91,29,62,0.282,0.225,0.157,970,53.088412,201,352,0.869135802469136
"4882",165820,"FITCHBURG STATE COLLEGE",1,0,2002,496,292,204,119,41,78,0.267,0.24,0.201,970,50.424742,184,432,0.870967741935484
"4883",165820,"FITCHBURG STATE COLLEGE",1,0,2003,585,320,265,144,50,94,0.294,0.246,0.189,970,50.356089,168,516,0.882051282051282
"4884",165820,"FITCHBURG STATE COLLEGE",1,0,2004,713,386,327,153,52,101,0.262,0.215,0.159,970,49.725779,166,592,0.830294530154278
"4885",165820,"Fitchburg State College",1,0,2005,599,297,302,125,54,71,0.239,0.209,0.179,970,54.058708,166,525,0.876460767946578
"4886",165820,"Fitchburg State College",1,0,2006,728,383,345,172,63,109,0.285,0.236,0.183,970,57.959077,174,611,0.839285714285714
"4887",165820,"Fitchburg State College",1,0,2007,698,366,332,142,56,86,0.235,0.203,0.169,970,63.092444,176,570,0.816618911174785
"4888",165820,"Fitchburg State College",1,0,2008,763,421,342,227,76,151,0.359,0.298,0.222,970,68.405002,184,646,0.846657929226737
"4889",165820,"Fitchburg State College",1,0,2009,781,410,371,217,89,128,0.312,0.278,0.24,970,67.192314,180,682,0.873239436619718
"4890",165820,"Fitchburg State University",1,0,2010,721,413,308,246,86,160,0.387,0.341,0.279,970,68.594527,176,491,0.680998613037448
"4891",165866,"FRAMINGHAM STATE COLLEGE",1,0,1991,385,251,134,114,22,92,0.366,0.296,0.164,2889,21.933786,166,347,0.901298701298701
"4892",165866,"FRAMINGHAM STATE COLLEGE",1,0,1992,577,382,195,154,35,119,0.312,0.267,0.179,2995,21.055056,169,515,0.892547660311958
"4893",165866,"FRAMINGHAM STATE COLLEGE",1,0,1993,517,339,178,117,21,96,0.283,0.226,0.118,3154,24.833714,176,450,0.870406189555126
"4894",165866,"FRAMINGHAM STATE COLLEGE",1,0,1995,600,404,196,122,28,94,0.233,0.203,0.143,3308,28.518687,171,500,0.833333333333333
"4895",165866,"FRAMINGHAM STATE COLLEGE",1,0,1996,644,429,215,127,26,101,0.235,0.197,0.121,3238,37.071146,168,570,0.885093167701863
"4896",165866,"FRAMINGHAM STATE COLLEGE",1,0,1997,590,397,193,120,25,95,0.239,0.203,0.13,3160,39.834766,168,512,0.867796610169492
"4897",165866,"FRAMINGHAM STATE COLLEGE",1,0,1998,601,381,220,136,27,109,0.286,0.226,0.123,3070,40.89881,161,514,0.855241264559068
"4898",165866,"FRAMINGHAM STATE COLLEGE",1,0,1999,559,402,157,130,27,103,0.256,0.233,0.172,1090,42.724007,164,469,0.838998211091234
"4899",165866,"FRAMINGHAM STATE COLLEGE",1,0,2000,612,434,178,153,30,123,0.283,0.25,0.169,1030,45.292974,162.5,506,0.826797385620915
"4900",165866,"FRAMINGHAM STATE COLLEGE",1,0,2001,645,455,190,145,28,117,0.257,0.225,0.147,970,48.137207,161,557,0.863565891472868
"4901",165866,"FRAMINGHAM STATE COLLEGE",1,0,2002,716,500,216,193,38,155,0.31,0.27,0.176,970,46.414122,166,622,0.868715083798883
"4902",165866,"FRAMINGHAM STATE COLLEGE",1,0,2003,617,441,176,202,45,157,0.356,0.327,0.256,970,44.565907,161,526,0.852512155591572
"4903",165866,"FRAMINGHAM STATE COLLEGE",1,0,2004,642,434,208,187,49,138,0.318,0.291,0.236,970,45.597337,158,546,0.850467289719626
"4904",165866,"Framingham State College",1,0,2005,666,461,205,210,44,166,0.36,0.315,0.215,970,50.416525,167,563,0.845345345345345
"4905",165866,"Framingham State College",1,0,2006,714,496,218,242,57,185,0.373,0.339,0.261,970,53.942062,164,583,0.816526610644258
"4906",165866,"Framingham State College",1,0,2007,633,420,213,212,52,160,0.381,0.335,0.244,970,61.181782,165,517,0.816745655608215
"4907",165866,"Framingham State College",1,0,2008,644,450,194,213,49,164,0.364,0.331,0.253,970,68.374693,166,551,0.855590062111801
"4908",165866,"Framingham State College",1,0,2009,719,520,199,261,59,202,0.388,0.363,0.296,970,63.993241,164,609,0.847009735744089
"4909",165866,"Framingham State University",1,0,2010,719,481,238,245,59,186,0.387,0.341,0.248,970,70.269003,163,565,0.785813630041725
"4910",165936,"GORDON COLLEGE",1,0,1991,282,171,111,122,41,81,0.474,0.433,0.369,11400,20.68131,71,236,0.836879432624113
"4911",165936,"GORDON COLLEGE",1,0,1992,292,193,99,140,39,101,0.523,0.479,0.394,12090,22.227242,70,253,0.866438356164384
"4912",165936,"GORDON COLLEGE",1,0,1993,298,186,112,98,27,71,0.382,0.329,0.241,12720,23.779966,71,270,0.906040268456376
"4913",165936,"GORDON COLLEGE",1,0,1995,330,226,104,152,43,109,0.482,0.461,0.413,13950,26.116411,72,303,0.918181818181818
"4914",165936,"GORDON COLLEGE",1,0,1996,326,210,116,152,41,111,0.529,0.466,0.353,14690,27.470336,72,301,0.923312883435583
"4915",165936,"GORDON COLLEGE",1,0,1997,406,279,127,206,68,138,0.495,0.507,0.535,15150,23.034273,75,381,0.938423645320197
"4916",165936,"GORDON COLLEGE",1,0,1998,417,289,128,214,65,149,0.516,0.513,0.508,15760,24.492547,79,391,0.937649880095923
"4917",165936,"GORDON COLLEGE",1,0,1999,382,243,139,205,61,144,0.593,0.537,0.439,15740,27.696774,83,356,0.931937172774869
"4918",165936,"GORDON COLLEGE",1,0,2000,411,274,137,233,71,162,0.591,0.567,0.518,16550,29.763625,85,389,0.94647201946472
"4919",165936,"GORDON COLLEGE",1,0,2001,441,313,128,246,63,183,0.585,0.558,0.492,17378,31.642373,87,407,0.922902494331066
"4920",165936,"GORDON COLLEGE",1,0,2002,400,266,134,248,77,171,0.643,0.62,0.575,18230,35.928438,93,353,0.8825
"4921",165936,"GORDON COLLEGE",1,0,2003,427,274,153,260,86,174,0.635,0.609,0.562,19334,39.123409,91,382,0.894613583138173
"4922",165936,"GORDON COLLEGE",1,0,2004,401,264,137,235,75,160,0.606,0.586,0.547,20494,41.24326,94,343,0.855361596009975
"4923",165936,"Gordon College",1,0,2005,414,259,155,254,79,175,0.676,0.614,0.51,21930,43.88558,95,368,0.888888888888889
"4924",165936,"Gordon College",1,0,2006,380,250,130,225,71,154,0.616,0.592,0.546,23224,46.37311,97,340,0.894736842105263
"4925",165936,"Gordon College",1,0,2007,454,286,168,264,95,169,0.591,0.581,0.565,24652,47.645636,99,392,0.863436123348018
"4926",165936,"Gordon College",1,0,2008,419,260,159,256,91,165,0.635,0.611,0.572,26132,51.950741,98,354,0.844868735083532
"4927",165936,"Gordon College",1,0,2009,381,237,144,233,71,162,0.683,0.612,0.493,27152,52.723233,94,313,0.821522309711286
"4928",165936,"Gordon College",1,0,2010,348,212,136,212,80,132,0.623,0.609,0.588,28210,51.322431,97,276,0.793103448275862
"4929",166027,"HARVARD UNIVERSITY",1,0,1991,1601,669,932,1347,759,588,0.879,0.841,0.814,15410,1184.781,1533,925,0.577763897564022
"4930",166027,"HARVARD UNIVERSITY",1,0,1992,1603,686,917,1380,782,598,0.872,0.861,0.853,16454,1262.269,1498,667,0.416094822208359
"4931",166027,"HARVARD UNIVERSITY",1,0,1993,1601,715,886,1358,743,615,0.86,0.848,0.839,17470,1327.024,1362,669,0.417863835103061
"4932",166027,"HARVARD UNIVERSITY",1,0,1995,1606,738,868,1343,705,638,0.865,0.836,0.812,19472,1469.446,1115,779,0.48505603985056
"4933",166027,"HARVARD UNIVERSITY",1,0,1996,1611,721,890,1390,754,636,0.882,0.863,0.847,20424,1520.985,1129,685,0.4252017380509
"4934",166027,"HARVARD UNIVERSITY",1,0,1997,1642,782,860,1436,744,692,0.885,0.875,0.865,21266,1531.781,1156,629,0.383069427527406
"4935",166027,"HARVARD UNIVERSITY",1,0,1998,1650,772,878,1423,748,675,0.874,0.862,0.852,22028,1629.514,1247,711,0.430909090909091
"4936",166027,"HARVARD UNIVERSITY",1,0,1999,1647,775,872,1429,757,672,0.867,0.868,0.868,22054,1784.112,1272,770,0.467516697024894
"4937",166027,"HARVARD UNIVERSITY",1,0,2000,1638,755,883,1431,757,674,0.893,0.874,0.857,22694,1902.469,1318.5,731,0.446275946275946
"4938",166027,"HARVARD UNIVERSITY",1,0,2001,1637,786,851,1448,742,706,0.898,0.885,0.872,23457,2063.27,1365,749,0.457544288332315
"4939",166027,"HARVARD UNIVERSITY",1,0,2002,1619,783,836,1422,710,712,0.909,0.878,0.849,24630,2286.586,1387,838,0.517603458925262
"4940",166027,"HARVARD UNIVERSITY",1,0,2003,1633,782,851,1433,726,707,0.904,0.878,0.853,26066,2432.944,1349,803,0.491733006736069
"4941",166027,"HARVARD UNIVERSITY",1,0,2004,1638,823,815,1427,688,739,0.898,0.871,0.844,27448,2560.919,1352,757,0.462148962148962
"4942",166027,"Harvard University",1,0,2005,1637,819,818,1421,698,723,0.883,0.868,0.853,28752,2757.373,1550,776,0.474037874160049
"4943",166027,"Harvard University",1,0,2006,1679,878,801,1448,664,784,0.893,0.862,0.829,30275,2999.503,1560,739,0.440142942227516
"4944",166027,"Harvard University",1,0,2007,1657,839,818,1434,695,739,0.881,0.865,0.85,31456,3170.65,1607,694,0.418829209414605
"4945",166027,"Harvard University",1,0,2008,1656,836,820,1420,677,743,0.889,0.857,0.826,32557,3464.893,1644,741,0.447463768115942
"4946",166027,"Harvard University",1,0,2009,1662,837,825,1425,673,752,0.898,0.857,0.816,33696,3756.071,1661,742,0.446450060168472
"4947",166027,"Harvard University",1,0,2010,1663,827,836,1434,708,726,0.878,0.862,0.847,34976,3729.582,1739,767,0.461214672279014
"4948",166124,"COLLEGE OF THE HOLY CROSS",1,0,1991,728,344,384,631,329,302,0.878,0.867,0.857,15530,65.169048,179,653,0.896978021978022
"4949",166124,"COLLEGE OF THE HOLY CROSS",1,0,1992,765,428,337,698,308,390,0.911,0.912,0.914,16300,71.163517,186,724,0.94640522875817
"4950",166124,"COLLEGE OF THE HOLY CROSS",1,0,1993,658,350,308,598,277,321,0.917,0.909,0.899,17200,75.667114,186,625,0.949848024316109
"4951",166124,"COLLEGE OF THE HOLY CROSS",1,0,1995,710,384,326,618,287,331,0.862,0.87,0.88,18900,85.392833,186,612,0.861971830985915
"4952",166124,"COLLEGE OF THE HOLY CROSS",1,0,1996,688,349,339,611,287,324,0.928,0.888,0.847,19700,89.383664,190,567,0.824127906976744
"4953",166124,"COLLEGE OF THE HOLY CROSS",1,0,1997,726,409,317,635,270,365,0.892,0.875,0.852,21080,71.608798,188,584,0.804407713498623
"4954",166124,"COLLEGE OF THE HOLY CROSS",1,0,1998,723,354,369,623,305,318,0.898,0.862,0.827,22005,74.758944,191,561,0.775933609958506
"4955",166124,"COLLEGE OF THE HOLY CROSS",1,0,1999,722,383,339,645,298,347,0.906,0.893,0.879,22500,81.666959,195,566,0.78393351800554
"4956",166124,"COLLEGE OF THE HOLY CROSS",1,0,2000,706,376,330,626,284,342,0.91,0.887,0.861,23400,88.918915,191.5,551,0.780453257790368
"4957",166124,"COLLEGE OF THE HOLY CROSS",1,0,2001,691,366,325,609,274,335,0.915,0.881,0.843,24600,92.382955,188,533,0.771345875542692
"4958",166124,"COLLEGE OF THE HOLY CROSS",1,0,2002,669,348,321,644,300,344,0.988,0.963,0.935,26000,98.304893,197,508,0.759342301943199
"4959",166124,"COLLEGE OF THE HOLY CROSS",1,0,2003,698,378,320,607,270,337,0.892,0.87,0.844,27560,104.840867,226,546,0.782234957020057
"4960",166124,"COLLEGE OF THE HOLY CROSS",1,0,2004,703,389,314,635,274,361,0.928,0.903,0.873,29220,108.834346,236,524,0.745376955903272
"4961",166124,"College of the Holy Cross",1,0,2005,723,399,324,645,281,364,0.912,0.892,0.867,30960,113.377166,234,505,0.698478561549101
"4962",166124,"College of the Holy Cross",1,0,2006,751,415,336,675,293,382,0.92,0.899,0.872,32820,120.624257,232,538,0.716378162450067
"4963",166124,"College of the Holy Cross",1,0,2007,718,398,320,639,272,367,0.922,0.89,0.85,34630,126.387055,236,460,0.64066852367688
"4964",166124,"College of the Holy Cross",1,0,2008,737,420,317,664,285,379,0.902,0.901,0.899,36710,133.464239,257,448,0.6078697421981
"4965",166124,"College of the Holy Cross",1,0,2009,746,379,367,666,320,346,0.913,0.893,0.872,38180,142.72403,241,539,0.722520107238606
"4966",166124,"College of the Holy Cross",1,0,2010,727,379,348,645,298,347,0.916,0.887,0.856,39330,140.764771,249,464,0.638239339752407
"4967",166513,"UNIVERSITY OF MASSACHUSETTS AT LOWELL",1,0,1991,1075,386,689,276,146,130,0.337,0.257,0.212,4337,89.706681,471,902,0.83906976744186
"4968",166513,"UNIVERSITY OF MASSACHUSETTS AT LOWELL",1,0,1992,964,340,624,239,134,105,0.309,0.248,0.215,4513,112.028006,462,806,0.836099585062241
"4969",166513,"UNIVERSITY OF MASSACHUSETTS-LOWELL",1,0,1993,1033,392,641,217,108,109,0.278,0.21,0.168,4602,118.76576,476,886,0.857696030977735
"4970",166513,"UNIVERSITY OF MASSACHUSETTS-LOWELL",1,0,1995,1102,422,680,195,90,105,0.249,0.177,0.132,4606,127.153423,434,874,0.793103448275862
"4971",166513,"UNIVERSITY OF MASSACHUSETTS-LOWELL",1,0,1996,1022,428,594,228,96,132,0.308,0.223,0.162,4512,132.191443,406,811,0.793542074363992
"4972",166513,"UNIVERSITY OF MASSACHUSETTS-LOWELL",1,0,1997,989,367,622,232,104,128,0.349,0.235,0.167,4422,131.205131,416,768,0.776541961577351
"4973",166513,"UNIVERSITY OF MASSACHUSETTS-LOWELL",1,0,1998,997,366,631,235,116,119,0.325,0.236,0.184,4337,142.792,415,792,0.794383149448345
"4974",166513,"UNIVERSITY OF MASSACHUSETTS-LOWELL",1,0,1999,935,368,567,230,91,139,0.378,0.246,0.16,1454,144.45,411,587,0.627807486631016
"4975",166513,"UNIVERSITY OF MASSACHUSETTS-LOWELL",1,0,2000,996,373,623,299,140,159,0.426,0.3,0.225,1454,153.437,405,670,0.672690763052209
"4976",166513,"UNIVERSITY OF MASSACHUSETTS-LOWELL",1,0,2001,967,349,618,269,128,141,0.404,0.278,0.207,1454,165.314,399,568,0.587383660806618
"4977",166513,"UNIVERSITY OF MASSACHUSETTS-LOWELL",1,0,2002,1013,371,642,289,138,151,0.407,0.285,0.215,1454,155.316,359,716,0.706811451135242
"4978",166513,"UNIVERSITY OF MASSACHUSETTS-LOWELL",1,0,2003,1008,393,615,291,145,146,0.372,0.289,0.236,1454,156.069,361,842,0.83531746031746
"4979",166513,"UNIVERSITY OF MASSACHUSETTS-LOWELL",1,0,2004,996,333,663,286,134,152,0.456,0.287,0.202,1454,162.653,361,791,0.794176706827309
"4980",166513,"University of Massachusetts-Lowell",1,0,2005,1062,390,672,318,160,158,0.405,0.299,0.238,1454,194.043,383,840,0.790960451977401
"4981",166513,"University of Massachusetts-Lowell",1,0,2006,1208,451,757,355,190,165,0.366,0.294,0.251,1454,208.581,405,908,0.751655629139073
"4982",166513,"University of Massachusetts-Lowell",1,0,2007,1220,424,796,346,179,167,0.394,0.284,0.225,1454,220.998,406,971,0.795901639344262
"4983",166513,"University of Massachusetts-Lowell",1,0,2008,1514,540,974,411,213,198,0.367,0.271,0.219,1454,231.092,414,1139,0.752311756935271
"4984",166513,"University of Massachusetts-Lowell",1,0,2009,1499,548,951,465,243,222,0.405,0.31,0.256,1454,231.826,402,1102,0.735156771180787
"4985",166513,"University of Massachusetts-Lowell",1,0,2010,1601,575,1026,514,272,242,0.421,0.321,0.265,1454,249.209,434,1196,0.747033104309806
"4986",166629,"UNIVERSITY OF MASSACHUSETTS AT AMHERST",1,0,1991,3435,1665,1770,1271,511,760,0.456,0.37,0.289,4863,405.904643,1138,2863,0.833478893740902
"4987",166629,"UNIVERSITY OF MASSACHUSETTS AT AMHERST",1,0,1992,3993,1940,2053,1329,538,791,0.408,0.333,0.262,5062,395.249651,1152,3239,0.811169546706737
"4988",166629,"UNIVERSITY OF MASSACHUSETTS-AMHERST",1,0,1993,3926,1908,2018,1436,577,859,0.45,0.366,0.286,5467,442.172,1172,3187,0.811767702496179
"4989",166629,"UNIVERSITY OF MASSACHUSETTS-AMHERST",1,0,1995,3959,1946,2013,1429,583,846,0.435,0.361,0.29,5514,487.145,1146,3166,0.799696893154837
"4990",166629,"UNIVERSITY OF MASSACHUSETTS-AMHERST",1,0,1996,4073,1964,2109,1577,660,917,0.467,0.387,0.313,5413,501.023,1164,2951,0.724527375398969
"4991",166629,"UNIVERSITY OF MASSACHUSETTS-AMHERST",1,0,1997,3831,2012,1819,1635,614,1021,0.508,0.427,0.338,5329,543.62,1154,2729,0.712346645784391
"4992",166629,"UNIVERSITY OF MASSACHUSETTS-AMHERST",1,0,1998,3953,2021,1932,1651,625,1026,0.508,0.418,0.323,5229,574.743236,1140,2840,0.718441689855806
"4993",166629,"UNIVERSITY OF MASSACHUSETTS-AMHERST",1,0,1999,4144,2199,1945,1824,701,1123,0.511,0.44,0.36,1714,569.604,1161,3065,0.739623552123552
"4994",166629,"UNIVERSITY OF MASSACHUSETTS-AMHERST",1,0,2000,3803,2086,1717,1768,667,1101,0.528,0.465,0.388,1714,598.259,1156,2933,0.771233236918222
"4995",166629,"UNIVERSITY OF MASSACHUSETTS-AMHERST",1,0,2001,4289,2298,1991,2046,783,1263,0.55,0.477,0.393,1714,615.978,1151,3316,0.773140592212637
"4996",166629,"UNIVERSITY OF MASSACHUSETTS-AMHERST",1,0,2002,3411,1799,1612,1682,707,975,0.542,0.493,0.439,1714,578.229,1063,2678,0.785107006742891
"4997",166629,"UNIVERSITY OF MASSACHUSETTS-AMHERST",1,0,2003,4149,2060,2089,1958,850,1108,0.538,0.472,0.407,1714,573.142,1078,3237,0.780187997107737
"4998",166629,"UNIVERSITY OF MASSACHUSETTS-AMHERST",1,0,2004,4311,2126,2185,2196,968,1228,0.578,0.509,0.443,1714,602.55,1100,3325,0.771282765019717
"4999",166629,"University of Massachusetts-Amherst",1,0,2005,4510,2316,2194,2268,970,1298,0.56,0.503,0.442,1714,691.482,1148,3541,0.785144124168514
"5000",166629,"University of Massachusetts-Amherst",1,0,2006,4265,2174,2091,2259,1002,1257,0.578,0.53,0.479,1714,730.497,1168,3116,0.730597889800703
"5001",166629,"University of Massachusetts Amherst",1,0,2007,4374,2321,2053,2504,1060,1444,0.622,0.572,0.516,1714,763.047,1175,3165,0.723593964334705
"5002",166629,"University of Massachusetts Amherst",1,0,2008,4256,2200,2056,2594,1140,1454,0.661,0.609,0.554,1714,799.926,1180,2869,0.674107142857143
"5003",166629,"University of Massachusetts Amherst",1,0,2009,4215,2175,2040,2703,1192,1511,0.695,0.641,0.584,1714,807.314,1180,2653,0.629418742586002
"5004",166629,"University of Massachusetts Amherst",1,0,2010,4543,2296,2247,2986,1336,1650,0.719,0.657,0.595,1714,820.854,1173,2958,0.651111600264143
"5005",166638,"UNIVERSITY OF MASSACHUSETTS AT BOSTON",1,0,1991,529,270,259,68,27,41,0.152,0.129,0.104,3937,108.559944,445,296,0.559546313799622
"5006",166638,"UNIVERSITY OF MASSACHUSETTS AT BOSTON",1,0,1992,534,256,278,48,18,30,0.117,0.09,0.065,4094,108.822716,457,280,0.524344569288389
"5007",166638,"UNIVERSITY OF MASSACHUSETTS-BOSTON",1,0,1993,546,253,293,44,15,29,0.115,0.081,0.051,4253,126.910523,473,275,0.503663003663004
"5008",166638,"UNIVERSITY OF MASSACHUSETTS-BOSTON",1,0,1995,502,222,280,38,17,21,0.095,0.076,0.061,4405,135.648591,464,229,0.456175298804781
"5009",166638,"UNIVERSITY OF MASSACHUSETTS-BOSTON",1,0,1996,538,274,264,55,14,41,0.15,0.102,0.053,4348,141.15793,449,260,0.483271375464684
"5010",166638,"UNIVERSITY OF MASSACHUSETTS-BOSTON",1,0,1997,533,284,249,65,25,40,0.141,0.122,0.1,4290,147.619652,452,232,0.435272045028143
"5011",166638,"UNIVERSITY OF MASSACHUSETTS-BOSTON",1,0,1998,579,307,272,69,29,40,0.13,0.119,0.107,4197,153.872213,448,256,0.442141623488774
"5012",166638,"UNIVERSITY OF MASSACHUSETTS-BOSTON",1,0,1999,671,368,303,102,33,69,0.188,0.152,0.109,1714,158.262344,456,287,0.427719821162444
"5013",166638,"UNIVERSITY OF MASSACHUSETTS-BOSTON",1,0,2000,593,326,267,91,14,77,0.236,0.153,0.052,1714,169.795,462,271,0.456998313659359
"5014",166638,"UNIVERSITY OF MASSACHUSETTS-BOSTON",1,0,2001,676,359,317,67,22,45,0.125,0.099,0.069,1714,184.735,468,277,0.409763313609467
"5015",166638,"UNIVERSITY OF MASSACHUSETTS-BOSTON",1,0,2002,534,307,227,64,16,48,0.156,0.12,0.07,1714,188.017,427,218,0.408239700374532
"5016",166638,"UNIVERSITY OF MASSACHUSETTS-BOSTON",1,0,2003,602,353,249,60,21,39,0.111,0.1,0.084,1714,192.452,433,260,0.431893687707641
"5017",166638,"UNIVERSITY OF MASSACHUSETTS-BOSTON",1,0,2004,543,323,220,61,12,49,0.152,0.112,0.055,1714,200.735,435,216,0.397790055248619
"5018",166638,"University of Massachusetts-Boston",1,0,2005,723,419,304,100,34,66,0.158,0.138,0.112,1714,227.57,445,328,0.453665283540802
"5019",166638,"University of Massachusetts-Boston",1,0,2006,846,484,362,109,29,80,0.165,0.129,0.08,1714,244.051,435,388,0.458628841607565
"5020",166638,"University of Massachusetts-Boston",1,0,2007,950,558,392,144,42,102,0.183,0.152,0.107,1714,257.392,444,419,0.441052631578947
"5021",166638,"University of Massachusetts-Boston",1,0,2008,972,570,402,154,60,94,0.165,0.158,0.149,1714,267.615,462,441,0.453703703703704
"5022",166638,"University of Massachusetts-Boston",1,0,2009,934,545,389,154,53,101,0.185,0.165,0.136,1714,269.591,499,429,0.4593147751606
"5023",166638,"University of Massachusetts-Boston",1,0,2010,1067,595,472,194,55,139,0.234,0.182,0.117,1714,277.418,525,459,0.430178069353327
"5024",166683,"MASSACHUSETTS INSTITUTE OF TECHNOLOGY",1,0,1991,1048,367,681,825,516,309,0.842,0.787,0.758,16900,1089.212,986,511,0.487595419847328
"5025",166683,"MASSACHUSETTS INSTITUTE OF TECHNOLOGY",1,0,1992,1137,398,739,919,583,336,0.844,0.808,0.789,18000,1092.549,989,549,0.482849604221636
"5026",166683,"MASSACHUSETTS INSTITUTE OF TECHNOLOGY",1,0,1993,1074,366,708,874,546,328,0.896,0.814,0.771,19000,1132.191,989,492,0.458100558659218
"5027",166683,"MASSACHUSETTS INSTITUTE OF TECHNOLOGY",1,0,1995,1115,468,647,921,517,404,0.863,0.826,0.799,21000,1167.241,981,546,0.489686098654709
"5028",166683,"MASSACHUSETTS INSTITUTE OF TECHNOLOGY",1,0,1996,1065,446,619,875,498,377,0.845,0.822,0.805,22000,1223.867,906,359,0.337089201877934
"5029",166683,"MASSACHUSETTS INSTITUTE OF TECHNOLOGY",1,0,1997,1066,405,661,861,521,340,0.84,0.808,0.788,23100,1186.573,942,370,0.347091932457786
"5030",166683,"MASSACHUSETTS INSTITUTE OF TECHNOLOGY",1,0,1998,1042,446,596,840,466,374,0.839,0.806,0.782,24050,0,958,364,0.349328214971209
"5031",166683,"MASSACHUSETTS INSTITUTE OF TECHNOLOGY",1,0,1999,1049,448,601,863,473,390,0.87,0.823,0.787,25000,1287.287,951,369,0.351763584366063
"5032",166683,"MASSACHUSETTS INSTITUTE OF TECHNOLOGY",1,0,2000,1010,425,585,825,468,357,0.84,0.817,0.8,26050,1289.988,964,347,0.343564356435644
"5033",166683,"MASSACHUSETTS INSTITUTE OF TECHNOLOGY",1,0,2001,1027,426,601,857,479,378,0.887,0.834,0.797,26960,1385.108,977,383,0.372930866601753
"5034",166683,"MASSACHUSETTS INSTITUTE OF TECHNOLOGY",1,0,2002,977,420,557,806,446,360,0.857,0.825,0.801,28030,1535.949,1044,340,0.348004094165814
"5035",166683,"MASSACHUSETTS INSTITUTE OF TECHNOLOGY",1,0,2003,1018,459,559,842,450,392,0.854,0.827,0.805,29400,1686.573,1043,368,0.361493123772102
"5036",166683,"MASSACHUSETTS INSTITUTE OF TECHNOLOGY",1,0,2004,1076,457,619,909,507,402,0.88,0.845,0.819,30600,1839.905,1055,388,0.360594795539033
"5037",166683,"Massachusetts Institute of Technology",1,0,2005,995,465,530,847,436,411,0.884,0.851,0.823,32100,2035.146,1117,393,0.394974874371859
"5038",166683,"Massachusetts Institute of Technology",1,0,2006,1001,447,554,837,457,380,0.85,0.836,0.825,33400,2181.696,1202,373,0.372627372627373
"5039",166683,"Massachusetts Institute of Technology",1,0,2007,1068,492,576,892,463,429,0.872,0.835,0.804,34750,2207.621,1200,412,0.385767790262172
"5040",166683,"Massachusetts Institute of Technology",1,0,2008,1046,487,559,849,441,408,0.838,0.812,0.789,36140,2301.687,1215,359,0.34321223709369
"5041",166683,"Massachusetts Institute of Technology",1,0,2009,1066,477,589,874,462,412,0.864,0.82,0.784,37510,2461.286,1200,390,0.365853658536585
"5042",166683,"Massachusetts Institute of Technology",1,0,2010,1063,479,584,898,478,420,0.877,0.845,0.818,38940,2382.566,1189,416,0.39134524929445
"5043",167288,"NORTH ADAMS STATE COLLEGE",1,0,1991,423,211,212,81,26,55,0.261,0.191,0.123,3218,16.50601,98,397,0.938534278959811
"5044",167288,"NORTH ADAMS STATE COLLEGE",1,0,1992,203,105,98,49,18,31,0.295,0.241,0.184,3345,18.156114,90,187,0.921182266009852
"5045",167288,"NORTH ADAMS STATE COLLEGE",1,0,1993,228,107,121,39,11,28,0.262,0.171,0.091,3493,17.624397,91,205,0.899122807017544
"5046",167288,"NORTH ADAMS STATE COLLEGE",1,0,1995,290,171,119,80,15,65,0.38,0.276,0.126,3555,19.713024,95,272,0.937931034482759
"5047",167288,"NORTH ADAMS STATE COLLEGE",1,0,1996,311,176,135,101,35,66,0.375,0.325,0.259,3485,22.890453,88,283,0.909967845659164
"5048",167288,"MASSACHUSETTS COLLEGE OF LIBERAL ARTS",1,0,1997,274,152,122,89,30,59,0.388,0.325,0.246,3437,24.531121,90,241,0.87956204379562
"5049",167288,"MASSACHUSETTS COLLEGE OF LIBERAL ARTS",1,0,1998,209,131,78,66,17,49,0.374,0.316,0.218,3377,25.210961,84,172,0.822966507177033
"5050",167288,"MASSACHUSETTS COLLEGE OF LIBERAL ARTS",1,0,1999,220,135,85,78,27,51,0.378,0.355,0.318,1090,25.638632,84,181,0.822727272727273
"5051",167288,"MASSACHUSETTS COLLEGE OF LIBERAL ARTS",1,0,2000,224,126,98,80,32,48,0.381,0.357,0.327,1090,26.989196,85,202,0.901785714285714
"5052",167288,"MASSACHUSETTS COLLEGE OF LIBERAL ARTS",1,0,2001,268,171,97,85,26,59,0.345,0.317,0.268,1030,27.142712,86,232,0.865671641791045
"5053",167288,"MASSACHUSETTS COLLEGE OF LIBERAL ARTS",1,0,2002,265,159,106,106,38,68,0.428,0.4,0.358,1030,27.314897,80,240,0.905660377358491
"5054",167288,"MASSACHUSETTS COLLEGE OF LIBERAL ARTS",1,0,2003,244,149,95,91,28,63,0.423,0.373,0.295,1030,26.627463,80,221,0.905737704918033
"5055",167288,"MASSACHUSETTS COLLEGE OF LIBERAL ARTS",1,0,2004,263,161,102,99,28,71,0.441,0.376,0.275,1030,27.158548,76,231,0.878326996197719
"5056",167288,"Massachusetts College of Liberal Arts",1,0,2005,271,177,94,104,36,68,0.384,0.384,0.383,1030,30.3899,85,238,0.878228782287823
"5057",167288,"Massachusetts College of Liberal Arts",1,0,2006,299,175,124,94,33,61,0.349,0.314,0.266,1030,33.401714,87,246,0.822742474916388
"5058",167288,"Massachusetts College of Liberal Arts",1,0,2007,334,207,127,128,37,91,0.44,0.383,0.291,1030,36.271288,84,285,0.853293413173653
"5059",167288,"Massachusetts College of Liberal Arts",1,0,2008,325,193,132,109,38,71,0.368,0.335,0.288,1030,38.789498,90,265,0.815384615384615
"5060",167288,"Massachusetts College of Liberal Arts",1,0,2009,347,229,118,119,40,79,0.345,0.343,0.339,1030,37.821348,84,265,0.763688760806916
"5061",167288,"Massachusetts College of Liberal Arts",1,0,2010,351,225,126,133,41,92,0.409,0.379,0.325,1030,38.649694,89,249,0.709401709401709
"5062",167987,"UNIVERSITY OF MASSACHUSETTS AT DARTMOUTH",1,0,1991,989,515,474,285,109,176,0.342,0.288,0.23,3053,62.118456,313,878,0.887765419615773
"5063",167987,"UNIVERSITY OF MASSACHUSETTS DARTMOUTH",1,0,1992,869,453,416,223,75,148,0.327,0.257,0.18,3163,61.843368,315,800,0.920598388952819
"5064",167987,"UNIVERSITY OF MASSACHUSETTS-DARTMOUTH",1,0,1993,985,489,496,234,87,147,0.301,0.238,0.175,3568,63.036006,330,853,0.865989847715736
"5065",167987,"UNIVERSITY OF MASSACHUSETTS-DARTMOUTH",1,0,1995,886,420,466,253,90,163,0.388,0.286,0.193,4122,80.044691,333,709,0.800225733634311
"5066",167987,"UNIVERSITY OF MASSACHUSETTS-DARTMOUTH",1,0,1996,825,429,396,240,71,169,0.394,0.291,0.179,4151,85.30356,326,619,0.75030303030303
"5067",167987,"UNIVERSITY OF MASSACHUSETTS-DARTMOUTH",1,0,1997,835,440,395,217,72,145,0.33,0.26,0.182,4254,85.371777,317,638,0.764071856287425
"5068",167987,"UNIVERSITY OF MASSACHUSETTS-DARTMOUTH",1,0,1998,1086,535,551,284,102,182,0.34,0.262,0.185,4171,94.389876,334,853,0.785451197053407
"5069",167987,"UNIVERSITY OF MASSACHUSETTS-DARTMOUTH",1,0,1999,1131,556,575,316,126,190,0.342,0.279,0.219,1417,101.109373,340,891,0.787798408488064
"5070",167987,"UNIVERSITY OF MASSACHUSETTS-DARTMOUTH",1,0,2000,1300,642,658,363,142,221,0.344,0.279,0.216,1417,108.148,347.5,1040,0.8
"5071",167987,"UNIVERSITY OF MASSACHUSETTS-DARTMOUTH",1,0,2001,1148,575,573,310,125,185,0.322,0.27,0.218,1417,129.29256,355,924,0.804878048780488
"5072",167987,"UNIVERSITY OF MASSACHUSETTS-DARTMOUTH",1,0,2002,1699,825,874,452,191,261,0.316,0.266,0.219,1417,131.071,321,1351,0.795173631547969
"5073",167987,"UNIVERSITY OF MASSACHUSETTS-DARTMOUTH",1,0,2003,1510,764,746,489,187,302,0.395,0.324,0.251,1417,122.249,329,1215,0.804635761589404
"5074",167987,"UNIVERSITY OF MASSACHUSETTS-DARTMOUTH",1,0,2004,1456,715,741,416,147,269,0.376,0.286,0.198,1417,137.248,340,1173,0.805631868131868
"5075",167987,"University of Massachusetts-Dartmouth",1,0,2005,1703,816,887,505,212,293,0.359,0.297,0.239,1417,160.281,355,1394,0.818555490311216
"5076",167987,"University of Massachusetts-Dartmouth",1,0,2006,1763,866,897,559,248,311,0.359,0.317,0.276,1417,173.341,359,1460,0.828133862733976
"5077",167987,"University of Massachusetts-Dartmouth",1,0,2007,1901,859,1042,575,262,313,0.364,0.302,0.251,1417,192.085,365,1590,0.836401893740137
"5078",167987,"University of Massachusetts-Dartmouth",1,0,2008,1768,837,931,485,210,275,0.329,0.274,0.226,1417,204.056,368,1447,0.818438914027149
"5079",167987,"University of Massachusetts-Dartmouth",1,0,2009,1780,822,958,494,212,282,0.343,0.278,0.221,1417,195.692,369,1400,0.786516853932584
"5080",167987,"University of Massachusetts-Dartmouth",1,0,2010,1667,765,902,471,208,263,0.344,0.283,0.231,1417,200.57,375,1085,0.650869826034793
"5081",167996,"STONEHILL COLLEGE",1,0,1991,518,279,239,359,160,199,0.713,0.693,0.669,10240,25.685119,109,494,0.953667953667954
"5082",167996,"STONEHILL COLLEGE",1,0,1992,514,314,200,387,135,252,0.802,0.753,0.675,10820,35.017223,112,494,0.961089494163424
"5083",167996,"STONEHILL COLLEGE",1,0,1993,585,331,254,411,159,252,0.761,0.703,0.626,11420,35.586054,116,552,0.943589743589744
"5084",167996,"STONEHILL COLLEGE",1,0,1995,547,328,219,443,166,277,0.845,0.81,0.758,13284,40.379959,118,499,0.912248628884826
"5085",167996,"STONEHILL COLLEGE",1,0,1996,551,310,241,419,169,250,0.807,0.76,0.701,14170,37.037074,118,509,0.923774954627949
"5086",167996,"STONEHILL COLLEGE",1,0,1997,530,287,243,429,185,244,0.85,0.809,0.761,14856,44.055882,119,486,0.916981132075472
"5087",167996,"STONEHILL COLLEGE",1,0,1998,531,313,218,421,168,253,0.808,0.793,0.771,15730,37.910276,122,495,0.932203389830508
"5088",167996,"STONEHILL COLLEGE",1,0,1999,572,333,239,458,185,273,0.82,0.801,0.774,15736,40.663683,123,522,0.912587412587413
"5089",167996,"STONEHILL COLLEGE",1,0,2000,629,363,266,517,210,307,0.846,0.822,0.789,16680,42.372469,125,582,0.925278219395866
"5090",167996,"STONEHILL COLLEGE",1,0,2001,586,328,258,479,203,276,0.842,0.817,0.787,17680,45.531118,127,522,0.890784982935154
"5091",167996,"STONEHILL COLLEGE",1,0,2002,566,342,224,448,160,288,0.842,0.792,0.714,19094,47.927811,125,517,0.913427561837456
"5092",167996,"STONEHILL COLLEGE",1,0,2003,565,307,258,451,193,258,0.84,0.798,0.748,20432,52.00412,130,496,0.87787610619469
"5093",167996,"STONEHILL COLLEGE",1,0,2004,614,384,230,494,171,323,0.841,0.805,0.743,22068,56.058759,133,554,0.90228013029316
"5094",167996,"Stonehill College",1,0,2005,616,354,262,478,190,288,0.814,0.776,0.725,24160,59.624546,136,557,0.904220779220779
"5095",167996,"Stonehill College",1,0,2006,594,363,231,469,173,296,0.815,0.79,0.749,26345,64.352392,135,542,0.912457912457912
"5096",167996,"Stonehill College",1,0,2007,659,409,250,539,199,340,0.831,0.818,0.796,28065,66.312241,145,615,0.933232169954476
"5097",167996,"Stonehill College",1,0,2008,634,384,250,503,185,318,0.828,0.793,0.74,30150,72.209311,148,570,0.899053627760252
"5098",167996,"Stonehill College",1,0,2009,683,397,286,564,219,345,0.869,0.826,0.766,31210,76.842067,152,611,0.894582723279649
"5099",167996,"Stonehill College",1,0,2010,727,469,258,556,180,376,0.802,0.765,0.698,32620,79.369464,155,629,0.865199449793673
"5100",168005,"SUFFOLK UNIVERSITY",1,0,1991,421,214,207,137,55,82,0.383,0.325,0.266,8535,50.029768,214,299,0.71021377672209
"5101",168005,"SUFFOLK UNIVERSITY",1,0,1992,382,190,192,113,43,70,0.368,0.296,0.224,9150,54.70796,226,274,0.717277486910995
"5102",168005,"SUFFOLK UNIVERSITY",1,0,1993,357,185,172,114,43,71,0.384,0.319,0.25,9940,60.320262,232,207,0.579831932773109
"5103",168005,"SUFFOLK UNIVERSITY",1,0,1995,386,214,172,110,39,71,0.332,0.285,0.227,11450,71.451979,233,231,0.598445595854922
"5104",168005,"SUFFOLK UNIVERSITY",1,0,1996,507,288,219,140,46,94,0.326,0.276,0.21,12200,75.266884,246,314,0.619329388560158
"5105",168005,"SUFFOLK UNIVERSITY",1,0,1997,525,299,226,198,70,128,0.428,0.377,0.31,12900,73.180517,249,340,0.647619047619048
"5106",168005,"SUFFOLK UNIVERSITY",1,0,1998,620,355,265,208,75,133,0.375,0.335,0.283,13740,79.998004,258,385,0.620967741935484
"5107",168005,"SUFFOLK UNIVERSITY",1,0,1999,672,381,291,240,72,168,0.441,0.357,0.247,14580,87.6075,264,423,0.629464285714286
"5108",168005,"SUFFOLK UNIVERSITY",1,0,2000,645,371,274,243,87,156,0.42,0.377,0.318,15538,98.103575,277,417,0.646511627906977
"5109",168005,"SUFFOLK UNIVERSITY",1,0,2001,710,393,317,285,116,169,0.43,0.401,0.366,16536,107.406389,290,433,0.609859154929577
"5110",168005,"SUFFOLK UNIVERSITY",1,0,2002,787,481,306,307,88,219,0.455,0.39,0.288,17610,118.578041,295,497,0.63151207115629
"5111",168005,"SUFFOLK UNIVERSITY",1,0,2003,914,542,372,320,117,203,0.375,0.35,0.315,18670,126.618514,317,614,0.671772428884026
"5112",168005,"SUFFOLK UNIVERSITY",1,0,2004,1014,589,425,350,123,227,0.385,0.345,0.289,19790,141.113917,321,643,0.634122287968442
"5113",168005,"Suffolk University",1,0,2005,1127,682,445,416,143,273,0.4,0.369,0.321,21140,173.59321,339,768,0.681455190771961
"5114",168005,"Suffolk University",1,0,2006,1286,735,551,520,197,323,0.44,0.404,0.358,22610,175.147177,355,861,0.669517884914463
"5115",168005,"Suffolk University",1,0,2007,1308,752,556,531,218,313,0.416,0.406,0.392,24190,191.692118,388,821,0.627675840978593
"5116",168005,"Suffolk University",1,0,2008,1557,920,637,607,215,392,0.426,0.39,0.338,25850,215.686177,400,884,0.567758509955042
"5117",168005,"Suffolk University",1,0,2009,1257,736,521,510,182,328,0.446,0.406,0.349,27100,226.66086,396,588,0.467780429594272
"5118",168005,"Suffolk University",1,0,2010,1307,739,568,582,221,361,0.489,0.445,0.389,28414,230.625472,387,727,0.556235654169855
"5119",168148,"TUFTS UNIVERSITY",1,0,1991,1155,640,515,870,378,492,0.769,0.753,0.734,16755,252.669491,418,729,0.631168831168831
"5120",168148,"TUFTS UNIVERSITY",1,0,1992,1211,638,573,921,426,495,0.776,0.761,0.743,17897,266.344599,421,782,0.645747316267547
"5121",168148,"TUFTS UNIVERSITY",1,0,1993,1193,632,561,923,422,501,0.793,0.774,0.752,18793,283.763467,427,750,0.628667225481978
"5122",168148,"TUFTS UNIVERSITY",1,0,1995,1147,594,553,944,439,505,0.85,0.823,0.794,21086,318.530682,517,650,0.566695727986051
"5123",168148,"TUFTS UNIVERSITY",1,0,1996,1179,597,582,950,452,498,0.834,0.806,0.777,21957,333.268486,526,639,0.541984732824427
"5124",168148,"TUFTS UNIVERSITY",1,0,1997,1270,659,611,1063,498,565,0.857,0.837,0.815,22811,304.28626,479,695,0.547244094488189
"5125",168148,"TUFTS UNIVERSITY",1,0,1998,1236,668,568,1040,466,574,0.859,0.841,0.82,23709,322.396329,480,684,0.553398058252427
"5126",168148,"TUFTS UNIVERSITY",1,0,1999,1345,741,604,1134,497,637,0.86,0.843,0.823,24126,345.710864,529,758,0.563568773234201
"5127",168148,"TUFTS UNIVERSITY",1,0,2000,1181,637,544,1022,464,558,0.876,0.865,0.853,25062,359.09279,533.5,618,0.523285351397121
"5128",168148,"TUFTS UNIVERSITY",1,0,2001,1163,640,523,970,426,544,0.85,0.834,0.815,26213,389.73107,538,601,0.51676698194325
"5129",168148,"TUFTS UNIVERSITY",1,0,2002,1276,736,540,1094,455,639,0.868,0.857,0.843,27450,411.335756,564,676,0.529780564263323
"5130",168148,"TUFTS UNIVERSITY",1,0,2003,1281,664,617,1087,507,580,0.873,0.849,0.822,28896,448.246484,579,696,0.543325526932084
"5131",168148,"TUFTS UNIVERSITY",1,0,2004,1273,635,638,1101,537,564,0.888,0.865,0.842,30377,477.536745,584,748,0.587588373919874
"5132",168148,"Tufts University",1,0,2005,1364,682,682,1159,559,600,0.88,0.85,0.82,31828,503.994843,615,806,0.590909090909091
"5133",168148,"Tufts University",1,0,2006,1280,648,632,1120,543,577,0.89,0.875,0.859,33906,538.830616,626,779,0.60859375
"5134",168148,"Tufts University",1,0,2007,1370,703,667,1194,570,624,0.888,0.872,0.855,35842,579.059557,629,791,0.577372262773723
"5135",168148,"Tufts University",1,0,2008,1298,702,596,1141,511,630,0.897,0.879,0.857,37952,614.945648,623,758,0.583975346687211
"5136",168148,"Tufts University",1,0,2009,1302,669,633,1141,542,599,0.895,0.876,0.856,39432,656.212472,636,789,0.605990783410138
"5137",168148,"Tufts University",1,0,2010,1313,649,664,1138,560,578,0.891,0.867,0.843,40664,670.337492,658,772,0.587966488956588
"5138",168254,"WESTERN NEW ENGLAND COLLEGE",1,0,1991,428,166,262,165,81,84,0.506,0.386,0.309,7962,37.149521,144,404,0.94392523364486
"5139",168254,"WESTERN NEW ENGLAND COLLEGE",1,0,1992,431,182,249,145,82,63,0.346,0.336,0.329,8426,37.739629,135,395,0.916473317865429
"5140",168254,"WESTERN NEW ENGLAND COLLEGE",1,0,1993,392,149,243,120,64,56,0.376,0.306,0.263,9314,37.058742,137,356,0.908163265306122
"5141",168254,"WESTERN NEW ENGLAND COLLEGE",1,0,1995,580,222,358,223,116,107,0.482,0.384,0.324,10310,38.644916,138,484,0.83448275862069
"5142",168254,"WESTERN NEW ENGLAND COLLEGE",1,0,1996,478,174,304,173,104,69,0.397,0.362,0.342,10810,43.639487,134,391,0.817991631799163
"5143",168254,"WESTERN NEW ENGLAND COLLEGE",1,0,1997,526,220,306,210,98,112,0.509,0.399,0.32,11448,40.899509,134,418,0.79467680608365
"5144",168254,"WESTERN NEW ENGLAND COLLEGE",1,0,1998,535,238,297,231,119,112,0.471,0.432,0.401,12130,42.825978,136,456,0.852336448598131
"5145",168254,"WESTERN NEW ENGLAND COLLEGE",1,0,1999,618,271,347,268,145,123,0.454,0.434,0.418,11954,46.171222,139,568,0.919093851132686
"5146",168254,"WESTERN NEW ENGLAND COLLEGE",1,0,2000,560,262,298,268,140,128,0.489,0.479,0.47,14354,48.83394,146.5,498,0.889285714285714
"5147",168254,"WESTERN NEW ENGLAND COLLEGE",1,0,2001,654,287,367,346,176,170,0.592,0.529,0.48,14567,51.541286,154,562,0.859327217125382
"5148",168254,"WESTERN NEW ENGLAND COLLEGE",1,0,2002,682,301,381,298,151,147,0.488,0.437,0.396,16144,55.010349,154,586,0.859237536656892
"5149",168254,"WESTERN NEW ENGLAND COLLEGE",1,0,2003,672,279,393,275,148,127,0.455,0.409,0.377,19460,58.873768,157,583,0.867559523809524
"5150",168254,"WESTERN NEW ENGLAND COLLEGE",1,0,2004,798,302,496,353,197,156,0.517,0.442,0.397,20570,65.113761,159,700,0.87719298245614
"5151",168254,"Western New England College",1,0,2005,662,244,418,341,188,153,0.627,0.515,0.45,21600,68.760105,164,575,0.868580060422961
"5152",168254,"Western New England College",1,0,2006,719,259,460,367,211,156,0.602,0.51,0.459,22982,74.599349,169,645,0.897079276773296
"5153",168254,"Western New England College",1,0,2007,713,293,420,372,193,179,0.611,0.522,0.46,24224,75.124694,177,628,0.880785413744741
"5154",168254,"Western New England College",1,0,2008,735,281,454,370,206,164,0.584,0.503,0.454,25556,79.161149,180,642,0.873469387755102
"5155",168254,"Western New England College",1,0,2009,683,257,426,322,187,135,0.525,0.471,0.439,26822,83.994051,188,558,0.816983894582723
"5156",168254,"Western New England University",1,0,2010,736,303,433,373,213,160,0.528,0.507,0.492,27762,86.158261,194,589,0.800271739130435
"5157",168281,"WHEATON COLLEGE",1,0,1991,319,210,109,222,62,160,0.762,0.696,0.569,15650,30.320389,89,269,0.843260188087774
"5158",168281,"WHEATON COLLEGE",1,0,1992,412,274,138,265,87,178,0.65,0.643,0.63,16650,33.025832,93,349,0.847087378640777
"5159",168281,"WHEATON COLLEGE",1,0,1993,417,300,117,263,71,192,0.64,0.631,0.607,17670,35.161998,91,341,0.817745803357314
"5160",168281,"WHEATON COLLEGE",1,0,1995,359,249,110,241,72,169,0.679,0.671,0.655,19020,38.403185,93,312,0.86908077994429
"5161",168281,"WHEATON COLLEGE",1,0,1996,445,315,130,295,82,213,0.676,0.663,0.631,19740,40.193948,92,369,0.829213483146067
"5162",168281,"WHEATON COLLEGE",1,0,1997,438,277,161,298,97,201,0.726,0.68,0.602,20820,34.401519,93,364,0.831050228310502
"5163",168281,"WHEATON COLLEGE",1,0,1998,435,294,141,291,79,212,0.721,0.669,0.56,21840,38.769744,93,347,0.797701149425287
"5164",168281,"WHEATON COLLEGE",1,0,1999,427,281,146,298,85,213,0.758,0.698,0.582,22950,40.844581,96,351,0.822014051522248
"5165",168281,"WHEATON COLLEGE",1,0,2000,450,286,164,318,104,214,0.748,0.707,0.634,24225,42.702119,108,378,0.84
"5166",168281,"WHEATON COLLEGE",1,0,2001,494,328,166,364,114,250,0.762,0.737,0.687,25565,47.167677,120,397,0.803643724696356
"5167",168281,"WHEATON COLLEGE",1,0,2002,411,255,156,316,106,210,0.824,0.769,0.679,27105,52.038507,122,335,0.815085158150852
"5168",168281,"WHEATON COLLEGE",1,0,2003,445,286,159,324,104,220,0.769,0.728,0.654,28675,53.650114,121,338,0.759550561797753
"5169",168281,"WHEATON COLLEGE",1,0,2004,443,280,163,310,114,196,0.7,0.7,0.699,30355,57.377001,126,343,0.774266365688488
"5170",168281,"Wheaton College",1,0,2005,467,301,166,341,119,222,0.738,0.73,0.717,32115,60.631671,129,371,0.794432548179872
"5171",168281,"Wheaton College",1,0,2006,410,239,171,317,125,192,0.803,0.773,0.731,34365,64.419174,127,332,0.809756097560976
"5172",168281,"Wheaton College",1,0,2007,418,262,156,297,98,199,0.76,0.711,0.628,36430,66.969614,141,301,0.720095693779904
"5173",168281,"Wheaton College",1,0,2008,420,259,161,313,116,197,0.761,0.745,0.72,38585,71.25225,144,319,0.759523809523809
"5174",168281,"Wheaton College",1,0,2009,423,261,162,322,118,204,0.782,0.761,0.728,39565,72.237487,145,296,0.699763593380615
"5175",168281,"Wheaton College",1,0,2010,450,306,144,342,103,239,0.781,0.76,0.715,40790,71.487402,148,301,0.668888888888889
"5176",168342,"WILLIAMS COLLEGE",1,0,1991,517,246,271,467,238,229,0.931,0.903,0.878,16785,72.653599,218,365,0.705996131528046
"5177",168342,"WILLIAMS COLLEGE",1,0,1992,518,258,260,454,225,229,0.888,0.876,0.865,17840,72.652013,213,377,0.727799227799228
"5178",168342,"WILLIAMS COLLEGE",1,0,1993,527,269,258,467,222,245,0.911,0.886,0.86,18795,75.644992,213,376,0.713472485768501
"5179",168342,"WILLIAMS COLLEGE",1,0,1995,524,243,281,453,237,216,0.889,0.865,0.843,20790,80.440102,211,383,0.730916030534351
"5180",168342,"WILLIAMS COLLEGE",1,0,1996,553,276,277,507,248,259,0.938,0.917,0.895,21910,92.111868,215,410,0.741410488245931
"5181",168342,"WILLIAMS COLLEGE",1,0,1997,544,266,278,499,253,246,0.925,0.917,0.91,23050,83.624831,212,386,0.709558823529412
"5182",168342,"WILLIAMS COLLEGE",1,0,1998,537,265,272,492,252,240,0.906,0.916,0.926,23860,87.024325,217,386,0.718808193668529
"5183",168342,"WILLIAMS COLLEGE",1,0,1999,544,264,280,487,244,243,0.92,0.895,0.871,24619,94.447165,219,384,0.705882352941177
"5184",168342,"WILLIAMS COLLEGE",1,0,2000,528,260,268,483,240,243,0.935,0.915,0.896,24619,99.997857,220,387,0.732954545454545
"5185",168342,"WILLIAMS COLLEGE",1,0,2001,520,257,263,475,236,239,0.93,0.913,0.897,25352,113.763564,221,372,0.715384615384615
"5186",168342,"WILLIAMS COLLEGE",1,0,2002,539,291,248,492,226,266,0.914,0.913,0.911,26326,116.603408,271,360,0.667903525046382
"5187",168342,"WILLIAMS COLLEGE",1,0,2003,533,272,261,497,245,252,0.927,0.932,0.939,27890,126.30238,247,344,0.645403377110694
"5188",168342,"WILLIAMS COLLEGE",1,0,2004,532,272,260,484,234,250,0.919,0.91,0.9,29786,135.05659,247,349,0.656015037593985
"5189",168342,"Williams College",1,0,2005,536,280,256,477,226,251,0.896,0.89,0.883,31548,144.333549,275,343,0.639925373134328
"5190",168342,"Williams College",1,0,2006,533,280,253,484,223,261,0.932,0.908,0.881,33478,157.777313,285,342,0.641651031894934
"5191",168342,"Williams College",1,0,2007,539,258,281,483,248,235,0.911,0.896,0.883,35438,166.037295,270,336,0.623376623376623
"5192",168342,"Williams College",1,0,2008,538,284,254,476,222,254,0.894,0.885,0.874,37400,181.192585,278,316,0.587360594795539
"5193",168342,"Williams College",1,0,2009,545,293,252,481,216,265,0.904,0.883,0.857,39250,203.833028,275,330,0.605504587155963
"5194",168342,"Williams College",1,0,2010,548,288,260,471,215,256,0.889,0.859,0.827,41190,175.615673,275,324,0.591240875912409
"5195",168546,"ALBION COLLEGE",1,0,1991,548,266,282,349,179,170,0.639,0.637,0.635,11064,30.312814,111,504,0.91970802919708
"5196",168546,"ALBION COLLEGE",1,0,1992,508,242,266,330,173,157,0.649,0.65,0.65,12294,32.725491,112,470,0.925196850393701
"5197",168546,"ALBION COLLEGE",1,0,1993,488,251,237,270,145,125,0.498,0.553,0.612,13676,36.685478,109,411,0.842213114754098
"5198",168546,"ALBION COLLEGE",1,0,1995,473,238,235,334,150,184,0.773,0.706,0.638,15478,41.408794,104,400,0.845665961945032
"5199",168546,"ALBION COLLEGE",1,0,1996,433,227,206,278,120,158,0.696,0.642,0.583,16160,40.76346,105,358,0.826789838337182
"5200",168546,"ALBION COLLEGE",1,0,1997,474,260,214,301,114,187,0.719,0.635,0.533,16806,30.296667,106,391,0.824894514767933
"5201",168546,"ALBION COLLEGE",1,0,1998,448,248,200,298,126,172,0.694,0.665,0.63,17712,32.086676,110,380,0.848214285714286
"5202",168546,"ALBION COLLEGE",1,0,1999,411,219,192,275,110,165,0.753,0.669,0.573,18234,33.720732,107,345,0.839416058394161
"5203",168546,"ALBION COLLEGE",1,0,2000,405,253,152,270,86,184,0.727,0.667,0.566,18690,35.368228,114,328,0.809876543209877
"5204",168546,"ALBION COLLEGE",1,0,2001,450,226,224,267,115,152,0.673,0.593,0.513,19390,41.752136,121,390,0.866666666666667
"5205",168546,"ALBION COLLEGE",1,0,2002,525,293,232,330,129,201,0.686,0.629,0.556,20458,42.306851,123,472,0.899047619047619
"5206",168546,"ALBION COLLEGE",1,0,2003,486,263,223,306,118,188,0.715,0.63,0.529,21692,43.345552,118,443,0.911522633744856
"5207",168546,"ALBION COLLEGE",1,0,2004,559,310,249,358,149,209,0.674,0.64,0.598,22650,43.333779,131,490,0.876565295169946
"5208",168546,"Albion College",1,0,2005,571,315,256,372,160,212,0.673,0.651,0.625,24012,46.15186,141,512,0.896672504378284
"5209",168546,"Albion College",1,0,2006,480,260,220,297,118,179,0.689,0.619,0.536,25668,48.576676,135,413,0.860416666666667
"5210",168546,"Albion College",1,0,2007,500,258,242,322,144,178,0.69,0.644,0.595,27054,49.239667,135,444,0.888
"5211",168546,"Albion College",1,0,2008,485,242,243,297,137,160,0.661,0.612,0.564,28380,51.869186,143,423,0.872164948453608
"5212",168546,"Albion College",1,0,2009,434,218,216,241,106,135,0.619,0.555,0.491,29488,55.555207,125,345,0.794930875576037
"5213",168546,"Albion College",1,0,2010,383,196,187,235,102,133,0.679,0.614,0.545,30650,52.561178,114,322,0.840731070496084
"5214",168786,"AQUINAS COLLEGE",1,0,1991,231,134,97,65,26,39,0.291,0.281,0.268,8960,21.411712,83,197,0.852813852813853
"5215",168786,"AQUINAS COLLEGE",1,0,1992,233,162,71,50,14,36,0.222,0.215,0.197,9722,20.66474,87,191,0.819742489270386
"5216",168786,"AQUINAS COLLEGE",1,0,1993,219,152,67,67,14,53,0.349,0.306,0.209,10402,22.105266,90,195,0.89041095890411
"5217",168786,"AQUINAS COLLEGE",1,0,1995,241,139,102,69,28,41,0.295,0.286,0.275,11852,22.038467,79,222,0.921161825726141
"5218",168786,"AQUINAS COLLEGE",1,0,1996,283,177,106,92,28,64,0.362,0.325,0.264,12534,23.139554,76,251,0.886925795053004
"5219",168786,"AQUINAS COLLEGE",1,0,1997,329,204,125,79,30,49,0.24,0.24,0.24,12910,19.383956,72,310,0.942249240121581
"5220",168786,"AQUINAS COLLEGE",1,0,1998,346,213,133,75,23,52,0.244,0.217,0.173,13168,20.725919,82,317,0.916184971098266
"5221",168786,"AQUINAS COLLEGE",1,0,1999,347,227,120,93,32,61,0.269,0.268,0.267,13366,23.841906,82,318,0.9164265129683
"5222",168786,"AQUINAS COLLEGE",1,0,2000,362,244,118,89,24,65,0.266,0.246,0.203,14034,26.602707,89,337,0.930939226519337
"5223",168786,"AQUINAS COLLEGE",1,0,2001,321,227,94,107,29,78,0.344,0.333,0.309,14876,26.203498,96,304,0.947040498442368
"5224",168786,"AQUINAS COLLEGE",1,0,2002,346,216,130,85,25,60,0.278,0.246,0.192,15620,27.52189,95,310,0.895953757225434
"5225",168786,"AQUINAS COLLEGE",1,0,2003,284,182,102,94,31,63,0.346,0.331,0.304,16400,28.370844,96,264,0.929577464788732
"5226",168786,"AQUINAS COLLEGE",1,0,2004,316,199,117,119,45,74,0.372,0.377,0.385,16992,29.796026,94,284,0.89873417721519
"5227",168786,"Aquinas College",1,0,2005,364,240,124,160,49,111,0.462,0.44,0.395,17926,28.978369,94,317,0.870879120879121
"5228",168786,"Aquinas College",1,0,2006,387,252,135,192,67,125,0.496,0.496,0.496,19000,29.840191,92,332,0.857881136950904
"5229",168786,"Aquinas College",1,0,2007,410,269,141,124,35,89,0.331,0.302,0.248,20048,30.303751,86,361,0.880487804878049
"5230",168786,"Aquinas College",1,0,2008,456,283,173,138,43,95,0.336,0.303,0.249,21150,32.12669,89,401,0.879385964912281
"5231",168786,"Aquinas College",1,0,2009,402,271,131,158,46,112,0.413,0.393,0.351,22314,34.423854,90,349,0.868159203980099
"5232",168786,"Aquinas College",1,0,2010,428,255,173,140,53,87,0.341,0.327,0.306,23206,33.38106,92,365,0.852803738317757
"5233",169080,"CALVIN COLLEGE",1,0,1991,858,489,369,412,168,244,0.499,0.48,0.455,8100,52.11842,236,751,0.875291375291375
"5234",169080,"CALVIN COLLEGE",1,0,1992,803,474,329,369,145,224,0.473,0.46,0.441,8630,52.779428,225,716,0.891656288916563
"5235",169080,"CALVIN COLLEGE",1,0,1993,908,524,384,471,194,277,0.529,0.519,0.505,9450,53.268654,212,785,0.864537444933921
"5236",169080,"CALVIN COLLEGE",1,0,1995,1013,571,442,506,215,291,0.51,0.5,0.486,10995,58.869482,238,915,0.903257650542942
"5237",169080,"CALVIN COLLEGE",1,0,1996,960,565,395,545,209,336,0.595,0.568,0.529,11655,64.539711,258,846,0.88125
"5238",169080,"CALVIN COLLEGE",1,0,1997,1053,614,439,595,243,352,0.573,0.565,0.554,12225,56.669918,261,940,0.892687559354226
"5239",169080,"CALVIN COLLEGE",1,0,1998,974,536,438,559,236,323,0.603,0.574,0.539,12915,58.696797,266,847,0.869609856262834
"5240",169080,"CALVIN COLLEGE",1,0,1999,1059,591,468,574,225,349,0.591,0.542,0.481,13420,62.275256,273,914,0.863078375826251
"5241",169080,"CALVIN COLLEGE",1,0,2000,1050,594,456,585,241,344,0.579,0.557,0.529,14040,66.853262,282,893,0.85047619047619
"5242",169080,"CALVIN COLLEGE",1,0,2001,1026,601,425,571,214,357,0.594,0.557,0.504,14870,73.680268,291,863,0.841130604288499
"5243",169080,"CALVIN COLLEGE",1,0,2002,1045,577,468,586,228,358,0.62,0.561,0.487,15750,78.809777,300,905,0.866028708133971
"5244",169080,"CALVIN COLLEGE",1,0,2003,1041,577,464,572,230,342,0.593,0.549,0.496,16775,84.763018,302,876,0.84149855907781
"5245",169080,"CALVIN COLLEGE",1,0,2004,899,467,432,524,245,279,0.597,0.583,0.567,17770,90.980439,304,766,0.852057842046719
"5246",169080,"Calvin College",1,0,2005,1000,564,436,598,232,366,0.649,0.598,0.532,18925,94.428657,309,866,0.866
"5247",169080,"Calvin College",1,0,2006,1020,551,469,615,268,347,0.63,0.603,0.571,20245,98.535849,315,867,0.85
"5248",169080,"Calvin College",1,0,2007,1034,556,478,590,246,344,0.619,0.571,0.515,21460,103.618439,319,846,0.818181818181818
"5249",169080,"Calvin College",1,0,2008,935,500,435,539,235,304,0.608,0.576,0.54,22940,115.707673,316,751,0.803208556149733
"5250",169080,"Calvin College",1,0,2009,943,492,451,540,244,296,0.602,0.573,0.541,23810,118.632046,325,749,0.794273594909862
"5251",169080,"Calvin College",1,0,2010,929,469,460,573,250,323,0.689,0.617,0.543,24645,120.02039,319,719,0.773950484391819
"5252",169798,"EASTERN MICHIGAN UNIVERSITY",1,0,1991,2232,1255,977,176,65,111,0.088,0.079,0.067,2347,155.855483,733,1785,0.799731182795699
"5253",169798,"EASTERN MICHIGAN UNIVERSITY",1,0,1992,2149,1200,949,174,50,124,0.103,0.081,0.053,2471,151.00383,731,1681,0.782224290367613
"5254",169798,"EASTERN MICHIGAN UNIVERSITY",1,0,1993,2242,1217,1025,180,67,113,0.093,0.08,0.065,2804,170.263999,729,1675,0.747100802854594
"5255",169798,"EASTERN MICHIGAN UNIVERSITY",1,0,1995,2172,1230,942,198,65,133,0.108,0.091,0.069,3314,180.382001,727,1642,0.755985267034991
"5256",169798,"EASTERN MICHIGAN UNIVERSITY",1,0,1996,2298,1371,927,225,77,148,0.108,0.098,0.083,3399,187.52678,741,1720,0.748476936466493
"5257",169798,"EASTERN MICHIGAN UNIVERSITY",1,0,1997,2314,1372,942,260,80,180,0.131,0.112,0.085,3529,194.925539,730,1706,0.737251512532411
"5258",169798,"EASTERN MICHIGAN UNIVERSITY",1,0,1998,2349,1426,923,244,79,165,0.116,0.104,0.086,3645,206.595314,739,1749,0.744572158365262
"5259",169798,"EASTERN MICHIGAN UNIVERSITY",1,0,1999,2767,1627,1140,298,93,205,0.126,0.108,0.082,3146,215.173665,767,1927,0.69642211781713
"5260",169798,"EASTERN MICHIGAN UNIVERSITY",1,0,2000,2664,1619,1045,327,109,218,0.135,0.123,0.104,3097,227.720472,761.5,1885,0.707582582582583
"5261",169798,"EASTERN MICHIGAN UNIVERSITY",1,0,2001,2706,1627,1079,284,92,192,0.118,0.105,0.085,3622,241.904685,756,1855,0.685513673318551
"5262",169798,"EASTERN MICHIGAN UNIVERSITY",1,0,2002,2601,1564,1037,272,91,181,0.116,0.105,0.088,4047,248.377201,760,1785,0.686274509803922
"5263",169798,"EASTERN MICHIGAN UNIVERSITY",1,0,2003,2479,1510,969,295,85,210,0.139,0.119,0.088,4594,270.421888,751,1676,0.676079064138766
"5264",169798,"EASTERN MICHIGAN UNIVERSITY",1,0,2004,2281,1329,952,280,85,195,0.147,0.123,0.089,4707,269.060996,735,1508,0.661113546690048
"5265",169798,"Eastern Michigan University",1,0,2005,2301,1416,885,297,89,208,0.147,0.129,0.101,5463,276.087321,769,1544,0.671012603215993
"5266",169798,"Eastern Michigan University",1,0,2006,2272,1315,957,276,97,179,0.136,0.121,0.101,5835,284.534921,764,1463,0.643926056338028
"5267",169798,"Eastern Michigan University",1,0,2007,2365,1345,1020,294,109,185,0.138,0.124,0.107,6390,297.107857,756,1437,0.607610993657505
"5268",169798,"Eastern Michigan University",1,0,2008,2167,1283,884,269,84,185,0.144,0.124,0.095,6885,305.924218,738,1176,0.542685740655284
"5269",169798,"Eastern Michigan University",1,0,2009,2196,1308,888,288,84,204,0.156,0.131,0.095,7148,313.605547,755,1298,0.591074681238616
"5270",169798,"Eastern Michigan University",1,0,2010,1955,1152,803,254,75,179,0.155,0.13,0.093,7148,338.567268,764,1080,0.552429667519182
"5271",169910,"FERRIS STATE UNIVERSITY",0,1,1991,2377,889,1488,90,47,43,0.048,0.038,0.032,2565,112.872211,512,1994,0.838872528397139
"5272",169910,"FERRIS STATE UNIVERSITY",0,1,1992,2051,835,1216,57,28,29,0.035,0.028,0.023,2970,120.641194,500,1617,0.78839590443686
"5273",169910,"FERRIS STATE UNIVERSITY",1,0,1993,2114,810,1304,51,26,25,0.031,0.024,0.02,3222,123.114019,477,1681,0.795175023651845
"5274",169910,"FERRIS STATE UNIVERSITY",1,0,1995,1893,752,1141,55,28,27,0.036,0.029,0.025,3532,122.206355,445,1439,0.760169043845747
"5275",169910,"FERRIS STATE UNIVERSITY",1,0,1996,1831,731,1100,48,28,20,0.027,0.026,0.025,3630,124.787123,430,1413,0.771709448388859
"5276",169910,"FERRIS STATE UNIVERSITY",1,0,1997,1906,763,1143,46,21,25,0.033,0.024,0.018,3808,129.050426,429,1504,0.789087093389297
"5277",169910,"FERRIS STATE UNIVERSITY",1,0,1998,1946,812,1134,53,25,28,0.034,0.027,0.022,3998,137.228602,422,1472,0.756423432682426
"5278",169910,"FERRIS STATE UNIVERSITY",1,0,1999,1916,798,1118,78,44,34,0.043,0.041,0.039,4118,141.585306,419,1511,0.788622129436326
"5279",169910,"FERRIS STATE UNIVERSITY",1,0,2000,2147,883,1264,94,47,47,0.053,0.044,0.037,4284,160.903334,430.5,1667,0.776432231020028
"5280",169910,"FERRIS STATE UNIVERSITY",1,0,2001,2128,901,1227,123,66,57,0.063,0.058,0.054,4670,172.260599,442,1671,0.785244360902256
"5281",169910,"FERRIS STATE UNIVERSITY",1,0,2002,2035,882,1153,138,67,71,0.08,0.068,0.058,5334,165.19156,446,1653,0.812285012285012
"5282",169910,"FERRIS STATE UNIVERSITY",1,0,2003,2205,960,1245,137,67,70,0.073,0.062,0.054,6044,175.681948,429,1821,0.825850340136054
"5283",169910,"FERRIS STATE UNIVERSITY",1,0,2004,1924,834,1090,127,60,67,0.08,0.066,0.055,6190,172.67964,463,1559,0.81029106029106
"5284",169910,"Ferris State University",1,0,2005,2189,1003,1186,140,59,81,0.081,0.064,0.05,6740,178.076498,512,1744,0.796710826861581
"5285",169910,"Ferris State University",1,0,2006,1895,860,1035,167,82,85,0.099,0.088,0.079,7200,186.931008,537,1660,0.87598944591029
"5286",169910,"Ferris State University",1,0,2007,2035,933,1102,182,79,103,0.11,0.089,0.072,8460,190.928205,540,1645,0.808353808353808
"5287",169910,"Ferris State University",1,0,2008,2103,992,1111,169,75,94,0.095,0.08,0.068,9000,204.278409,544,1680,0.79885877318117
"5288",169910,"Ferris State University",1,0,2009,1958,980,978,152,58,94,0.096,0.078,0.059,9480,212.423236,586,1529,0.780898876404494
"5289",169910,"Ferris State University",1,0,2010,1960,976,984,143,59,84,0.086,0.073,0.06,9930,225.75306,525,1533,0.782142857142857
"5290",170082,"GRAND VALLEY STATE UNIVERSITY",1,0,1991,1545,941,604,240,63,177,0.188,0.155,0.104,2306,74.760095,303,1377,0.89126213592233
"5291",170082,"GRAND VALLEY STATE UNIVERSITY",1,0,1992,1557,982,575,289,91,198,0.202,0.186,0.158,2508,80.635812,317,1378,0.885035324341683
"5292",170082,"GRAND VALLEY STATE UNIVERSITY",1,0,1993,1511,916,595,262,79,183,0.2,0.173,0.133,2742,86.989589,320,1341,0.887491727332892
"5293",170082,"GRAND VALLEY STATE UNIVERSITY",1,0,1995,1773,1087,686,287,95,192,0.177,0.162,0.138,3140,105.253417,362,1575,0.888324873096447
"5294",170082,"GRAND VALLEY STATE UNIVERSITY",1,0,1996,2039,1200,839,356,112,244,0.203,0.175,0.133,3226,110.803842,380,1835,0.899950956351153
"5295",170082,"GRAND VALLEY STATE UNIVERSITY",1,0,1997,2406,1494,912,410,120,290,0.194,0.17,0.132,3288,122.925528,400,2187,0.908977556109726
"5296",170082,"GRAND VALLEY STATE UNIVERSITY",1,0,1998,2482,1544,938,469,153,316,0.205,0.189,0.163,3362,132.89411,435,2235,0.900483481063658
"5297",170082,"GRAND VALLEY STATE UNIVERSITY",1,0,1999,2528,1553,975,512,163,349,0.225,0.203,0.167,4048,151.957909,475,2283,0.903085443037975
"5298",170082,"GRAND VALLEY STATE UNIVERSITY",1,0,2000,2831,1732,1099,548,166,382,0.221,0.194,0.151,4230,190.395919,580,2577,0.910279053338043
"5299",170082,"GRAND VALLEY STATE UNIVERSITY",1,0,2001,2977,1826,1151,569,189,380,0.208,0.191,0.164,4660,204.117494,685,2642,0.887470607994626
"5300",170082,"GRAND VALLEY STATE UNIVERSITY",1,0,2002,2868,1801,1067,634,188,446,0.248,0.221,0.176,5056,190.679605,748,2573,0.897140864714086
"5301",170082,"GRAND VALLEY STATE UNIVERSITY",1,0,2003,3270,2096,1174,851,257,594,0.283,0.26,0.219,5254,213.252626,827,2842,0.869113149847095
"5302",170082,"GRAND VALLEY STATE UNIVERSITY",1,0,2004,3324,2123,1201,875,270,605,0.285,0.263,0.225,5782,230.568891,880,2881,0.866726835138387
"5303",170082,"Grand Valley State University",1,0,2005,3407,2220,1187,1011,308,703,0.317,0.297,0.259,6220,249.252957,880,2864,0.840622248312298
"5304",170082,"Grand Valley State University",1,0,2006,3556,2276,1280,1116,346,770,0.338,0.314,0.27,6588,264.229881,904,2948,0.829021372328459
"5305",170082,"Grand Valley State University",1,0,2007,3446,2201,1245,1137,346,791,0.359,0.33,0.278,7240,290.186527,923,2850,0.827045850261172
"5306",170082,"Grand Valley State University",1,0,2008,3879,2413,1466,1216,403,813,0.337,0.313,0.275,8196,312.885486,981,3464,0.893013663315287
"5307",170082,"Grand Valley State University",1,0,2009,3716,2278,1438,1363,461,902,0.396,0.367,0.321,8630,335.506736,1036,3271,0.880247578040904
"5308",170082,"Grand Valley State University",1,0,2010,3414,2084,1330,1165,413,752,0.361,0.341,0.311,9088,353.288335,1048,2900,0.849443468072642
"5309",170301,"HOPE COLLEGE",1,0,1991,554,317,237,278,99,179,0.565,0.502,0.418,10086,45.112016,162,515,0.929602888086643
"5310",170301,"HOPE COLLEGE",1,0,1992,687,408,279,371,134,237,0.581,0.54,0.48,10792,46.139558,167,640,0.931586608442504
"5311",170301,"HOPE COLLEGE",1,0,1993,657,360,297,360,157,203,0.564,0.548,0.529,11542,50.2482,159,599,0.911719939117199
"5312",170301,"HOPE COLLEGE",1,0,1995,709,418,291,412,143,269,0.643,0.581,0.491,13234,55.005,177,660,0.930888575458392
"5313",170301,"HOPE COLLEGE",1,0,1996,695,415,280,474,166,308,0.742,0.682,0.593,14310,57.068872,184,657,0.945323741007194
"5314",170301,"HOPE COLLEGE",1,0,1997,721,432,289,450,164,286,0.662,0.624,0.567,14878,56.106591,186,673,0.933425797503467
"5315",170301,"HOPE COLLEGE",1,0,1998,747,462,285,446,148,298,0.645,0.597,0.519,15470,59.869594,186,708,0.947791164658635
"5316",170301,"HOPE COLLEGE",1,0,1999,755,455,300,485,184,301,0.662,0.642,0.613,15934,63.988858,200,709,0.939072847682119
"5317",170301,"HOPE COLLEGE",1,0,2000,754,468,286,480,170,310,0.662,0.637,0.594,16554,64.769089,199.5,683,0.905835543766578
"5318",170301,"HOPE COLLEGE",1,0,2001,763,468,295,474,158,316,0.675,0.621,0.536,17348,68.523209,199,718,0.941022280471822
"5319",170301,"HOPE COLLEGE",1,0,2002,725,465,260,457,139,318,0.684,0.63,0.535,18158,69.067781,210,676,0.932413793103448
"5320",170301,"HOPE COLLEGE",1,0,2003,810,515,295,531,167,364,0.707,0.656,0.566,19212,72.257597,218,760,0.938271604938272
"5321",170301,"HOPE COLLEGE",1,0,2004,780,463,317,531,194,337,0.728,0.681,0.612,20300,75.655834,227,700,0.897435897435897
"5322",170301,"Hope College",1,0,2005,774,463,311,531,194,337,0.728,0.686,0.624,21420,81.285588,232,713,0.921188630490956
"5323",170301,"Hope College",1,0,2006,778,461,317,524,189,335,0.727,0.674,0.596,22430,84.258778,235,714,0.917737789203085
"5324",170301,"Hope College",1,0,2007,819,495,324,554,199,355,0.717,0.676,0.614,23660,91.301077,245,728,0.888888888888889
"5325",170301,"Hope College",1,0,2008,805,499,306,565,189,376,0.753,0.702,0.618,24780,94.648917,246,711,0.883229813664596
"5326",170301,"Hope College",1,0,2009,803,486,317,515,186,329,0.677,0.641,0.587,25500,94.226066,243,701,0.872976338729763
"5327",170301,"Hope College",1,0,2010,765,455,310,524,185,339,0.745,0.685,0.597,26350,92.894446,240,660,0.862745098039216
"5328",170532,"KALAMAZOO COLLEGE",0,1,1991,336,179,157,192,86,106,0.592,0.571,0.548,12669,25.58918,89,294,0.875
"5329",170532,"KALAMAZOO COLLEGE",0,1,1992,349,201,148,193,77,116,0.577,0.553,0.52,13785,27.90636,90,303,0.868194842406877
"5330",170532,"KALAMAZOO COLLEGE",0,1,1993,338,198,140,217,86,131,0.662,0.642,0.614,15135,29.995183,92,298,0.881656804733728
"5331",170532,"KALAMAZOO COLLEGE",0,1,1995,350,197,153,221,90,131,0.665,0.631,0.588,16713,32.25896,89,305,0.871428571428571
"5332",170532,"KALAMAZOO COLLEGE",0,1,1996,360,202,158,239,108,131,0.648,0.664,0.684,17214,33.423345,82,313,0.869444444444444
"5333",170532,"KALAMAZOO COLLEGE",0,1,1997,290,170,120,201,78,123,0.723,0.693,0.65,17976,37.568783,84,247,0.851724137931035
"5334",170532,"KALAMAZOO COLLEGE",0,1,1998,442,256,186,322,126,196,0.766,0.729,0.677,18630,39.66256,84,391,0.884615384615385
"5335",170532,"KALAMAZOO COLLEGE",0,1,1999,369,187,182,270,128,142,0.759,0.732,0.703,19188,42.255298,90,318,0.861788617886179
"5336",170532,"KALAMAZOO COLLEGE",0,1,2000,324,180,144,246,103,143,0.794,0.759,0.715,19764,42.817789,93.5,260,0.802469135802469
"5337",170532,"KALAMAZOO COLLEGE",0,1,2001,341,198,143,248,100,148,0.748,0.727,0.699,20652,45.7266,97,289,0.847507331378299
"5338",170532,"KALAMAZOO COLLEGE",0,1,2002,335,177,158,239,105,134,0.757,0.713,0.665,21603,47.253967,106,267,0.797014925373134
"5339",170532,"KALAMAZOO COLLEGE",0,1,2003,382,220,162,275,118,157,0.714,0.72,0.728,22908,47.601502,106,309,0.808900523560209
"5340",170532,"KALAMAZOO COLLEGE",0,1,2004,310,188,122,240,86,154,0.819,0.774,0.705,24351,50.697444,102,239,0.770967741935484
"5341",170532,"Kalamazoo College",0,1,2005,377,196,181,286,134,152,0.775,0.759,0.74,25644,50.617783,103,308,0.816976127320955
"5342",170532,"Kalamazoo College",0,1,2006,379,211,168,279,110,169,0.801,0.736,0.655,27054,54.55414,106,277,0.730870712401055
"5343",170532,"Kalamazoo College",0,1,2007,363,213,150,263,100,163,0.765,0.725,0.667,28716,40.424349,99,259,0.713498622589532
"5344",170532,"Kalamazoo College",0,1,2008,364,200,164,279,128,151,0.755,0.766,0.78,30723,43.069996,98,274,0.752747252747253
"5345",170532,"Kalamazoo College",0,1,2009,389,219,170,299,121,178,0.813,0.769,0.712,32643,44.70881,94,273,0.701799485861183
"5346",170532,"Kalamazoo College",0,1,2010,341,192,149,250,106,144,0.75,0.733,0.711,34017,44.867722,99,211,0.618768328445748
"5347",170639,"LAKE SUPERIOR STATE UNIVERSITY",1,0,1991,492,221,271,60,28,32,0.145,0.122,0.103,2518,27.445674,107,413,0.839430894308943
"5348",170639,"LAKE SUPERIOR STATE UNIVERSITY",1,0,1992,482,226,256,84,35,49,0.217,0.174,0.137,2694,32.356098,108,385,0.798755186721992
"5349",170639,"LAKE SUPERIOR STATE UNIVERSITY",1,0,1993,593,290,303,95,35,60,0.207,0.16,0.116,3200,32.331091,112,443,0.747048903878583
"5350",170639,"LAKE SUPERIOR STATE UNIVERSITY",1,0,1995,593,281,312,80,39,41,0.146,0.135,0.125,3396,32.692414,111,480,0.809443507588533
"5351",170639,"LAKE SUPERIOR STATE UNIVERSITY",1,0,1996,540,247,293,63,27,36,0.146,0.117,0.092,3534,35.883428,114,418,0.774074074074074
"5352",170639,"LAKE SUPERIOR STATE UNIVERSITY",1,0,1997,522,239,283,71,34,37,0.155,0.136,0.12,3642,36.62463,114,386,0.739463601532567
"5353",170639,"LAKE SUPERIOR STATE UNIVERSITY",1,0,1998,575,250,325,67,27,40,0.16,0.117,0.083,3871,36.991188,115,453,0.787826086956522
"5354",170639,"LAKE SUPERIOR STATE UNIVERSITY",1,0,1999,505,242,263,71,30,41,0.169,0.141,0.114,4030,39.252556,115,392,0.776237623762376
"5355",170639,"LAKE SUPERIOR STATE UNIVERSITY",1,0,2000,555,262,293,76,35,41,0.156,0.137,0.119,3818,41.837175,112.5,437,0.787387387387387
"5356",170639,"LAKE SUPERIOR STATE UNIVERSITY",1,0,2001,536,235,301,83,42,41,0.174,0.155,0.14,4128,40.163687,110,428,0.798507462686567
"5357",170639,"LAKE SUPERIOR STATE UNIVERSITY",1,0,2002,574,262,312,53,29,24,0.092,0.092,0.093,4548,44.040691,115,454,0.790940766550523
"5358",170639,"LAKE SUPERIOR STATE UNIVERSITY",1,0,2003,551,243,308,42,17,25,0.103,0.076,0.055,5136,45.170434,108,453,0.822141560798548
"5359",170639,"LAKE SUPERIOR STATE UNIVERSITY",1,0,2004,527,242,285,67,27,40,0.165,0.127,0.095,5418,43.581789,107,436,0.827324478178368
"5360",170639,"Lake Superior State University",1,0,2005,474,216,258,62,31,31,0.144,0.131,0.12,5988,41.132023,107,379,0.79957805907173
"5361",170639,"Lake Superior State University",1,0,2006,454,232,222,58,23,35,0.151,0.128,0.104,6558,43.238823,101,367,0.808370044052863
"5362",170639,"Lake Superior State University",1,0,2007,469,230,239,66,35,31,0.135,0.141,0.146,7176,44.504166,104,400,0.852878464818763
"5363",170639,"Lake Superior State University",1,0,2008,490,250,240,72,32,40,0.16,0.147,0.133,7824,45.797063,104,403,0.822448979591837
"5364",170639,"Lake Superior State University",1,0,2009,437,209,228,65,33,32,0.153,0.149,0.145,8184,48.174706,115,358,0.819221967963387
"5365",170639,"Lake Superior State University",1,0,2010,501,229,272,91,54,37,0.162,0.182,0.199,8664,48.372773,113,399,0.796407185628742
"5366",170976,"UNIVERSITY OF MICHIGAN-ANN ARBOR",0,1,1991,4908,2299,2609,2841,1363,1478,0.643,0.579,0.522,4044,1759.239493,1929,3399,0.692542787286064
"5367",170976,"UNIVERSITY OF MICHIGAN-ANN ARBOR",0,1,1992,5006,2342,2664,3058,1490,1568,0.67,0.611,0.559,4583,1868.539629,1968,3411,0.681382341190571
"5368",170976,"UNIVERSITY OF MICHIGAN-ANN ARBOR",0,1,1993,5016,2428,2588,3078,1451,1627,0.67,0.614,0.561,5119,2031.412733,1968,3366,0.671052631578947
"5369",170976,"UNIVERSITY OF MICHIGAN-ANN ARBOR",0,1,1995,5265,2658,2607,3223,1428,1795,0.675,0.612,0.548,5842,2303.795271,1961,3375,0.641025641025641
"5370",170976,"UNIVERSITY OF MICHIGAN-ANN ARBOR",0,1,1996,5328,2710,2618,3399,1533,1866,0.689,0.638,0.586,5710,2339.875327,1977,3338,0.626501501501502
"5371",170976,"UNIVERSITY OF MICHIGAN-ANN ARBOR",0,1,1997,5535,2763,2772,3619,1656,1963,0.711,0.654,0.597,5878,2516.726576,1985,3616,0.653297199638663
"5372",170976,"UNIVERSITY OF MICHIGAN-ANN ARBOR",0,1,1998,5258,2654,2604,3531,1620,1911,0.72,0.672,0.622,6098,2662.642386,2020,3321,0.631608976797261
"5373",170976,"UNIVERSITY OF MICHIGAN-ANN ARBOR",0,1,1999,5563,2853,2710,3879,1779,2100,0.736,0.697,0.656,6148,2714.324685,2113,3607,0.648391155851159
"5374",170976,"UNIVERSITY OF MICHIGAN-ANN ARBOR",0,1,2000,5403,2860,2543,3803,1697,2106,0.736,0.704,0.667,6328,3034.133252,2360.5,3447,0.637978900610772
"5375",170976,"UNIVERSITY OF MICHIGAN-ANN ARBOR",0,1,2001,5531,2884,2647,3896,1752,2144,0.743,0.704,0.662,6750,3743.65508,2608,3618,0.654131260169951
"5376",170976,"UNIVERSITY OF MICHIGAN-ANN ARBOR",0,1,2002,5180,2704,2476,3641,1634,2007,0.742,0.703,0.66,7298,3405.581511,2651,3402,0.656756756756757
"5377",170976,"UNIVERSITY OF MICHIGAN-ANN ARBOR",0,1,2003,5538,2903,2635,4025,1840,2185,0.753,0.727,0.698,7788,3585.974,2645,3530,0.637414228963525
"5378",170976,"UNIVERSITY OF MICHIGAN-ANN ARBOR",0,1,2004,6016,3033,2983,4334,1990,2344,0.773,0.72,0.667,8014,3747.935,2662,3990,0.663231382978723
"5379",170976,"University of Michigan-Ann Arbor",0,1,2005,6080,3071,3009,4431,2061,2370,0.772,0.729,0.685,9024,3885.837,2495,3955,0.650493421052632
"5380",170976,"University of Michigan-Ann Arbor",0,1,2006,5356,2704,2652,4072,1880,2192,0.811,0.76,0.709,9534,4119.405,2572,3555,0.663741598207618
"5381",170976,"University of Michigan-Ann Arbor",0,1,2007,5955,3019,2936,4513,2063,2450,0.812,0.758,0.703,10258,4283.566,2998,3873,0.650377833753149
"5382",170976,"University of Michigan-Ann Arbor",0,1,2008,5738,2905,2833,4336,1989,2347,0.808,0.756,0.702,10848,5988.427,3079,3821,0.665911467410247
"5383",170976,"University of Michigan-Ann Arbor",0,1,2009,6019,2983,3036,4503,2101,2402,0.805,0.748,0.692,11470,4917.321,3228,4316,0.717062634989201
"5384",170976,"University of Michigan-Ann Arbor",0,1,2010,6443,3217,3226,4929,2317,2612,0.812,0.765,0.718,11648,5098.288,3258,4480,0.695328263231414
"5385",171100,"MICHIGAN STATE UNIVERSITY",0,1,1991,6314,3456,2858,1480,535,945,0.273,0.234,0.187,3474,765.330766,1927,5257,0.832594235033259
"5386",171100,"MICHIGAN STATE UNIVERSITY",1,0,1992,6086,3320,2766,1897,669,1228,0.37,0.312,0.242,3876,820.176721,1876,5064,0.832073611567532
"5387",171100,"MICHIGAN STATE UNIVERSITY",1,0,1993,6164,3372,2792,1851,641,1210,0.359,0.3,0.23,4260,850.246503,1840,5016,0.81375730045425
"5388",171100,"MICHIGAN STATE UNIVERSITY",1,0,1995,6396,3546,2850,2076,693,1383,0.39,0.325,0.243,4521,896.4729,1848,5312,0.830519074421513
"5389",171100,"MICHIGAN STATE UNIVERSITY",1,0,1996,6708,3728,2980,2358,809,1549,0.416,0.352,0.271,4655,925.605689,1861,5551,0.827519379844961
"5390",171100,"MICHIGAN STATE UNIVERSITY",1,0,1997,6804,3723,3081,2232,751,1481,0.398,0.328,0.244,4789,960.732056,1851,5567,0.81819517930629
"5391",171100,"MICHIGAN STATE UNIVERSITY",1,0,1998,6724,3767,2957,2343,757,1586,0.421,0.348,0.256,4896,1020.842907,1847,5437,0.808596073765616
"5392",171100,"MICHIGAN STATE UNIVERSITY",1,0,1999,6499,3674,2825,2580,833,1747,0.476,0.397,0.295,5003,1066.25605,1838,5186,0.797968918295122
"5393",171100,"MICHIGAN STATE UNIVERSITY",1,0,2000,6790,3756,3034,2908,1026,1882,0.501,0.428,0.338,4830,1129.112312,1889,5338,0.786156111929308
"5394",171100,"MICHIGAN STATE UNIVERSITY",1,0,2001,6755,3808,2947,2878,1041,1837,0.482,0.426,0.353,5257,1277.533579,1940,5224,0.773353071798668
"5395",171100,"MICHIGAN STATE UNIVERSITY",1,0,2002,6829,3864,2965,3127,1133,1994,0.516,0.458,0.382,5704,1248.13084,2068,5275,0.772441060184507
"5396",171100,"MICHIGAN STATE UNIVERSITY",1,0,2003,6938,3932,3006,3315,1201,2114,0.538,0.478,0.4,6266,1299.315408,2091,5460,0.786970308446238
"5397",171100,"MICHIGAN STATE UNIVERSITY",1,0,2004,7426,4073,3353,3531,1334,2197,0.539,0.475,0.398,6540,1303.075634,2075,5898,0.794236466469162
"5398",171100,"Michigan State University",1,0,2005,7303,4147,3156,3470,1232,2238,0.54,0.475,0.39,7161,1401.640386,2180,5712,0.782144324250308
"5399",171100,"Michigan State University",1,0,2006,7306,4103,3203,3800,1448,2352,0.573,0.52,0.452,7759,1498.644286,2268,5639,0.7718313714755
"5400",171100,"Michigan State University",1,0,2007,7398,4099,3299,3666,1372,2294,0.56,0.496,0.416,8672,1572.9961,2285,5678,0.767504731008381
"5401",171100,"Michigan State University",1,0,2008,7385,4098,3287,3831,1442,2389,0.583,0.519,0.439,9806,1714.075443,2340,5488,0.743127962085308
"5402",171100,"Michigan State University",1,0,2009,7249,3869,3380,3612,1445,2167,0.56,0.498,0.428,10913,1798.712077,2346,5207,0.718305973237688
"5403",171100,"Michigan State University",1,0,2010,7221,3821,3400,3685,1516,2169,0.568,0.51,0.446,11670,1829.539938,2256,5213,0.721922171444398
"5404",171128,"MICHIGAN TECHNOLOGICAL UNIVERSITY",0,1,1991,1283,319,964,234,145,89,0.279,0.182,0.15,2916,97.19,322,1191,0.928293063133281
"5405",171128,"MICHIGAN TECHNOLOGICAL UNIVERSITY",0,1,1992,1260,321,939,253,169,84,0.262,0.201,0.18,3249,100.569,322,1143,0.907142857142857
"5406",171128,"MICHIGAN TECHNOLOGICAL UNIVERSITY",0,1,1993,1026,262,764,215,133,82,0.313,0.21,0.174,3441,106.948,338,958,0.933723196881092
"5407",171128,"MICHIGAN TECHNOLOGICAL UNIVERSITY",0,1,1995,1072,285,787,218,134,84,0.295,0.203,0.17,3843,120.25,368,971,0.905783582089552
"5408",171128,"MICHIGAN TECHNOLOGICAL UNIVERSITY",0,1,1996,1068,260,808,298,199,99,0.381,0.279,0.246,3948,126.234,374,963,0.901685393258427
"5409",171128,"MICHIGAN TECHNOLOGICAL UNIVERSITY",0,1,1997,1251,295,956,329,224,105,0.356,0.263,0.234,4062,127.719,370,1131,0.904076738609113
"5410",171128,"MICHIGAN TECHNOLOGICAL UNIVERSITY",0,1,1998,1194,328,866,323,202,121,0.369,0.271,0.233,4362,134.594,369,1056,0.884422110552764
"5411",171128,"MICHIGAN TECHNOLOGICAL UNIVERSITY",0,1,1999,1137,276,861,259,183,76,0.275,0.228,0.213,4365,138.36,366,1022,0.898856640281442
"5412",171128,"MICHIGAN TECHNOLOGICAL UNIVERSITY",1,0,2000,1267,292,975,316,223,93,0.318,0.249,0.229,4530,147.135,366.5,1115,0.880031570639305
"5413",171128,"MICHIGAN TECHNOLOGICAL UNIVERSITY",1,0,2001,1189,281,908,281,181,100,0.356,0.236,0.199,5028,159.182,367,1021,0.858704793944491
"5414",171128,"MICHIGAN TECHNOLOGICAL UNIVERSITY",1,0,2002,1186,267,919,306,210,96,0.36,0.258,0.229,5782,156.146,366,1050,0.885328836424958
"5415",171128,"MICHIGAN TECHNOLOGICAL UNIVERSITY",1,0,2003,1168,238,930,251,177,74,0.311,0.215,0.19,6810,159.87,346,1051,0.899828767123288
"5416",171128,"MICHIGAN TECHNOLOGICAL UNIVERSITY",1,0,2004,1219,243,976,327,221,106,0.436,0.268,0.226,6978,153.237,355,1102,0.904019688269073
"5417",171128,"Michigan Technological University",1,0,2005,1321,236,1085,327,243,84,0.356,0.248,0.224,7560,157.892,343,1152,0.872066616199849
"5418",171128,"Michigan Technological University",1,0,2006,1163,283,880,328,221,107,0.378,0.282,0.251,8271,167.705,349,1023,0.879621668099742
"5419",171128,"Michigan Technological University",1,0,2007,1215,287,928,275,197,78,0.272,0.226,0.212,9180,184.741,367,1035,0.851851851851852
"5420",171128,"Michigan Technological University",1,0,2008,1361,318,1043,333,218,115,0.362,0.245,0.209,9930,197.981,361,1200,0.881704628949302
"5421",171128,"Michigan Technological University",1,0,2009,1155,301,854,260,162,98,0.326,0.225,0.19,10500,208.172,378,1001,0.866666666666667
"5422",171128,"Michigan Technological University",1,0,2010,1110,273,837,308,202,106,0.388,0.277,0.241,11175,213.442,389,959,0.863963963963964
"5423",171137,"UNIVERSITY OF MICHIGAN-DEARBORN",1,0,1991,597,308,289,50,22,28,0.091,0.084,0.076,2766,45.19004,201,507,0.849246231155779
"5424",171137,"UNIVERSITY OF MICHIGAN-DEARBORN",1,0,1992,625,323,302,46,18,28,0.087,0.074,0.06,2886,44.964603,206,552,0.8832
"5425",171137,"UNIVERSITY OF MICHIGAN-DEARBORN",1,0,1993,631,311,320,50,21,29,0.093,0.079,0.066,3160,48.026421,219,518,0.820919175911252
"5426",171137,"UNIVERSITY OF MICHIGAN-DEARBORN",1,0,1995,600,320,280,49,23,26,0.081,0.082,0.082,3736,54.339163,221,493,0.821666666666667
"5427",171137,"UNIVERSITY OF MICHIGAN-DEARBORN",1,0,1996,666,321,345,67,23,44,0.137,0.101,0.067,3970,58.922538,230,523,0.785285285285285
"5428",171137,"UNIVERSITY OF MICHIGAN-DEARBORN",1,0,1997,696,378,318,96,29,67,0.177,0.138,0.091,4087,64.062591,237,569,0.817528735632184
"5429",171137,"UNIVERSITY OF MICHIGAN-DEARBORN",1,0,1998,741,373,368,99,41,58,0.156,0.134,0.111,4274,66.137478,233,569,0.767881241565452
"5430",171137,"UNIVERSITY OF MICHIGAN-DEARBORN",1,0,1999,690,334,356,88,30,58,0.174,0.128,0.084,4077,67.041619,239,514,0.744927536231884
"5431",171137,"UNIVERSITY OF MICHIGAN-DEARBORN",1,0,2000,738,371,367,118,52,66,0.178,0.16,0.142,4492,74.935336,257.5,583,0.789972899728997
"5432",171137,"UNIVERSITY OF MICHIGAN-DEARBORN",1,0,2001,658,330,328,90,33,57,0.173,0.137,0.101,4915,77.420159,276,497,0.75531914893617
"5433",171137,"UNIVERSITY OF MICHIGAN-DEARBORN",1,0,2002,735,342,393,105,48,57,0.167,0.143,0.122,5332,80.02988,283,573,0.779591836734694
"5434",171137,"UNIVERSITY OF MICHIGAN-DEARBORN",1,0,2003,704,313,391,123,62,61,0.195,0.175,0.159,5839,83.804,291,535,0.759943181818182
"5435",171137,"UNIVERSITY OF MICHIGAN-DEARBORN",1,0,2004,656,311,345,106,45,61,0.196,0.162,0.13,5491,91.66,295,460,0.701219512195122
"5436",171137,"University of Michigan-Dearborn",1,0,2005,798,381,417,128,47,81,0.213,0.16,0.113,6146,97.641,290,601,0.753132832080201
"5437",171137,"University of Michigan-Dearborn",1,0,2006,761,394,367,136,56,80,0.203,0.179,0.153,6641,99.898,288,563,0.739816031537451
"5438",171137,"University of Michigan-Dearborn",1,0,2007,859,420,439,128,61,67,0.16,0.149,0.139,7165,104.992,292,611,0.711292200232829
"5439",171137,"University of Michigan-Dearborn",1,0,2008,905,436,469,145,60,85,0.195,0.16,0.128,7631,108.791,294,645,0.712707182320442
"5440",171137,"University of Michigan-Dearborn",1,0,2009,886,418,468,146,60,86,0.206,0.165,0.128,8142,111.388,306,651,0.734762979683973
"5441",171137,"University of Michigan-Dearborn",1,0,2010,883,429,454,149,51,98,0.228,0.169,0.112,8460,116.002,305,650,0.736126840317101
"5442",171146,"UNIVERSITY OF MICHIGAN-FLINT",1,0,1991,485,286,199,32,7,25,0.087,0.066,0.035,2460,37.350657,176,411,0.847422680412371
"5443",171146,"UNIVERSITY OF MICHIGAN-FLINT",1,0,1992,523,317,206,45,8,37,0.117,0.086,0.039,2700,37.966024,184,421,0.804971319311663
"5444",171146,"UNIVERSITY OF MICHIGAN-FLINT",1,0,1993,504,322,182,41,12,29,0.09,0.081,0.066,2916,40.132507,184,434,0.861111111111111
"5445",171146,"UNIVERSITY OF MICHIGAN-FLINT",1,0,1995,263,169,94,116,45,71,0.42,0.441,0.479,3304,42.845613,192,226,0.859315589353612
"5446",171146,"UNIVERSITY OF MICHIGAN-FLINT",1,0,1996,551,352,199,53,15,38,0.108,0.096,0.075,3433,45.23237,204,472,0.856624319419238
"5447",171146,"UNIVERSITY OF MICHIGAN-FLINT",1,0,1997,552,337,215,30,10,20,0.059,0.054,0.047,3559,48.68374,206,450,0.815217391304348
"5448",171146,"UNIVERSITY OF MICHIGAN-FLINT",1,0,1998,613,372,241,60,20,40,0.108,0.098,0.083,3697,51.171769,198,524,0.854812398042414
"5449",171146,"UNIVERSITY OF MICHIGAN-FLINT",1,0,1999,492,289,203,49,15,34,0.118,0.1,0.074,3640,52.363875,202,395,0.802845528455285
"5450",171146,"UNIVERSITY OF MICHIGAN-FLINT",1,0,2000,576,349,227,64,18,46,0.132,0.111,0.079,3712,60.99268,209,464,0.805555555555556
"5451",171146,"UNIVERSITY OF MICHIGAN-FLINT",1,0,2001,549,330,219,54,17,37,0.112,0.098,0.078,4135,59.874395,216,455,0.828779599271403
"5452",171146,"UNIVERSITY OF MICHIGAN-FLINT",1,0,2002,467,269,198,52,16,36,0.134,0.111,0.081,4494,63.628777,211,382,0.817987152034261
"5453",171146,"UNIVERSITY OF MICHIGAN-FLINT",1,0,2003,420,252,168,57,17,40,0.159,0.136,0.101,5000,72.133,191,334,0.795238095238095
"5454",171146,"UNIVERSITY OF MICHIGAN-FLINT",1,0,2004,474,293,181,53,17,36,0.123,0.112,0.094,5126,71.684,191,393,0.829113924050633
"5455",171146,"University of Michigan-Flint",1,0,2005,509,293,216,48,18,30,0.102,0.094,0.083,5752,66.921,214,374,0.734774066797642
"5456",171146,"University of Michigan-Flint",1,0,2006,483,274,209,46,14,32,0.117,0.095,0.067,6214,75.783,222,347,0.718426501035197
"5457",171146,"University of Michigan-Flint",1,0,2007,594,346,248,56,16,40,0.116,0.094,0.065,6618,77.683,220,407,0.685185185185185
"5458",171146,"University of Michigan-Flint",1,0,2008,846,512,334,78,31,47,0.092,0.092,0.093,7008,84.396,229,537,0.634751773049645
"5459",171146,"University of Michigan-Flint",1,0,2009,713,401,312,77,29,48,0.12,0.108,0.093,7474,92.22,231,471,0.660589060308555
"5460",171146,"University of Michigan-Flint",1,0,2010,724,398,326,94,34,60,0.151,0.13,0.104,7809,95.772,242,506,0.698895027624309
"5461",171599,"OLIVET COLLEGE",1,0,1991,162,55,107,30,18,12,0.218,0.185,0.168,7890,9.734991,41,136,0.839506172839506
"5462",171599,"OLIVET COLLEGE",1,0,1992,139,39,100,14,5,9,0.231,0.101,0.05,8291,9.329928,40,120,0.863309352517986
"5463",171599,"OLIVET COLLEGE",1,0,1993,234,78,156,53,30,23,0.295,0.226,0.192,10500,10.906425,44,210,0.897435897435897
"5464",171599,"OLIVET COLLEGE",1,0,1995,209,69,140,28,20,8,0.116,0.134,0.143,11580,12.875474,40,171,0.818181818181818
"5465",171599,"OLIVET COLLEGE",1,0,1996,241,93,148,45,21,24,0.258,0.187,0.142,12160,13.40698,45,163,0.676348547717842
"5466",171599,"OLIVET COLLEGE",1,0,1997,228,73,155,2,0,2,0.027,0.009,0,12660,15.755119,43,159,0.697368421052632
"5467",171599,"OLIVET COLLEGE",1,0,1998,198,85,113,42,21,21,0.247,0.212,0.186,12900,16.671485,36,117,0.590909090909091
"5468",171599,"OLIVET COLLEGE",1,0,1999,181,74,107,63,32,31,0.419,0.348,0.299,12948,16.677411,40,118,0.651933701657459
"5469",171599,"OLIVET COLLEGE",1,0,2000,183,66,117,36,18,18,0.273,0.197,0.154,13142,17.783726,38,94,0.513661202185792
"5470",171599,"OLIVET COLLEGE",1,0,2001,151,59,92,52,26,26,0.441,0.344,0.283,13982,20.192627,36,95,0.629139072847682
"5471",171599,"OLIVET COLLEGE",1,0,2002,238,85,153,82,42,40,0.471,0.345,0.275,14332,18.110863,31,174,0.73109243697479
"5472",171599,"OLIVET COLLEGE",1,0,2003,271,99,172,101,53,48,0.485,0.373,0.308,14762,13.749,33,175,0.645756457564576
"5473",171599,"OLIVET COLLEGE",1,0,2004,198,72,126,51,26,25,0.347,0.258,0.206,15500,15.044209,34,144,0.727272727272727
"5474",171599,"Olivet College",1,0,2005,257,103,154,77,33,44,0.427,0.3,0.214,15970,16.584669,33,198,0.770428015564202
"5475",171599,"Olivet College",1,0,2006,195,73,122,52,28,24,0.329,0.267,0.23,17584,15.865444,34,153,0.784615384615385
"5476",171599,"Olivet College",1,0,2007,182,67,115,48,18,30,0.448,0.264,0.157,17994,16.426342,37,137,0.752747252747253
"5477",171599,"Olivet College",1,0,2008,282,99,183,76,34,42,0.424,0.27,0.186,18580,17.050287,41,202,0.716312056737589
"5478",171599,"Olivet College",1,0,2009,258,141,117,68,26,42,0.298,0.264,0.222,19138,18.766385,42,212,0.821705426356589
"5479",171599,"Olivet College",1,0,2010,229,93,136,80,35,45,0.484,0.349,0.257,19710,16.973058,43,187,0.816593886462882
"5480",172051,"SAGINAW VALLEY STATE UNIVERSITY",1,0,1991,564,296,268,26,6,20,0.068,0.046,0.022,2426,39.990769,166,492,0.872340425531915
"5481",172051,"SAGINAW VALLEY STATE UNIVERSITY",1,0,1992,655,360,295,42,8,34,0.094,0.064,0.027,2620,47.171397,170,561,0.856488549618321
"5482",172051,"SAGINAW VALLEY STATE UNIVERSITY",1,0,1993,633,337,296,112,36,76,0.226,0.177,0.122,2891,42.882759,174,580,0.916271721958926
"5483",172051,"SAGINAW VALLEY STATE UNIVERSITY",1,0,1995,752,412,340,40,14,26,0.063,0.053,0.041,3259,45.03841,171,674,0.896276595744681
"5484",172051,"SAGINAW VALLEY STATE UNIVERSITY",1,0,1996,747,425,322,33,8,25,0.059,0.044,0.025,3350,47.272488,180,664,0.888888888888889
"5485",172051,"SAGINAW VALLEY STATE UNIVERSITY",1,0,1997,818,461,357,55,12,43,0.093,0.067,0.034,3447,51.748834,179,673,0.822738386308069
"5486",172051,"SAGINAW VALLEY STATE UNIVERSITY",1,0,1998,895,492,403,59,20,39,0.079,0.066,0.05,3526,55.046576,200,757,0.845810055865922
"5487",172051,"SAGINAW VALLEY STATE UNIVERSITY",1,0,1999,1015,549,466,81,36,45,0.082,0.08,0.077,3351,58.87485,211,843,0.830541871921182
"5488",172051,"SAGINAW VALLEY STATE UNIVERSITY",1,0,2000,1049,559,490,68,24,44,0.079,0.065,0.049,3290,65.957315,218.5,878,0.836987607244995
"5489",172051,"SAGINAW VALLEY STATE UNIVERSITY",1,0,2001,1044,539,505,106,39,67,0.124,0.102,0.077,3455,74.312351,226,865,0.828544061302682
"5490",172051,"SAGINAW VALLEY STATE UNIVERSITY",1,0,2002,1109,654,455,97,27,70,0.107,0.087,0.059,3824,77.712477,233,923,0.832281334535618
"5491",172051,"SAGINAW VALLEY STATE UNIVERSITY",1,0,2003,1156,667,489,104,32,72,0.108,0.09,0.065,4188,82.640716,235,969,0.838235294117647
"5492",172051,"SAGINAW VALLEY STATE UNIVERSITY",1,0,2004,1209,720,489,129,32,97,0.135,0.107,0.065,4271,84.670393,243,1044,0.863523573200993
"5493",172051,"Saginaw Valley State University",1,0,2005,1233,742,491,102,26,76,0.102,0.083,0.053,4877,90.392105,258,1014,0.822384428223844
"5494",172051,"Saginaw Valley State University",1,0,2006,1434,840,594,123,36,87,0.104,0.086,0.061,5130,96.448567,266,1167,0.813807531380753
"5495",172051,"Saginaw Valley State University",1,0,2007,1533,883,650,155,56,99,0.112,0.101,0.086,5832,102.298409,279,1219,0.795172863666014
"5496",172051,"Saginaw Valley State University",1,0,2008,1647,949,698,144,50,94,0.099,0.087,0.072,6054,115.489779,286,1337,0.811778992106861
"5497",172051,"Saginaw Valley State University",1,0,2009,1728,1028,700,177,59,118,0.115,0.102,0.084,6462,119.099817,288,1338,0.774305555555556
"5498",172051,"Saginaw Valley State University",1,0,2010,1729,1013,716,196,51,145,0.143,0.113,0.071,6870,126.548298,296,1284,0.742625795257374
"5499",172699,"WESTERN MICHIGAN UNIVERSITY",0,1,1991,2778,1543,1235,432,162,270,0.175,0.156,0.131,2447,209.331,740,2379,0.856371490280778
"5500",172699,"WESTERN MICHIGAN UNIVERSITY",0,1,1992,2863,1614,1249,484,165,319,0.198,0.169,0.132,2807,239.354528,709,2370,0.827803003842124
"5501",172699,"WESTERN MICHIGAN UNIVERSITY",0,1,1993,2810,1587,1223,538,161,377,0.238,0.191,0.132,2997,242.343577,731,2439,0.86797153024911
"5502",172699,"WESTERN MICHIGAN UNIVERSITY",0,1,1995,3165,1851,1314,524,148,376,0.203,0.166,0.113,3242,264.856844,729,2704,0.85434439178515
"5503",172699,"WESTERN MICHIGAN UNIVERSITY",1,0,1996,3121,1801,1320,557,177,380,0.211,0.178,0.134,3332,272.930356,756,2672,0.856135853892983
"5504",172699,"WESTERN MICHIGAN UNIVERSITY",1,0,1997,3213,1835,1378,592,211,381,0.208,0.184,0.153,3655,288.822945,751,2820,0.877684407096172
"5505",172699,"WESTERN MICHIGAN UNIVERSITY",1,0,1998,3621,1981,1640,699,255,444,0.224,0.193,0.155,3937,309.701311,808,3198,0.883181441590721
"5506",172699,"WESTERN MICHIGAN UNIVERSITY",1,0,1999,4302,2288,2014,864,306,558,0.244,0.201,0.152,3453,328.430679,799,3916,0.910274291027429
"5507",172699,"WESTERN MICHIGAN UNIVERSITY",1,0,2000,4429,2349,2080,865,323,542,0.231,0.195,0.155,3492,359.342906,857.5,4012,0.905847821178596
"5508",172699,"WESTERN MICHIGAN UNIVERSITY",1,0,2001,4562,2306,2256,857,334,523,0.227,0.188,0.148,3897,384.849894,916,4113,0.901578255151249
"5509",172699,"WESTERN MICHIGAN UNIVERSITY",1,0,2002,4442,2318,2124,941,381,560,0.242,0.212,0.179,4322,404.6729,962,4020,0.904997748761819
"5510",172699,"WESTERN MICHIGAN UNIVERSITY",1,0,2003,4218,2191,2027,915,388,527,0.241,0.217,0.191,4933,421.860485,962,3743,0.887387387387387
"5511",172699,"WESTERN MICHIGAN UNIVERSITY",1,0,2004,3725,1872,1853,802,301,501,0.268,0.215,0.162,5066,416.497575,954,3246,0.871409395973154
"5512",172699,"Western Michigan University",1,0,2005,3702,1917,1785,919,374,545,0.284,0.248,0.21,5826,420.716541,890,3272,0.883846569421934
"5513",172699,"Western Michigan University",1,0,2006,3531,1800,1731,852,359,493,0.274,0.241,0.207,6176,437.342088,872,2977,0.843103936561881
"5514",172699,"Western Michigan University",1,0,2007,3473,1750,1723,842,362,480,0.274,0.242,0.21,6570,445.108703,867,2838,0.817160955945868
"5515",172699,"Western Michigan University",1,0,2008,3803,1934,1869,880,381,499,0.258,0.231,0.204,7220,476.889916,893,3067,0.806468577438864
"5516",172699,"Western Michigan University",1,0,2009,3162,1591,1571,718,279,439,0.276,0.227,0.178,7654,491.667906,862,2453,0.775774826059456
"5517",172699,"Western Michigan University",1,0,2010,3346,1734,1612,721,259,462,0.266,0.215,0.161,8182,494.820389,865,2502,0.747758517632995
"5518",173160,"BETHEL COLLEGE",1,0,1991,272,183,89,157,49,108,0.59,0.577,0.551,9950,28.025678,109,260,0.955882352941177
"5519",173160,"BETHEL COLLEGE",1,0,1992,236,143,93,153,54,99,0.692,0.648,0.581,10540,30.048773,105,225,0.953389830508475
"5520",173160,"BETHEL COLLEGE",1,0,1993,275,168,107,175,64,111,0.661,0.636,0.598,11050,31.861102,103,262,0.952727272727273
"5521",173160,"BETHEL COLLEGE",1,0,1995,475,303,172,282,90,192,0.634,0.594,0.523,12260,36.970428,116,450,0.947368421052632
"5522",173160,"BETHEL COLLEGE",1,0,1996,468,284,184,292,103,189,0.665,0.624,0.56,13180,40.177183,115,439,0.938034188034188
"5523",173160,"BETHEL COLLEGE",1,0,1997,447,281,166,279,98,181,0.644,0.624,0.59,13840,34.968983,125,431,0.96420581655481
"5524",173160,"BETHEL COLLEGE",1,0,1998,513,314,199,314,122,192,0.612,0.612,0.613,14720,37.350111,132,485,0.94541910331384
"5525",173160,"BETHEL COLLEGE",1,0,1999,479,315,164,295,98,197,0.625,0.616,0.598,15300,43.043118,143,459,0.958246346555324
"5526",173160,"BETHEL COLLEGE",1,0,2000,591,357,234,364,127,237,0.664,0.616,0.543,15900,45.465678,153,568,0.961082910321489
"5527",173160,"BETHEL COLLEGE",1,0,2001,645,385,260,442,173,269,0.699,0.685,0.665,16780,48.034005,163,614,0.951937984496124
"5528",173160,"BETHEL COLLEGE",1,0,2002,567,348,219,370,125,245,0.704,0.653,0.571,17700,51.929821,171,540,0.952380952380952
"5529",173160,"BETHEL COLLEGE",1,0,2003,690,419,271,427,172,255,0.609,0.619,0.635,18700,53.894137,178,650,0.942028985507246
"5530",173160,"BETHEL UNIVERSITY",1,0,2004,669,386,283,385,160,225,0.583,0.575,0.565,19880,57.741104,189,615,0.919282511210762
"5531",173160,"Bethel University",1,0,2005,683,425,258,436,149,287,0.675,0.638,0.578,21130,63.055528,186,638,0.93411420204978
"5532",173160,"Bethel University",1,0,2006,629,351,278,392,157,235,0.67,0.623,0.565,22590,67.680245,198,575,0.914149443561208
"5533",173160,"Bethel University",1,0,2007,597,370,227,374,126,248,0.67,0.626,0.555,24400,75.419748,195,562,0.941373534338358
"5534",173160,"Bethel University",1,0,2008,632,377,255,408,155,253,0.671,0.646,0.608,25750,80.857426,207,578,0.914556962025316
"5535",173160,"Bethel University",1,0,2009,683,387,296,430,169,261,0.674,0.63,0.571,26900,95.215933,210,629,0.920937042459737
"5536",173160,"Bethel University",1,0,2010,604,366,238,408,146,262,0.716,0.675,0.613,27950,89.686795,195,557,0.922185430463576
"5537",173258,"CARLETON COLLEGE",0,1,1991,471,247,224,387,175,212,0.858,0.822,0.781,16296,48.589769,158,389,0.825902335456476
"5538",173258,"CARLETON COLLEGE",0,1,1992,494,249,245,402,204,198,0.795,0.814,0.833,17360,51.357248,154,399,0.807692307692308
"5539",173258,"CARLETON COLLEGE",0,1,1993,488,252,236,391,185,206,0.818,0.801,0.784,18405,55.255726,155,405,0.829918032786885
"5540",173258,"CARLETON COLLEGE",0,1,1995,463,232,231,393,191,202,0.871,0.849,0.827,20300,61.254524,163,379,0.818574514038877
"5541",173258,"CARLETON COLLEGE",0,1,1996,471,256,215,387,164,223,0.871,0.822,0.763,21117,64.966712,166,384,0.815286624203822
"5542",173258,"CARLETON COLLEGE",0,1,1997,484,255,229,412,195,217,0.851,0.851,0.852,21885,58.121251,169,405,0.836776859504132
"5543",173258,"CARLETON COLLEGE",0,1,1998,520,279,241,450,204,246,0.882,0.865,0.846,22611,62.74325,166,421,0.809615384615385
"5544",173258,"CARLETON COLLEGE",0,1,1999,507,257,250,410,199,211,0.821,0.809,0.796,23325,65.037281,170,423,0.834319526627219
"5545",173258,"CARLETON COLLEGE",0,1,2000,471,247,224,415,194,221,0.895,0.881,0.866,24240,70.642815,170,385,0.817409766454352
"5546",173258,"CARLETON COLLEGE",0,1,2001,516,265,251,467,222,245,0.925,0.905,0.884,25371,79.512782,170,397,0.76937984496124
"5547",173258,"CARLETON COLLEGE",0,1,2002,499,264,235,447,203,244,0.924,0.896,0.864,26745,89.419361,202,350,0.701402805611222
"5548",173258,"CARLETON COLLEGE",0,1,2003,488,241,247,435,215,220,0.913,0.891,0.87,28362,88.43374,212,359,0.735655737704918
"5549",173258,"CARLETON COLLEGE",0,1,2004,487,263,224,432,195,237,0.901,0.887,0.871,30501,86.962018,220,355,0.728952772073922
"5550",173258,"Carleton College",0,1,2005,542,278,264,478,226,252,0.907,0.882,0.856,32460,89.240062,213,359,0.662361623616236
"5551",173258,"Carleton College",0,1,2006,504,272,232,458,209,249,0.915,0.909,0.901,34083,94.143273,212,368,0.73015873015873
"5552",173258,"Carleton College",0,1,2007,509,255,254,456,221,235,0.922,0.896,0.87,35958,98.497806,215,361,0.709233791748527
"5553",173258,"Carleton College",0,1,2008,488,244,244,444,220,224,0.918,0.91,0.902,37845,102.857333,216,335,0.686475409836066
"5554",173258,"Carleton College",0,1,2009,528,272,256,480,222,258,0.949,0.909,0.867,39546,109.87919,222,352,0.666666666666667
"5555",173258,"Carleton College",0,1,2010,511,268,243,451,209,242,0.903,0.883,0.86,41076,111.542293,228,343,0.671232876712329
"5556",173328,"CONCORDIA COLLEGE",0,1,1991,151,94,57,31,10,21,0.223,0.205,0.175,8268,14.718848,51,119,0.788079470198676
"5557",173328,"CONCORDIA COLLEGE",0,1,1992,149,90,59,39,12,27,0.3,0.262,0.203,9000,15.465618,54,118,0.791946308724832
"5558",173328,"CONCORDIA COLLEGE",0,1,1993,138,77,61,39,16,23,0.299,0.283,0.262,9720,16.395231,53,116,0.840579710144927
"5559",173328,"CONCORDIA COLLEGE",0,1,1995,153,91,62,42,13,29,0.319,0.275,0.21,10815,17.36482,52,125,0.816993464052288
"5560",173328,"CONCORDIA COLLEGE",0,1,1996,161,82,79,53,25,28,0.341,0.329,0.316,11355,17.710561,50,133,0.826086956521739
"5561",173328,"CONCORDIA UNIVERSITY",0,1,1997,222,132,90,86,32,54,0.409,0.387,0.356,11980,20.064776,49,178,0.801801801801802
"5562",173328,"CONCORDIA UNIVERSITY",1,0,1998,213,106,107,57,24,33,0.311,0.268,0.224,12658,22.681561,72,179,0.84037558685446
"5563",173328,"CONCORDIA UNIVERSITY",1,0,1999,258,142,116,76,32,44,0.31,0.295,0.276,13040,24.148429,68,187,0.724806201550388
"5564",173328,"CONCORDIA UNIVERSITY",1,0,2000,212,124,88,57,15,42,0.339,0.269,0.17,14752,25.765572,77,158,0.745283018867924
"5565",173328,"CONCORDIA UNIVERSITY",1,0,2001,200,87,113,57,26,31,0.356,0.285,0.23,15786,28.031731,86,138,0.69
"5566",173328,"CONCORDIA UNIVERSITY",1,0,2002,175,89,86,57,19,38,0.427,0.326,0.221,17326,30.431763,81,137,0.782857142857143
"5567",173328,"CONCORDIA UNIVERSITY-ST PAUL",1,0,2003,167,83,84,59,25,34,0.41,0.353,0.298,18624,31.913342,86,123,0.736526946107784
"5568",173328,"CONCORDIA UNIVERSITY-ST PAUL",1,0,2004,176,102,74,64,24,40,0.392,0.364,0.324,19928,34.646886,81,127,0.721590909090909
"5569",173328,"Concordia University-Saint Paul",1,0,2005,163,84,79,53,21,32,0.381,0.325,0.266,21312,38.84248,84,113,0.693251533742331
"5570",173328,"Concordia University-Saint Paul",1,0,2006,199,108,91,51,19,32,0.296,0.256,0.209,22378,37.49961,89,139,0.698492462311558
"5571",173328,"Concordia University-Saint Paul",1,0,2007,201,112,89,61,20,41,0.366,0.303,0.225,23496,39.546322,73,138,0.686567164179104
"5572",173328,"Concordia University-Saint Paul",1,0,2008,211,116,95,60,25,35,0.302,0.284,0.263,24900,33.181875,78,137,0.649289099526066
"5573",173328,"Concordia University-Saint Paul",1,0,2009,183,82,101,56,22,34,0.415,0.306,0.218,26400,35.244637,70,110,0.601092896174863
"5574",173328,"Concordia University-Saint Paul",1,0,2010,217,126,91,81,19,62,0.492,0.373,0.209,27400,35.527528,69,132,0.608294930875576
"5575",173647,"GUSTAVUS ADOLPHUS COLLEGE",1,0,1991,624,336,288,464,210,254,0.756,0.744,0.729,11900,35.982606,142,595,0.953525641025641
"5576",173647,"GUSTAVUS ADOLPHUS COLLEGE",1,0,1992,620,327,293,455,224,231,0.706,0.734,0.765,12600,38.214894,160,582,0.938709677419355
"5577",173647,"GUSTAVUS ADOLPHUS COLLEGE",1,0,1993,630,369,261,485,191,294,0.797,0.77,0.732,13400,40.744968,162,584,0.926984126984127
"5578",173647,"GUSTAVUS ADOLPHUS COLLEGE",1,0,1995,690,380,310,478,196,282,0.742,0.693,0.632,14760,47.042417,164,659,0.955072463768116
"5579",173647,"GUSTAVUS ADOLPHUS COLLEGE",1,0,1996,633,375,258,504,202,302,0.805,0.796,0.783,15350,50.413003,164,585,0.924170616113744
"5580",173647,"GUSTAVUS ADOLPHUS COLLEGE",1,0,1997,625,353,272,438,174,264,0.748,0.701,0.64,15940,42.576637,165,592,0.9472
"5581",173647,"GUSTAVUS ADOLPHUS COLLEGE",1,0,1998,695,391,304,477,195,282,0.721,0.686,0.641,16560,42.295564,166,663,0.953956834532374
"5582",173647,"GUSTAVUS ADOLPHUS COLLEGE",1,0,1999,654,365,289,473,207,266,0.729,0.723,0.716,17200,47.299888,170,612,0.935779816513762
"5583",173647,"GUSTAVUS ADOLPHUS COLLEGE",1,0,2000,652,383,269,392,169,223,0.582,0.601,0.628,17970,53.715762,172,603,0.924846625766871
"5584",173647,"GUSTAVUS ADOLPHUS COLLEGE",1,0,2001,601,343,258,468,196,272,0.793,0.779,0.76,18940,55.239324,174,546,0.908485856905158
"5585",173647,"GUSTAVUS ADOLPHUS COLLEGE",1,0,2002,645,383,262,521,216,305,0.796,0.808,0.824,19215,59.2698,185,601,0.931782945736434
"5586",173647,"GUSTAVUS ADOLPHUS COLLEGE",1,0,2003,623,331,292,514,235,279,0.843,0.825,0.805,20405,59.237998,178,571,0.91653290529695
"5587",173647,"GUSTAVUS ADOLPHUS COLLEGE",1,0,2004,651,361,290,468,221,247,0.684,0.719,0.762,22625,59.664584,183,584,0.897081413210445
"5588",173647,"Gustavus Adolphus College",1,0,2005,739,439,300,588,208,380,0.866,0.796,0.693,25765,62.314416,204,673,0.910690121786198
"5589",173647,"Gustavus Adolphus College",1,0,2006,684,396,288,553,226,327,0.826,0.808,0.785,26310,67.073102,192,610,0.891812865497076
"5590",173647,"Gustavus Adolphus College",1,0,2007,666,374,292,542,234,308,0.824,0.814,0.801,28125,68.96525,193,573,0.86036036036036
"5591",173647,"Gustavus Adolphus College",1,0,2008,616,346,270,495,211,284,0.821,0.804,0.781,29990,72.279421,205,541,0.878246753246753
"5592",173647,"Gustavus Adolphus College",1,0,2009,611,372,239,495,193,302,0.812,0.81,0.808,31460,75.489096,215,514,0.841243862520458
"5593",173647,"Gustavus Adolphus College",1,0,2010,585,314,271,454,208,246,0.783,0.776,0.768,33100,76.023525,226,470,0.803418803418803
"5594",173902,"MACALESTER COLLEGE",1,0,1991,403,206,197,284,126,158,0.767,0.705,0.64,13331,36.380345,124,311,0.771712158808933
"5595",173902,"MACALESTER COLLEGE",1,0,1992,475,258,217,332,139,193,0.748,0.699,0.641,14125,49.75804,126,358,0.753684210526316
"5596",173902,"MACALESTER COLLEGE",1,0,1993,452,252,200,318,128,190,0.754,0.704,0.64,15107,52.424604,120,346,0.765486725663717
"5597",173902,"MACALESTER COLLEGE",1,0,1995,437,231,206,322,143,179,0.775,0.737,0.694,16686,60.063089,138,353,0.807780320366133
"5598",173902,"MACALESTER COLLEGE",1,0,1996,491,293,198,377,151,226,0.771,0.768,0.763,17580,63.462308,141,387,0.788187372708758
"5599",173902,"MACALESTER COLLEGE",1,0,1997,450,251,199,339,140,199,0.793,0.753,0.704,18630,47.818,143,347,0.771111111111111
"5600",173902,"MACALESTER COLLEGE",1,0,1998,465,260,205,339,153,186,0.715,0.729,0.746,19673,52.119,147,352,0.756989247311828
"5601",173902,"MACALESTER COLLEGE",1,0,1999,460,271,189,360,147,213,0.786,0.783,0.778,20560,54.199,147,332,0.721739130434783
"5602",173902,"MACALESTER COLLEGE",1,0,2000,454,299,155,366,126,240,0.803,0.806,0.813,21486,55.672,147.5,336,0.740088105726872
"5603",173902,"MACALESTER COLLEGE",1,0,2001,505,265,240,415,193,222,0.838,0.822,0.804,22480,60.574,148,379,0.75049504950495
"5604",173902,"MACALESTER COLLEGE",1,0,2002,440,241,199,370,169,201,0.834,0.841,0.849,23604,64.75,150,310,0.704545454545455
"5605",173902,"MACALESTER COLLEGE",1,0,2003,513,300,213,422,168,254,0.847,0.823,0.789,24902,66.685,149,407,0.793372319688109
"5606",173902,"MACALESTER COLLEGE",1,0,2004,485,284,201,410,164,246,0.866,0.845,0.816,26638,68.219,151,321,0.661855670103093
"5607",173902,"MacAlester College",1,0,2005,491,287,204,405,158,247,0.861,0.825,0.775,28474,70.91,154,352,0.716904276985743
"5608",173902,"Macalester College",1,0,2006,501,281,220,429,181,248,0.883,0.856,0.823,30870,75.444,154,353,0.704590818363273
"5609",173902,"Macalester College",1,0,2007,485,270,215,411,176,235,0.87,0.847,0.819,33494,77.446,157,327,0.674226804123711
"5610",173902,"Macalester College",1,0,2008,478,279,199,401,161,240,0.86,0.839,0.809,36304,83.124,164,346,0.723849372384937
"5611",173902,"Macalester College",1,0,2009,564,329,235,481,196,285,0.866,0.853,0.834,37974,90.85,163,391,0.693262411347518
"5612",173902,"Macalester College",1,0,2010,515,314,201,434,158,276,0.879,0.843,0.786,39846,90.595,165,332,0.644660194174757
"5613",174066,"UNIVERSITY OF MINNESOTA TWIN CITIES",0,1,1991,1979,917,1062,318,134,184,0.201,0.161,0.126,2829,1418.854913,1513,1618,0.817584638706417
"5614",174066,"UNIVERSITY OF MINNESOTA TWIN CITIES",0,1,1992,1980,905,1075,329,137,192,0.212,0.166,0.127,3158,1887.167894,1560,1634,0.825252525252525
"5615",174066,"UNIVERSITY OF MINNESOTA TWIN CITIES",0,1,1993,2272,1080,1192,413,171,242,0.224,0.182,0.143,3266,1444.240089,1538,1848,0.813380281690141
"5616",174066,"UNIVERSITY OF MINNESOTA TWIN CITIES",0,1,1995,4128,2100,2028,984,418,566,0.27,0.238,0.206,3857,1616.218183,1499,3308,0.801356589147287
"5617",174066,"UNIVERSITY OF MINNESOTA TWIN CITIES",0,1,1996,4057,2049,2008,1050,451,599,0.292,0.259,0.225,4320,1673.834954,1478,3300,0.813408922849396
"5618",174066,"UNIVERSITY OF MINNESOTA-TWIN CITIES",0,1,1997,4371,2282,2089,1208,467,741,0.325,0.276,0.224,4749,1594.815137,1446,3462,0.7920384351407
"5619",174066,"UNIVERSITY OF MINNESOTA-TWIN CITIES",0,1,1998,4992,2582,2410,1441,573,868,0.336,0.289,0.238,4963,1487.690399,1440,3986,0.798477564102564
"5620",174066,"UNIVERSITY OF MINNESOTA-TWIN CITIES",1,0,1999,5025,2636,2389,1604,655,949,0.36,0.319,0.274,4171,1626.533218,1461,4033,0.802587064676617
"5621",174066,"UNIVERSITY OF MINNESOTA-TWIN CITIES",1,0,2000,4865,2577,2288,1581,668,913,0.354,0.325,0.292,4401,1636.78481,1490,3853,0.791983556012333
"5622",174066,"UNIVERSITY OF MINNESOTA-TWIN CITIES",1,0,2001,5259,2677,2582,1939,841,1098,0.41,0.369,0.326,4852,1755.153055,1519,4248,0.807758128921848
"5623",174066,"UNIVERSITY OF MINNESOTA-TWIN CITIES",1,0,2002,5162,2762,2400,2118,869,1249,0.452,0.41,0.362,5420,1850.850897,1559,4109,0.796009298721426
"5624",174066,"UNIVERSITY OF MINNESOTA-TWIN CITIES",1,0,2003,5160,2820,2340,2341,902,1439,0.51,0.454,0.385,5962,1964.920635,1626,3970,0.76937984496124
"5625",174066,"UNIVERSITY OF MINNESOTA-TWIN CITIES",1,0,2004,5562,3081,2481,2549,994,1555,0.505,0.458,0.401,6677,1936.203801,1669,4434,0.797195253505933
"5626",174066,"University of Minnesota-Twin Cities",1,0,2005,5274,2856,2418,2488,1023,1465,0.513,0.472,0.423,7140,2037.771087,1677,4165,0.789723170269245
"5627",174066,"University of Minnesota-Twin Cities",1,0,2006,5418,2970,2448,2734,1150,1584,0.533,0.505,0.47,7588,2182.280854,1710,4194,0.774086378737541
"5628",174066,"University of Minnesota-Twin Cities",1,0,2007,5256,2927,2329,2863,1182,1681,0.574,0.545,0.508,7950,2328.787414,2041,3990,0.759132420091324
"5629",174066,"University of Minnesota-Twin Cities",1,0,2008,5089,2813,2276,2975,1224,1751,0.623,0.585,0.538,8500,2610.0005,1933,3729,0.732756926704657
"5630",174066,"University of Minnesota-Twin Cities",1,0,2009,5381,2849,2532,3188,1380,1808,0.635,0.592,0.545,9120,2682.239235,1834,3986,0.740754506597287
"5631",174066,"University of Minnesota-Twin Cities",1,0,2010,5310,2810,2500,3251,1428,1823,0.649,0.612,0.571,9794,2743.419751,1846,4074,0.767231638418079
"5632",174233,"UNIVERSITY OF MINNESOTA DULUTH",0,1,1991,1091,567,524,196,69,127,0.224,0.18,0.132,2750,86.455891,281,975,0.893675527039413
"5633",174233,"UNIVERSITY OF MINNESOTA DULUTH",0,1,1992,1163,566,597,221,95,126,0.223,0.19,0.159,3044,51.735719,290,1092,0.938950988822012
"5634",174233,"UNIVERSITY OF MINNESOTA-DULUTH",0,1,1993,1248,631,617,226,88,138,0.219,0.181,0.143,3137,96.151867,285,1164,0.932692307692308
"5635",174233,"UNIVERSITY OF MINNESOTA-DULUTH",0,1,1995,1462,688,774,361,146,215,0.312,0.247,0.189,3745,90.190058,327,1341,0.917236662106703
"5636",174233,"UNIVERSITY OF MINNESOTA-DULUTH",0,1,1996,1736,886,850,411,156,255,0.288,0.237,0.184,4187,93.908584,334,1614,0.929723502304147
"5637",174233,"UNIVERSITY OF MINNESOTA-DULUTH",0,1,1997,1679,843,836,363,140,223,0.264,0.216,0.167,4522,97.131186,335,1550,0.923168552709946
"5638",174233,"UNIVERSITY OF MINNESOTA-DULUTH",0,1,1998,1746,911,835,362,138,224,0.246,0.207,0.165,4725,103.299261,342,1623,0.929553264604811
"5639",174233,"UNIVERSITY OF MINNESOTA-DULUTH",1,0,1999,2000,1032,968,416,168,248,0.24,0.208,0.174,4230,112.857132,356,1869,0.9345
"5640",174233,"UNIVERSITY OF MINNESOTA-DULUTH",1,0,2000,2088,1107,981,508,182,326,0.294,0.243,0.186,4463,117.652966,370.5,1947,0.932471264367816
"5641",174233,"UNIVERSITY OF MINNESOTA-DULUTH",1,0,2001,2109,1094,1015,495,180,315,0.288,0.235,0.177,4920,128.042707,385,1970,0.934091986723566
"5642",174233,"UNIVERSITY OF MINNESOTA-DULUTH",1,0,2002,2025,1029,996,476,183,293,0.285,0.235,0.184,5585,142.263521,410,1870,0.923456790123457
"5643",174233,"UNIVERSITY OF MINNESOTA-DULUTH",1,0,2003,2155,1073,1082,514,218,296,0.276,0.239,0.201,6045,150.978139,378,1972,0.91508120649652
"5644",174233,"UNIVERSITY OF MINNESOTA-DULUTH",1,0,2004,2205,1153,1052,568,208,360,0.312,0.258,0.198,6710,150.407061,398,2021,0.916553287981859
"5645",174233,"University of Minnesota-Duluth",1,0,2005,2111,1025,1086,565,243,322,0.314,0.268,0.224,7157,164.492015,417,1969,0.932733301752724
"5646",174233,"University of Minnesota-Duluth",1,0,2006,2283,1105,1178,629,270,359,0.325,0.276,0.229,7605,177.224846,414,2122,0.929478756022777
"5647",174233,"University of Minnesota-Duluth",1,0,2007,2196,1100,1096,649,244,405,0.368,0.296,0.223,7700,190.765353,430,2006,0.913479052823315
"5648",174233,"University of Minnesota-Duluth",1,0,2008,2213,1110,1103,760,306,454,0.409,0.343,0.277,8230,214.156067,437,1999,0.903298689561681
"5649",174233,"University of Minnesota-Duluth",1,0,2009,2079,1028,1051,728,296,432,0.42,0.35,0.282,8830,212.612148,431,1887,0.907647907647908
"5650",174233,"University of Minnesota-Duluth",1,0,2010,2316,1112,1204,819,356,463,0.416,0.354,0.296,9482,200.726345,439,2097,0.905440414507772
"5651",174251,"UNIVERSITY OF MINNESOTA MORRIS",0,1,1991,462,272,190,155,55,100,0.368,0.335,0.289,2781,22.474314,116,384,0.831168831168831
"5652",174251,"UNIVERSITY OF MINNESOTA MORRIS",0,1,1992,497,291,206,187,67,120,0.412,0.376,0.325,3246,13.750651,113,435,0.875251509054326
"5653",174251,"UNIVERSITY OF MINNESOTA-MORRIS",0,1,1993,519,284,235,209,88,121,0.426,0.403,0.374,3417,23.969571,112,440,0.847784200385356
"5654",174251,"UNIVERSITY OF MINNESOTA-MORRIS",0,1,1995,503,297,206,202,66,136,0.458,0.402,0.32,4189,23.979072,113,430,0.854870775347913
"5655",174251,"UNIVERSITY OF MINNESOTA-MORRIS",0,1,1996,522,310,212,223,71,152,0.49,0.427,0.335,4554,25.829751,115,447,0.85632183908046
"5656",174251,"UNIVERSITY OF MINNESOTA-MORRIS",0,1,1997,461,271,190,161,53,108,0.398,0.349,0.279,4766,25.251903,111,387,0.839479392624729
"5657",174251,"UNIVERSITY OF MINNESOTA-MORRIS",0,1,1998,522,330,192,198,62,136,0.412,0.379,0.323,4956,26.902009,114,441,0.844827586206897
"5658",174251,"UNIVERSITY OF MINNESOTA-MORRIS",0,1,1999,453,270,183,174,70,104,0.385,0.384,0.383,4777,28.616813,112,386,0.852097130242826
"5659",174251,"UNIVERSITY OF MINNESOTA-MORRIS",1,0,2000,467,267,200,186,66,120,0.449,0.398,0.33,5033,30.489748,117.5,391,0.837259100642398
"5660",174251,"UNIVERSITY OF MINNESOTA-MORRIS",1,0,2001,474,296,178,206,74,132,0.446,0.435,0.416,5549,32.665999,123,394,0.831223628691983
"5661",174251,"UNIVERSITY OF MINNESOTA-MORRIS",1,0,2002,475,309,166,219,71,148,0.479,0.461,0.428,6381,34.606504,123,404,0.850526315789474
"5662",174251,"UNIVERSITY OF MINNESOTA-MORRIS",1,0,2003,412,249,163,179,60,119,0.478,0.434,0.368,6908,35.932721,120,349,0.847087378640777
"5663",174251,"UNIVERSITY OF MINNESOTA-MORRIS",1,0,2004,383,235,148,205,73,132,0.562,0.535,0.493,7668,35.553352,113,303,0.7911227154047
"5664",174251,"University of Minnesota-Morris",1,0,2005,353,207,146,171,63,108,0.522,0.484,0.432,8204,35.395599,118,275,0.779036827195467
"5665",174251,"University of Minnesota-Morris",1,0,2006,377,214,163,179,66,113,0.528,0.475,0.405,8720,38.542525,113,283,0.750663129973475
"5666",174251,"University of Minnesota-Morris",1,0,2007,358,205,153,180,65,115,0.561,0.503,0.425,7700,41.040507,123,281,0.784916201117318
"5667",174251,"University of Minnesota-Morris",1,0,2008,373,209,164,200,80,120,0.574,0.536,0.488,8230,44.580929,112,286,0.766756032171582
"5668",174251,"University of Minnesota-Morris",1,0,2009,404,235,169,206,74,132,0.562,0.51,0.438,8830,41.137862,105,315,0.77970297029703
"5669",174251,"University of Minnesota-Morris",1,0,2010,418,242,176,211,81,130,0.537,0.505,0.46,9482,41.010201,110,295,0.705741626794258
"5670",174491,"NORTHWESTERN COLLEGE",0,1,1991,267,165,102,84,24,60,0.364,0.315,0.235,9096,23.855998,53,260,0.973782771535581
"5671",174491,"NORTHWESTERN COLLEGE",0,1,1992,308,183,125,106,40,66,0.361,0.344,0.32,9825,27.543032,57,297,0.964285714285714
"5672",174491,"NORTHWESTERN COLLEGE",0,1,1993,329,209,120,107,38,69,0.33,0.325,0.317,10659,29.033744,57,314,0.954407294832827
"5673",174491,"NORTHWESTERN COLLEGE",0,1,1995,378,245,133,155,43,112,0.457,0.41,0.323,11985,31.392219,54,366,0.968253968253968
"5674",174491,"NORTHWESTERN COLLEGE",0,1,1996,358,223,135,140,36,104,0.466,0.391,0.267,12750,33.177934,57,336,0.93854748603352
"5675",174491,"NORTHWESTERN COLLEGE",0,1,1997,372,231,141,162,61,101,0.437,0.435,0.433,13125,25.478973,61,352,0.946236559139785
"5676",174491,"NORTHWESTERN COLLEGE",0,1,1998,393,242,151,155,55,100,0.413,0.394,0.364,13920,26.782161,58,375,0.954198473282443
"5677",174491,"NORTHWESTERN COLLEGE",1,0,1999,392,262,130,160,42,118,0.45,0.408,0.323,14336,29.348168,61,376,0.959183673469388
"5678",174491,"NORTHWESTERN COLLEGE",1,0,2000,430,279,151,178,52,126,0.452,0.414,0.344,14982,33.675919,63.5,409,0.951162790697674
"5679",174491,"NORTHWESTERN COLLEGE",1,0,2001,400,262,138,184,54,130,0.496,0.46,0.391,15600,36.324268,66,373,0.9325
"5680",174491,"NORTHWESTERN COLLEGE",1,0,2002,431,267,164,183,75,108,0.404,0.425,0.457,16500,46.491912,78,410,0.951276102088167
"5681",174491,"NORTHWESTERN COLLEGE",1,0,2003,431,291,140,191,55,136,0.467,0.443,0.393,17400,41.862353,84,395,0.916473317865429
"5682",174491,"NORTHWESTERN COLLEGE",1,0,2004,409,245,164,194,67,127,0.518,0.474,0.409,18370,45.719547,89,378,0.924205378973105
"5683",174491,"Northwestern College",1,0,2005,476,295,181,221,76,145,0.492,0.464,0.42,19100,48.445044,89,424,0.890756302521008
"5684",174491,"Northwestern College",1,0,2006,498,302,196,256,89,167,0.553,0.514,0.454,19990,52.723763,95,459,0.921686746987952
"5685",174491,"Northwestern College",1,0,2007,526,315,211,264,99,165,0.524,0.502,0.469,20990,56.202036,98,478,0.908745247148289
"5686",174491,"Northwestern College",1,0,2008,455,273,182,202,62,140,0.513,0.444,0.341,22250,59.255522,101,420,0.923076923076923
"5687",174491,"Northwestern College",1,0,2009,450,258,192,240,86,154,0.597,0.533,0.448,22990,62.907927,101,404,0.897777777777778
"5688",174491,"Northwestern College",1,0,2010,451,247,204,219,89,130,0.526,0.486,0.436,24370,62.155464,103,378,0.838137472283814
"5689",174844,"SAINT OLAF COLLEGE",1,0,1991,733,391,342,534,246,288,0.737,0.729,0.719,12080,56.26779,253,674,0.919508867667121
"5690",174844,"SAINT OLAF COLLEGE",1,0,1992,701,409,292,501,192,309,0.755,0.715,0.658,12750,61.132224,230,641,0.914407988587732
"5691",174844,"SAINT OLAF COLLEGE",1,0,1993,737,413,324,515,215,300,0.726,0.699,0.664,13560,63.670717,235,687,0.932157394843962
"5692",174844,"SAINT OLAF COLLEGE",1,0,1995,742,431,311,557,223,334,0.775,0.751,0.717,15000,70.839384,244,692,0.932614555256065
"5693",174844,"SAINT OLAF COLLEGE",1,0,1996,771,448,323,565,228,337,0.752,0.733,0.706,15700,75.781348,238,715,0.927367055771725
"5694",174844,"SAINT OLAF COLLEGE",1,0,1997,722,416,306,539,227,312,0.75,0.747,0.742,16500,60.441564,227,666,0.922437673130194
"5695",174844,"SAINT OLAF COLLEGE",1,0,1998,756,431,325,594,256,338,0.784,0.786,0.788,17140,62.11998,218,692,0.915343915343915
"5696",174844,"SAINT OLAF COLLEGE",1,0,1999,761,451,310,594,225,369,0.818,0.781,0.726,18250,66.38279,210,661,0.868593955321945
"5697",174844,"SAINT OLAF COLLEGE",1,0,2000,753,441,312,600,232,368,0.835,0.797,0.744,19400,70.444718,202.5,675,0.896414342629482
"5698",174844,"SAINT OLAF COLLEGE",1,0,2001,744,432,312,608,253,355,0.822,0.817,0.811,21280,74.720528,195,639,0.858870967741935
"5699",174844,"SAINT OLAF COLLEGE",1,0,2002,777,479,298,645,235,410,0.856,0.83,0.789,22200,78.259795,200,689,0.886743886743887
"5700",174844,"SAINT OLAF COLLEGE",1,0,2003,719,422,297,593,234,359,0.851,0.825,0.788,23650,81.681464,211,606,0.842837273991655
"5701",174844,"SAINT OLAF COLLEGE",1,0,2004,777,446,331,631,258,373,0.836,0.812,0.779,25150,86.164958,198,632,0.813384813384813
"5702",174844,"St. Olaf College",1,0,2005,764,426,338,617,270,347,0.815,0.808,0.799,26500,87.241991,206,657,0.859947643979058
"5703",174844,"St. Olaf College",1,0,2006,792,436,356,660,288,372,0.853,0.833,0.809,28200,89.98818,199,688,0.868686868686869
"5704",174844,"St. Olaf College",1,0,2007,751,406,345,624,287,337,0.83,0.831,0.832,30600,95.419909,207,652,0.868175765645806
"5705",174844,"St. Olaf College",1,0,2008,813,454,359,698,292,406,0.894,0.859,0.813,34300,100.82131,216,688,0.846248462484625
"5706",174844,"St. Olaf College",1,0,2009,778,445,333,652,267,385,0.865,0.838,0.802,35500,104.863813,220,640,0.822622107969152
"5707",174844,"St Olaf College",1,0,2010,844,434,410,719,332,387,0.892,0.852,0.81,36800,105.438807,229,690,0.817535545023697
"5708",174899,"COLLEGE OF SAINT SCHOLASTICA",0,1,1991,276,206,70,114,28,86,0.418,0.413,0.4,9861,26.340388,93,273,0.989130434782609
"5709",174899,"COLLEGE OF SAINT SCHOLASTICA",0,1,1992,325,240,85,126,36,90,0.375,0.388,0.424,10659,28.537586,101,318,0.978461538461538
"5710",174899,"COLLEGE OF SAINT SCHOLASTICA",0,1,1993,254,193,61,120,25,95,0.492,0.472,0.41,11280,28.470336,108,222,0.874015748031496
"5711",174899,"COLLEGE OF SAINT SCHOLASTICA",0,1,1995,270,201,69,142,30,112,0.557,0.526,0.435,12534,28.959317,128,238,0.881481481481482
"5712",174899,"COLLEGE OF SAINT SCHOLASTICA",0,1,1996,295,229,66,145,36,109,0.476,0.492,0.545,13131,31.469448,113,265,0.898305084745763
"5713",174899,"COLLEGE OF SAINT SCHOLASTICA",0,1,1997,244,180,64,141,32,109,0.606,0.578,0.5,13995,25.459599,119,211,0.864754098360656
"5714",174899,"COLLEGE OF SAINT SCHOLASTICA",0,1,1998,277,213,64,163,30,133,0.624,0.588,0.469,15060,27.729599,93,245,0.884476534296029
"5715",174899,"THE COLLEGE OF SAINT SCHOLASTICA",1,0,1999,305,230,75,156,36,120,0.522,0.511,0.48,15420,24.993909,101,275,0.901639344262295
"5716",174899,"THE COLLEGE OF SAINT SCHOLASTICA",1,0,2000,315,226,89,173,45,128,0.566,0.549,0.506,16190,25.917913,101.5,287,0.911111111111111
"5717",174899,"THE COLLEGE OF SAINT SCHOLASTICA",1,0,2001,314,224,90,175,48,127,0.567,0.557,0.533,17080,26.714187,102,288,0.917197452229299
"5718",174899,"THE COLLEGE OF SAINT SCHOLASTICA",1,0,2002,382,286,96,218,43,175,0.612,0.571,0.448,18106,30.670211,105,348,0.910994764397906
"5719",174899,"THE COLLEGE OF SAINT SCHOLASTICA",1,0,2003,411,299,112,256,75,181,0.605,0.623,0.67,19192,34.610746,111,371,0.902676399026764
"5720",174899,"THE COLLEGE OF SAINT SCHOLASTICA",1,0,2004,437,300,137,227,66,161,0.537,0.519,0.482,20630,38.804151,124,382,0.874141876430206
"5721",174899,"The College of Saint Scholastica",1,0,2005,490,350,140,265,70,195,0.557,0.541,0.5,22110,43.846405,133,438,0.893877551020408
"5722",174899,"The College of Saint Scholastica",1,0,2006,493,331,162,283,79,204,0.616,0.574,0.488,23434,46.591891,135,412,0.835699797160243
"5723",174899,"The College of Saint Scholastica",1,0,2007,487,336,151,288,76,212,0.631,0.591,0.503,24840,49.598263,145,423,0.868583162217659
"5724",174899,"The College of Saint Scholastica",1,0,2008,575,381,194,314,93,221,0.58,0.546,0.479,26324,54.777162,155,476,0.827826086956522
"5725",174899,"The College of Saint Scholastica",1,0,2009,540,359,181,337,90,247,0.688,0.624,0.497,27114,59.879134,166,476,0.881481481481482
"5726",174899,"The College of Saint Scholastica",1,0,2010,575,358,217,328,100,228,0.637,0.57,0.461,28200,62.832902,175,489,0.850434782608696
"5727",174914,"UNIVERSITY OF ST THOMAS",1,0,1991,854,457,397,393,174,219,0.479,0.46,0.438,10564,92.109249,280,784,0.918032786885246
"5728",174914,"UNIVERSITY OF ST THOMAS",1,0,1992,798,444,354,362,141,221,0.498,0.454,0.398,11204,106.792045,295,727,0.911027568922306
"5729",174914,"UNIVERSITY OF ST THOMAS",1,0,1993,827,439,388,382,155,227,0.517,0.462,0.399,11748,111.392236,310,737,0.891172914147521
"5730",174914,"UNIVERSITY OF ST THOMAS",1,0,1995,852,454,398,430,181,249,0.548,0.505,0.455,13106,119.172391,298,769,0.902582159624413
"5731",174914,"UNIVERSITY OF ST THOMAS",1,0,1996,991,540,451,519,204,315,0.583,0.524,0.452,13778,126.734591,299,919,0.927346115035318
"5732",174914,"UNIVERSITY OF ST THOMAS",1,0,1997,955,514,441,595,237,358,0.697,0.623,0.537,14660,121.340728,317,869,0.909947643979058
"5733",174914,"UNIVERSITY OF ST THOMAS",1,0,1998,1038,579,459,561,230,331,0.572,0.54,0.501,15396,129.761217,321,942,0.907514450867052
"5734",174914,"UNIVERSITY OF ST THOMAS",1,0,1999,1087,603,484,642,255,387,0.642,0.591,0.527,16128,142.175307,338,993,0.913523459061638
"5735",174914,"UNIVERSITY OF ST THOMAS",1,0,2000,1082,578,504,597,244,353,0.611,0.552,0.484,17088,152.02921,357,971,0.897412199630314
"5736",174914,"UNIVERSITY OF ST THOMAS",1,0,2001,1080,579,501,601,253,348,0.601,0.556,0.505,18096,167.046458,376,943,0.873148148148148
"5737",174914,"UNIVERSITY OF ST THOMAS",1,0,2002,1095,577,518,629,280,349,0.605,0.574,0.541,19120,158.485882,387,992,0.905936073059361
"5738",174914,"UNIVERSITY OF ST THOMAS",1,0,2003,1038,547,491,584,244,340,0.622,0.563,0.497,20240,165.7374,387,952,0.917148362235067
"5739",174914,"UNIVERSITY OF ST THOMAS",1,0,2004,1161,608,553,710,312,398,0.655,0.612,0.564,21440,172.830393,395,970,0.835486649440138
"5740",174914,"University of St Thomas",1,0,2005,1325,706,619,812,342,470,0.666,0.613,0.553,22880,174.737021,384,1115,0.841509433962264
"5741",174914,"University of St Thomas",1,0,2006,1298,644,654,816,392,424,0.658,0.629,0.599,24368,183.004925,395,1129,0.86979969183359
"5742",174914,"University of St Thomas",1,0,2007,1313,672,641,822,365,457,0.68,0.626,0.569,25808,195.164593,394,1111,0.846153846153846
"5743",174914,"University of St Thomas",1,0,2008,1321,638,683,792,374,418,0.655,0.6,0.548,27328,205.464084,410,1088,0.823618470855413
"5744",174914,"University of St Thomas",1,0,2009,1350,586,764,812,439,373,0.636,0.601,0.575,28944,218.086535,420,1106,0.819259259259259
"5745",174914,"University of St Thomas",1,0,2010,1518,762,756,941,396,545,0.715,0.62,0.524,29952,215.678653,433,1329,0.875494071146245
"5746",175342,"ALCORN STATE UNIVERSITY",1,0,1991,899,520,379,108,25,83,0.16,0.12,0.066,2068,32.344724,160,16,0.017797552836485
"5747",175342,"ALCORN STATE UNIVERSITY",1,0,1992,531,310,221,73,16,57,0.184,0.137,0.072,2376,32.608622,158,19,0.0357815442561205
"5748",175342,"ALCORN STATE UNIVERSITY",1,0,1993,506,299,207,100,24,76,0.254,0.198,0.116,2376,36.265906,168,9,0.0177865612648221
"5749",175342,"ALCORN STATE UNIVERSITY",1,0,1995,746,410,336,148,38,110,0.268,0.198,0.113,2389,40.229105,159,3,0.00402144772117962
"5750",175342,"ALCORN STATE UNIVERSITY",1,0,1996,621,384,237,175,44,131,0.341,0.282,0.186,2389,44.291552,162,4,0.00644122383252818
"5751",175342,"ALCORN STATE UNIVERSITY",1,0,1997,532,299,233,138,42,96,0.321,0.259,0.18,2429,47.91417,159,7,0.0131578947368421
"5752",175342,"ALCORN STATE UNIVERSITY",1,0,1998,556,306,250,140,41,99,0.324,0.252,0.164,2685,47.827648,172,3,0.00539568345323741
"5753",175342,"ALCORN STATE UNIVERSITY",1,0,1999,553,309,244,130,41,89,0.288,0.235,0.168,2685,52.717787,176,1,0.00180831826401447
"5754",175342,"ALCORN STATE UNIVERSITY",1,0,2000,489,248,241,107,28,79,0.318,0.219,0.116,2585,63.164319,171.5,5,0.0102249488752556
"5755",175342,"ALCORN STATE UNIVERSITY",1,0,2001,495,262,233,97,36,61,0.233,0.196,0.155,2294,61.126052,167,6,0.0121212121212121
"5756",175342,"ALCORN STATE UNIVERSITY",1,0,2002,423,249,174,86,23,63,0.253,0.203,0.132,2478,55.797976,171,8,0.0189125295508274
"5757",175342,"ALCORN STATE UNIVERSITY",1,0,2003,495,271,224,108,32,76,0.28,0.218,0.143,2478,60.418816,187,8,0.0161616161616162
"5758",175342,"ALCORN STATE UNIVERSITY",1,0,2004,572,309,263,116,33,83,0.269,0.203,0.125,2999,60.926868,174,21,0.0367132867132867
"5759",175342,"Alcorn State University",1,0,2005,526,274,252,100,44,56,0.204,0.19,0.175,2733,63.067523,186,17,0.032319391634981
"5760",175342,"Alcorn State University",1,0,2006,545,302,243,79,34,45,0.149,0.145,0.14,3300,64.746957,175,7,0.0128440366972477
"5761",175342,"Alcorn State University",1,0,2007,514,305,209,94,27,67,0.22,0.183,0.129,3432,72.316166,172,3,0.00583657587548638
"5762",175342,"Alcorn State University",1,0,2008,451,261,190,87,36,51,0.195,0.193,0.189,3571,79.277734,175,7,0.0155210643015521
"5763",175342,"Alcorn State University",1,0,2009,463,277,186,77,20,57,0.206,0.166,0.108,3571,77.345135,183,12,0.0259179265658747
"5764",175342,"Alcorn State University",1,0,2010,588,341,247,94,25,69,0.202,0.16,0.101,3931,80.838201,176,2,0.00340136054421769
"5765",175421,"BELHAVEN COLLEGE",1,0,1991,43,27,16,5,2,3,0.111,0.116,0.125,5850,6.821353,28,29,0.674418604651163
"5766",175421,"BELHAVEN COLLEGE",1,0,1992,89,52,37,22,10,12,0.231,0.247,0.27,6300,7.723106,30,70,0.786516853932584
"5767",175421,"BELHAVEN COLLEGE",1,0,1993,113,59,54,37,16,21,0.356,0.327,0.296,6980,8.856718,34,88,0.778761061946903
"5768",175421,"BELHAVEN COLLEGE",1,0,1995,112,67,45,39,13,26,0.388,0.348,0.289,7890,11.583651,36,90,0.803571428571429
"5769",175421,"BELHAVEN COLLEGE",1,0,1996,84,42,42,21,11,10,0.238,0.25,0.262,8390,11.50415,36,62,0.738095238095238
"5770",175421,"BELHAVEN COLLEGE",1,0,1997,86,42,44,28,11,17,0.405,0.326,0.25,8990,10.899385,38,71,0.825581395348837
"5771",175421,"BELHAVEN COLLEGE",1,0,1998,112,53,59,35,12,23,0.434,0.312,0.203,9870,11.940483,42,90,0.803571428571429
"5772",175421,"BELHAVEN COLLEGE",1,0,1999,144,71,73,46,25,21,0.296,0.319,0.342,9960,11.263682,46,101,0.701388888888889
"5773",175421,"BELHAVEN COLLEGE",1,0,2000,182,95,87,50,19,31,0.326,0.275,0.218,10450,17.068076,47,137,0.752747252747253
"5774",175421,"BELHAVEN COLLEGE",1,0,2001,224,122,102,50,22,28,0.23,0.223,0.216,10990,19.105713,48,160,0.714285714285714
"5775",175421,"BELHAVEN COLLEGE",1,0,2002,266,150,116,68,19,49,0.327,0.256,0.164,11580,20.283821,51,187,0.703007518796993
"5776",175421,"BELHAVEN COLLEGE",1,0,2003,170,96,74,53,15,38,0.396,0.312,0.203,12200,26.766951,56,127,0.747058823529412
"5777",175421,"BELHAVEN COLLEGE",1,0,2004,237,144,93,94,28,66,0.458,0.397,0.301,12800,24.642142,57,164,0.691983122362869
"5778",175421,"Belhaven College",1,0,2005,201,105,96,68,16,52,0.495,0.338,0.167,13450,28.270905,56,155,0.771144278606965
"5779",175421,"Belhaven College",1,0,2006,248,133,115,76,31,45,0.338,0.306,0.27,14124,31.071503,69,166,0.669354838709677
"5780",175421,"Belhaven College",1,0,2007,241,134,107,60,15,45,0.336,0.249,0.14,15580,33.238874,68,146,0.605809128630705
"5781",175421,"Belhaven College",1,0,2008,239,146,93,79,27,52,0.356,0.331,0.29,16360,35.950017,68,141,0.589958158995816
"5782",175421,"Belhaven University",1,0,2009,208,116,92,67,18,49,0.422,0.322,0.196,16780,37.932467,68,123,0.591346153846154
"5783",175421,"Belhaven University",1,0,2010,234,126,108,65,17,48,0.381,0.278,0.157,17700,41.232928,69,117,0.5
"5784",175616,"DELTA STATE UNIVERSITY",1,0,1991,445,283,162,111,33,78,0.276,0.249,0.204,2000,28.315348,176,341,0.766292134831461
"5785",175616,"DELTA STATE UNIVERSITY",1,0,1992,443,247,196,98,35,63,0.255,0.221,0.179,2194,29.933286,172,345,0.778781038374718
"5786",175616,"DELTA STATE UNIVERSITY",1,0,1993,450,255,195,81,28,53,0.208,0.18,0.144,2194,30.660298,175,360,0.8
"5787",175616,"DELTA STATE UNIVERSITY",1,0,1995,464,301,163,102,25,77,0.256,0.22,0.153,2294,37.937062,185,333,0.717672413793103
"5788",175616,"DELTA STATE UNIVERSITY",1,0,1996,449,278,171,94,27,67,0.241,0.209,0.158,2294,38.458842,191,306,0.681514476614699
"5789",175616,"DELTA STATE UNIVERSITY",1,0,1997,521,338,183,136,40,96,0.284,0.261,0.219,2354,39.444299,187,368,0.706333973128599
"5790",175616,"DELTA STATE UNIVERSITY",1,0,1998,427,265,162,100,23,77,0.291,0.234,0.142,2596,42.961917,184,298,0.697892271662763
"5791",175616,"DELTA STATE UNIVERSITY",1,0,1999,458,275,183,107,38,69,0.251,0.234,0.208,2054,46.139328,191,334,0.729257641921397
"5792",175616,"DELTA STATE UNIVERSITY",1,0,2000,461,273,188,111,24,87,0.319,0.241,0.128,2145,49.007237,187.5,331,0.718004338394794
"5793",175616,"DELTA STATE UNIVERSITY",1,0,2001,430,253,177,77,21,56,0.221,0.179,0.119,2549,49.461289,184,308,0.716279069767442
"5794",175616,"DELTA STATE UNIVERSITY",1,0,2002,336,200,136,58,13,45,0.225,0.173,0.096,2924,50.591007,166,236,0.702380952380952
"5795",175616,"DELTA STATE UNIVERSITY",1,0,2003,327,191,136,55,19,36,0.189,0.168,0.14,2924,56.527401,146,198,0.605504587155963
"5796",175616,"DELTA STATE UNIVERSITY",1,0,2004,381,211,170,76,24,52,0.246,0.199,0.141,3092,65.012765,167,258,0.677165354330709
"5797",175616,"Delta State University",1,0,2005,393,222,171,67,25,42,0.189,0.17,0.146,3272,67.265216,165,236,0.600508905852417
"5798",175616,"Delta State University",1,0,2006,468,288,180,85,33,52,0.181,0.182,0.183,3518,64.708655,163,294,0.628205128205128
"5799",175616,"Delta State University",1,0,2007,477,293,184,78,27,51,0.174,0.164,0.147,3708,60.450363,179,268,0.561844863731656
"5800",175616,"Delta State University",1,0,2008,384,227,157,58,19,39,0.172,0.151,0.121,3946,63.111379,192,221,0.575520833333333
"5801",175616,"Delta State University",1,0,2009,367,230,137,62,22,40,0.174,0.169,0.161,3946,61.203253,193,189,0.514986376021798
"5802",175616,"Delta State University",1,0,2010,370,208,162,61,25,36,0.173,0.165,0.154,4347,65.947181,186,219,0.591891891891892
"5803",175856,"JACKSON STATE UNIVERSITY",1,0,1991,1081,615,466,113,34,79,0.128,0.105,0.073,2028,65.635869,302,2,0.00185013876040703
"5804",175856,"JACKSON STATE UNIVERSITY",1,0,1992,906,477,429,89,21,68,0.143,0.098,0.049,2230,65.707997,314,4,0.00441501103752759
"5805",175856,"JACKSON STATE UNIVERSITY",1,0,1993,1105,596,509,124,35,89,0.149,0.112,0.069,2230,67.473915,328,3,0.00271493212669683
"5806",175856,"JACKSON STATE UNIVERSITY",1,0,1995,1212,679,533,162,39,123,0.181,0.134,0.073,2380,80.10917,325,2,0.00165016501650165
"5807",175856,"JACKSON STATE UNIVERSITY",1,0,1996,906,508,398,140,33,107,0.211,0.155,0.083,2380,85.385559,307,2,0.0022075055187638
"5808",175856,"JACKSON STATE UNIVERSITY",1,0,1997,808,463,345,124,28,96,0.207,0.153,0.081,2380,74.80498,315,5,0.00618811881188119
"5809",175856,"JACKSON STATE UNIVERSITY",1,0,1998,842,494,348,155,43,112,0.227,0.184,0.124,2688,79.310972,318,0,0
"5810",175856,"JACKSON STATE UNIVERSITY",1,0,1999,845,527,318,128,34,94,0.178,0.151,0.107,2688,84.797084,327,1,0.00118343195266272
"5811",175856,"JACKSON STATE UNIVERSITY",1,0,2000,936,547,389,134,40,94,0.172,0.143,0.103,2788,114.550474,335,2,0.00213675213675214
"5812",175856,"JACKSON STATE UNIVERSITY",1,0,2001,930,540,390,154,35,119,0.22,0.166,0.09,3206,125.766623,343,4,0.0043010752688172
"5813",175856,"JACKSON STATE UNIVERSITY",1,0,2002,1014,581,433,206,49,157,0.27,0.203,0.113,3462,135.582534,339,5,0.00493096646942801
"5814",175856,"JACKSON STATE UNIVERSITY",1,0,2003,883,470,413,141,43,98,0.209,0.16,0.104,3612,149.111637,356,2,0.00226500566251416
"5815",175856,"JACKSON STATE UNIVERSITY",1,0,2004,995,587,408,200,50,150,0.256,0.201,0.123,3842,166.182151,360,5,0.0050251256281407
"5816",175856,"Jackson State University",1,0,2005,1131,690,441,221,64,157,0.228,0.195,0.145,3964,172.60313,367,18,0.0159151193633952
"5817",175856,"Jackson State University",1,0,2006,889,513,376,191,57,134,0.261,0.215,0.152,4224,172.239711,354,19,0.0213723284589426
"5818",175856,"Jackson State University",1,0,2007,919,541,378,153,41,112,0.207,0.166,0.108,4432,180.268934,384,18,0.0195865070729053
"5819",175856,"Jackson State University",1,0,2008,938,547,391,177,48,129,0.236,0.189,0.123,4634,183.260873,344,15,0.0159914712153518
"5820",175856,"Jackson State University",1,0,2009,841,507,334,157,47,110,0.217,0.187,0.141,4634,182.170291,406,14,0.0166468489892985
"5821",175856,"Jackson State University",1,0,2010,879,489,390,169,52,117,0.239,0.192,0.133,5050,177.530816,380,33,0.037542662116041
"5822",175980,"MILLSAPS COLLEGE",1,0,1991,273,140,133,170,73,97,0.693,0.623,0.549,9710,20.185577,83,256,0.937728937728938
"5823",175980,"MILLSAPS COLLEGE",1,0,1992,274,143,131,167,75,92,0.643,0.609,0.573,10280,20.910779,83,252,0.91970802919708
"5824",175980,"MILLSAPS COLLEGE",1,0,1993,319,161,158,189,95,94,0.584,0.592,0.601,11236,43.836456,85,304,0.952978056426332
"5825",175980,"MILLSAPS COLLEGE",1,0,1995,261,128,133,180,74,106,0.828,0.69,0.556,12700,25.7173,89,237,0.908045977011494
"5826",175980,"MILLSAPS COLLEGE",1,0,1996,292,163,129,166,64,102,0.626,0.568,0.496,13088,28.403654,91,262,0.897260273972603
"5827",175980,"MILLSAPS COLLEGE",1,0,1997,299,159,140,188,84,104,0.654,0.629,0.6,13612,23.812546,92,263,0.879598662207358
"5828",175980,"MILLSAPS COLLEGE",1,0,1998,286,145,141,169,79,90,0.621,0.591,0.56,14424,24.295901,89,243,0.84965034965035
"5829",175980,"MILLSAPS COLLEGE",1,0,1999,284,158,126,177,67,110,0.696,0.623,0.532,14190,25.428521,89,244,0.859154929577465
"5830",175980,"MILLSAPS COLLEGE",1,0,2000,292,152,140,176,82,94,0.618,0.603,0.586,14900,28.042942,91,246,0.842465753424658
"5831",175980,"MILLSAPS COLLEGE",1,0,2001,324,178,146,208,80,128,0.719,0.642,0.548,15586,29.512767,93,273,0.842592592592593
"5832",175980,"MILLSAPS COLLEGE",1,0,2002,251,125,126,159,75,84,0.672,0.633,0.595,16364,28.747081,93,204,0.812749003984064
"5833",175980,"MILLSAPS COLLEGE",1,0,2003,259,141,118,152,63,89,0.631,0.587,0.534,17346,29.206057,93,218,0.841698841698842
"5834",175980,"MILLSAPS COLLEGE",1,0,2004,278,136,142,170,83,87,0.64,0.612,0.585,18386,29.394042,93,219,0.787769784172662
"5835",175980,"Millsaps College",1,0,2005,258,118,140,158,76,82,0.695,0.612,0.543,19490,30.709333,92,208,0.806201550387597
"5836",175980,"Millsaps College",1,0,2006,225,122,103,149,63,86,0.705,0.662,0.612,20660,31.936936,92,183,0.813333333333333
"5837",175980,"Millsaps College",1,0,2007,296,154,142,175,75,100,0.649,0.591,0.528,21900,32.784091,90,247,0.834459459459459
"5838",175980,"Millsaps College",1,0,2008,266,141,125,165,66,99,0.702,0.62,0.528,23214,35.689686,99,188,0.706766917293233
"5839",175980,"Millsaps College",1,0,2009,281,116,165,166,80,86,0.741,0.591,0.485,24608,40.420429,95,205,0.729537366548043
"5840",175980,"Millsaps College",1,0,2010,211,106,105,145,69,76,0.717,0.687,0.657,26084,36.533571,101,149,0.706161137440758
"5841",176017,"UNIVERSITY OF MISSISSIPPI MAIN CAMPUS",1,0,1991,1690,892,798,484,169,315,0.353,0.286,0.212,2221,124.213934,430,1537,0.909467455621302
"5842",176017,"UNIVERSITY OF MISSISSIPPI MAIN CAMPUS",1,0,1992,1610,810,800,460,175,285,0.352,0.286,0.219,2435,125.451542,424,1448,0.899378881987578
"5843",176017,"UNIVERSITY OF MISSISSIPPI MAIN CAMPUS",1,0,1993,1538,796,742,461,156,305,0.383,0.3,0.21,2456,137.846296,439,1386,0.901170351105332
"5844",176017,"UNIVERSITY OF MISSISSIPPI MAIN CAMPUS",1,0,1995,1526,825,701,490,180,310,0.376,0.321,0.257,2546,160.830035,440,1363,0.893184796854522
"5845",176017,"UNIVERSITY OF MISSISSIPPI MAIN CAMPUS",1,0,1996,1736,909,827,580,199,381,0.419,0.334,0.241,2631,164.935919,474,1512,0.870967741935484
"5846",176017,"UNIVERSITY OF MISSISSIPPI MAIN CAMPUS",1,0,1997,1770,948,822,578,209,369,0.389,0.327,0.254,2731,166.779311,456,1526,0.862146892655367
"5847",176017,"UNIVERSITY OF MISSISSIPPI MAIN CAMPUS",1,0,1998,1794,920,874,602,213,389,0.423,0.336,0.244,3053,172.368204,464,1577,0.879041248606466
"5848",176017,"UNIVERSITY OF MISSISSIPPI MAIN CAMPUS",1,0,1999,1810,944,866,621,218,403,0.427,0.343,0.252,3053,192.764788,485,1537,0.849171270718232
"5849",176017,"UNIVERSITY OF MISSISSIPPI MAIN CAMPUS",1,0,2000,1981,1019,962,655,248,407,0.399,0.331,0.258,3153,218.664205,498.5,1693,0.854618879353862
"5850",176017,"UNIVERSITY OF MISSISSIPPI MAIN CAMPUS",1,0,2001,2126,1110,1016,402,215,187,0.168,0.189,0.212,3626,245.879051,512,1788,0.84101599247413
"5851",176017,"UNIVERSITY OF MISSISSIPPI MAIN CAMPUS",1,0,2002,2230,1150,1080,724,271,453,0.394,0.325,0.251,3916,256.450111,575,1871,0.839013452914798
"5852",176017,"UNIVERSITY OF MISSISSIPPI MAIN CAMPUS",1,0,2003,2377,1297,1080,851,286,565,0.436,0.358,0.265,3916,266.725135,587,1991,0.83761043331931
"5853",176017,"UNIVERSITY OF MISSISSIPPI MAIN CAMPUS",1,0,2004,2248,1185,1063,761,292,469,0.396,0.339,0.275,4110,265.975736,591,1906,0.847864768683274
"5854",176017,"University of Mississippi Main Campus",1,0,2005,2131,1139,992,800,280,520,0.456,0.375,0.282,4320,280.357681,622,1823,0.855466916940404
"5855",176017,"University of Mississippi Main Campus",1,0,2006,2521,1320,1201,920,352,568,0.43,0.365,0.293,4602,303.00989,647,2061,0.817532725109084
"5856",176017,"University of Mississippi Main Campus",1,0,2007,2434,1293,1141,885,328,557,0.431,0.364,0.287,4932,327.579428,653,2002,0.822514379622021
"5857",176017,"University of Mississippi Main Campus",1,0,2008,2316,1272,1044,857,301,556,0.437,0.37,0.288,5106,350.271204,702,1846,0.79706390328152
"5858",176017,"University of Mississippi Main Campus",1,0,2009,2547,1358,1189,996,360,636,0.468,0.391,0.303,5106,358.86996,711,2012,0.789948959560267
"5859",176017,"University of Mississippi Main Campus",1,0,2010,3065,1580,1485,1135,440,695,0.44,0.37,0.296,5436,369.532048,723,2321,0.757259380097879
"5860",176035,"MISSISSIPPI UNIVERSITY FOR WOMEN",1,0,1991,339,282,57,99,10,89,0.316,0.292,0.175,2043,19.567777,104,273,0.805309734513274
"5861",176035,"MISSISSIPPI UNIVERSITY FOR WOMEN",1,0,1992,259,210,49,52,6,46,0.219,0.201,0.122,2239,21.161789,110,197,0.760617760617761
"5862",176035,"MISSISSIPPI UNIVERSITY FOR WOMEN",1,0,1993,272,229,43,68,5,63,0.275,0.25,0.116,2239,22.807919,112,190,0.698529411764706
"5863",176035,"MISSISSIPPI UNIVERSITY FOR WOMEN",1,0,1995,288,238,50,59,7,52,0.219,0.205,0.14,2244,27.642756,122,205,0.711805555555556
"5864",176035,"MISSISSIPPI UNIVERSITY FOR WOMEN",1,0,1996,291,248,43,58,2,56,0.226,0.199,0.047,2284,29.274869,118,214,0.735395189003436
"5865",176035,"MISSISSIPPI UNIVERSITY FOR WOMEN",1,0,1997,231,193,38,71,6,65,0.337,0.307,0.158,2284,30.807207,129,171,0.74025974025974
"5866",176035,"MISSISSIPPI UNIVERSITY FOR WOMEN",1,0,1998,210,180,30,47,4,43,0.239,0.224,0.133,2556,33.003905,129,150,0.714285714285714
"5867",176035,"MISSISSIPPI UNIVERSITY FOR WOMEN",1,0,1999,202,177,25,59,3,56,0.316,0.292,0.12,2556,34.682022,132,128,0.633663366336634
"5868",176035,"MISSISSIPPI UNIVERSITY FOR WOMEN",1,0,2000,205,190,15,57,0,57,0.3,0.278,0,2656,36.762493,133,132,0.64390243902439
"5869",176035,"MISSISSIPPI UNIVERSITY FOR WOMEN",1,0,2001,189,163,26,44,3,41,0.252,0.233,0.115,3054,35.441124,134,129,0.682539682539683
"5870",176035,"MISSISSIPPI UNIVERSITY FOR WOMEN",1,0,2002,250,223,27,61,2,59,0.265,0.244,0.074,3298,35.037231,129,162,0.648
"5871",176035,"MISSISSIPPI UNIVERSITY FOR WOMEN",1,0,2003,202,178,24,48,3,45,0.253,0.238,0.125,3298,52.332047,134,136,0.673267326732673
"5872",176035,"MISSISSIPPI UNIVERSITY FOR WOMEN",1,0,2004,242,207,35,55,1,54,0.261,0.227,0.029,3495,46.298044,135,161,0.665289256198347
"5873",176035,"Mississippi University for Women",1,0,2005,238,204,34,53,5,48,0.235,0.223,0.147,3690,47.138485,135,147,0.617647058823529
"5874",176035,"Mississippi University for Women",1,0,2006,256,243,13,53,3,50,0.206,0.207,0.231,3933,39.777932,131,145,0.56640625
"5875",176035,"Mississippi University for Women",1,0,2007,235,213,22,46,6,40,0.188,0.196,0.273,4209,41.019856,135,123,0.523404255319149
"5876",176035,"Mississippi University for Women",1,0,2008,252,212,40,54,7,47,0.222,0.214,0.175,4423,42.111697,135,121,0.48015873015873
"5877",176035,"Mississippi University for Women",1,0,2009,216,177,39,56,10,46,0.26,0.259,0.256,4423,42.186628,134,103,0.476851851851852
"5878",176035,"Mississippi University for Women",1,0,2010,199,154,45,50,7,43,0.279,0.251,0.156,4644,42.277972,130,105,0.527638190954774
"5879",176044,"MISSISSIPPI VALLEY STATE UNIVERSITY",1,0,1991,386,223,163,34,7,27,0.121,0.088,0.043,1952,21.924855,98,0,0
"5880",176044,"MISSISSIPPI VALLEY STATE UNIVERSITY",1,0,1992,563,290,273,64,26,38,0.131,0.114,0.095,2164,23.277246,95,6,0.0106571936056838
"5881",176044,"MISSISSIPPI VALLEY STATE UNIVERSITY",1,0,1993,478,256,222,57,19,38,0.148,0.119,0.086,2164,24.453843,106,1,0.00209205020920502
"5882",176044,"MISSISSIPPI VALLEY STATE UNIVERSITY",1,0,1995,448,244,204,87,23,64,0.262,0.194,0.113,2278,29.759189,111,2,0.00446428571428571
"5883",176044,"MISSISSIPPI VALLEY STATE UNIVERSITY",1,0,1996,367,170,197,59,26,33,0.194,0.161,0.132,2278,29.359757,118,2,0.00544959128065395
"5884",176044,"MISSISSIPPI VALLEY STATE UNIVERSITY",1,0,1997,343,198,145,73,23,50,0.252,0.213,0.159,2353,32.128355,118,2,0.00583090379008746
"5885",176044,"MISSISSIPPI VALLEY STATE UNIVERSITY",1,0,1998,321,182,139,68,16,52,0.286,0.212,0.115,2646,33.764934,110,4,0.0124610591900312
"5886",176044,"MISSISSIPPI VALLEY STATE UNIVERSITY",1,0,1999,248,138,110,48,18,30,0.217,0.194,0.164,2646,37.6253,107,1,0.00403225806451613
"5887",176044,"MISSISSIPPI VALLEY STATE UNIVERSITY",1,0,2000,297,173,124,41,13,28,0.162,0.138,0.105,2746,39.142015,112,3,0.0101010101010101
"5888",176044,"MISSISSIPPI VALLEY STATE UNIVERSITY",1,0,2001,258,158,100,42,9,33,0.209,0.163,0.09,3158,42.872384,117,3,0.0116279069767442
"5889",176044,"MISSISSIPPI VALLEY STATE UNIVERSITY",1,0,2002,269,129,140,37,14,23,0.178,0.138,0.1,3411,53.211569,105,9,0.033457249070632
"5890",176044,"MISSISSIPPI VALLEY STATE UNIVERSITY",1,0,2003,325,187,138,57,16,41,0.219,0.175,0.116,3411,50.900892,110,13,0.04
"5891",176044,"MISSISSIPPI VALLEY STATE UNIVERSITY",1,0,2004,372,184,188,51,15,36,0.196,0.137,0.08,3832,54.195516,115,8,0.021505376344086
"5892",176044,"Mississippi Valley State University",1,0,2005,398,197,201,43,13,30,0.152,0.108,0.065,4024,66.343744,117,18,0.0452261306532663
"5893",176044,"Mississippi Valley State University",1,0,2006,443,216,227,55,14,41,0.19,0.124,0.062,4247,69.201947,121,25,0.0564334085778781
"5894",176044,"Mississippi Valley State University",1,0,2007,485,256,229,51,15,36,0.141,0.105,0.066,4417,69.185027,136,15,0.0309278350515464
"5895",176044,"Mississippi Valley State University",1,0,2008,446,203,243,57,23,34,0.168,0.128,0.095,4574,71.966142,138,15,0.0336322869955157
"5896",176044,"Mississippi Valley State University",1,0,2009,413,222,191,43,13,30,0.135,0.104,0.068,4754,75.887539,133,18,0.0435835351089588
"5897",176044,"Mississippi Valley State University",1,0,2010,382,192,190,68,25,43,0.224,0.178,0.132,4781,64.507937,126,12,0.031413612565445
"5898",176080,"MISSISSIPPI STATE UNIVERSITY",1,0,1991,1569,715,854,320,134,186,0.26,0.204,0.157,2223,227.143668,761,1291,0.822817080943276
"5899",176080,"MISSISSIPPI STATE UNIVERSITY",1,0,1992,1672,760,912,316,130,186,0.245,0.189,0.143,2474,228.007504,666,1338,0.800239234449761
"5900",176080,"MISSISSIPPI STATE UNIVERSITY",1,0,1993,1633,777,856,330,118,212,0.273,0.202,0.138,2474,239.631266,669,1286,0.787507654623393
"5901",176080,"MISSISSIPPI STATE UNIVERSITY",1,0,1995,1826,845,981,382,158,224,0.265,0.209,0.161,2591,286.100399,779,1430,0.783132530120482
"5902",176080,"MISSISSIPPI STATE UNIVERSITY",1,0,1996,1864,869,995,463,175,288,0.331,0.248,0.176,2631,294.606909,828,1506,0.80793991416309
"5903",176080,"MISSISSIPPI STATE UNIVERSITY",1,0,1997,2016,965,1051,462,162,300,0.311,0.229,0.154,2731,305.094967,822,1578,0.782738095238095
"5904",176080,"MISSISSIPPI STATE UNIVERSITY",1,0,1998,1929,944,985,501,178,323,0.342,0.26,0.181,3017,330.742031,851,1450,0.751684810782789
"5905",176080,"MISSISSIPPI STATE UNIVERSITY",1,0,1999,2033,1003,1030,507,177,330,0.329,0.249,0.172,3017,371.044103,892,1511,0.743236596163306
"5906",176080,"MISSISSIPPI STATE UNIVERSITY",1,0,2000,2055,1057,998,556,204,352,0.333,0.271,0.204,3117,401.464503,887.5,1540,0.749391727493917
"5907",176080,"MISSISSIPPI STATE UNIVERSITY",1,0,2001,1826,909,917,483,201,282,0.31,0.265,0.219,3586,419.155207,883,1444,0.790799561883899
"5908",176080,"MISSISSIPPI STATE UNIVERSITY",1,0,2002,1737,833,904,476,181,295,0.354,0.274,0.2,3874,420.38698,1011,1373,0.790443293033967
"5909",176080,"MISSISSIPPI STATE UNIVERSITY",1,0,2003,1659,822,837,509,185,324,0.394,0.307,0.221,3874,427.376219,1043,1303,0.78541289933695
"5910",176080,"MISSISSIPPI STATE UNIVERSITY",1,0,2004,1735,829,906,492,193,299,0.361,0.284,0.213,4106,443.665291,1044,1291,0.744092219020173
"5911",176080,"Mississippi State University",1,0,2005,1951,1010,941,585,215,370,0.366,0.3,0.228,4312,466.374203,819,1408,0.721681189133778
"5912",176080,"Mississippi State University",1,0,2006,1897,947,950,575,233,342,0.361,0.303,0.245,4596,483.177559,826,1396,0.735898787559304
"5913",176080,"Mississippi State University",1,0,2007,2262,1105,1157,699,274,425,0.385,0.309,0.237,4978,534.084801,824,1662,0.73474801061008
"5914",176080,"Mississippi State University",1,0,2008,2474,1278,1196,746,282,464,0.363,0.302,0.236,5151,567.049288,854,1811,0.732012934518998
"5915",176080,"Mississippi State University",1,0,2009,2447,1210,1237,755,282,473,0.391,0.309,0.228,5151,582.747476,897,1778,0.726604004903964
"5916",176080,"Mississippi State University",1,0,2010,2688,1308,1380,847,348,499,0.382,0.315,0.252,5461,591.408843,850,1857,0.690848214285714
"5917",176406,"TOUGALOO COLLEGE",1,0,1991,317,205,112,61,16,45,0.22,0.192,0.143,4395,10.644152,64,0,0
"5918",176406,"TOUGALOO COLLEGE",1,0,1992,325,215,110,69,15,54,0.251,0.212,0.136,4835,12.487696,53,0,0
"5919",176406,"TOUGALOO COLLEGE",1,0,1993,311,223,88,79,17,62,0.278,0.254,0.193,4795,13.750635,66,0,0
"5920",176406,"TOUGALOO COLLEGE",1,0,1995,218,141,77,65,19,46,0.326,0.298,0.247,5440,15.680808,64,0,0
"5921",176406,"TOUGALOO COLLEGE",1,0,1996,211,144,67,68,11,57,0.396,0.322,0.164,5712,15.332647,68,0,0
"5922",176406,"TOUGALOO COLLEGE",1,0,1997,206,146,60,66,11,55,0.377,0.32,0.183,6160,14.150432,67,0,0
"5923",176406,"TOUGALOO COLLEGE",1,0,1998,198,142,56,66,12,54,0.38,0.333,0.214,6610,14.510749,59,0,0
"5924",176406,"TOUGALOO COLLEGE",1,0,1999,252,196,56,73,11,62,0.316,0.29,0.196,6400,15.624381,58,0,0
"5925",176406,"TOUGALOO COLLEGE",1,0,2000,224,168,56,66,15,51,0.304,0.295,0.268,6600,17.030791,61,0,0
"5926",176406,"TOUGALOO COLLEGE",1,0,2001,201,137,64,58,13,45,0.328,0.289,0.203,6900,19.435873,64,0,0
"5927",176406,"TOUGALOO COLLEGE",1,0,2002,209,149,60,55,12,43,0.289,0.263,0.2,7245,22.670265,63,0,0
"5928",176406,"TOUGALOO COLLEGE",1,0,2003,221,166,55,53,9,44,0.265,0.24,0.164,7750,23.655489,64,1,0.00452488687782805
"5929",176406,"TOUGALOO COLLEGE",1,0,2004,278,190,88,68,16,52,0.274,0.245,0.182,8140,24.744207,71,0,0
"5930",176406,"Tougaloo College",1,0,2005,207,146,61,61,15,46,0.315,0.295,0.246,8800,24.922215,80,0,0
"5931",176406,"Tougaloo College",1,0,2006,243,172,71,74,15,59,0.343,0.305,0.211,8800,30.715743,74,1,0.00411522633744856
"5932",176406,"Tougaloo College",1,0,2007,200,135,65,53,9,44,0.326,0.265,0.138,9240,27.308935,74,0,0
"5933",176406,"Tougaloo College",1,0,2008,237,158,79,68,19,49,0.31,0.287,0.241,9240,22.039203,76,1,0.00421940928270042
"5934",176406,"Tougaloo College",1,0,2009,231,154,77,57,12,45,0.292,0.247,0.156,9240,24.604868,76,4,0.0173160173160173
"5935",176406,"Tougaloo College",1,0,2010,198,126,72,50,10,40,0.318,0.253,0.139,9240,22.617005,76,4,0.0202020202020202
"5936",176628,"AVILA COLLEGE",1,0,1991,88,53,35,27,8,19,0.359,0.307,0.229,7380,7.806649,59,73,0.829545454545455
"5937",176628,"AVILA COLLEGE",1,0,1992,91,50,41,21,10,11,0.22,0.231,0.244,7980,8.49764,50,83,0.912087912087912
"5938",176628,"AVILA COLLEGE",1,0,1993,84,57,27,25,3,22,0.386,0.298,0.111,8490,9.252563,52,74,0.880952380952381
"5939",176628,"AVILA COLLEGE",1,0,1995,101,61,40,31,11,20,0.328,0.307,0.275,9600,10.770135,55,78,0.772277227722772
"5940",176628,"AVILA COLLEGE",1,0,1996,91,56,35,20,5,15,0.268,0.22,0.143,10100,11.966248,55,83,0.912087912087912
"5941",176628,"AVILA COLLEGE",1,0,1997,96,57,39,29,6,23,0.404,0.302,0.154,10700,12.051153,54,68,0.708333333333333
"5942",176628,"AVILA COLLEGE",1,0,1998,113,64,49,39,9,30,0.469,0.345,0.184,11410,12.763725,54,95,0.84070796460177
"5943",176628,"AVILA COLLEGE",1,0,1999,113,81,32,45,7,38,0.469,0.398,0.219,11800,13.883114,56,91,0.805309734513274
"5944",176628,"AVILA COLLEGE",1,0,2000,162,91,71,36,5,31,0.341,0.222,0.07,12500,15.843829,57.5,127,0.783950617283951
"5945",176628,"AVILA COLLEGE",1,0,2001,155,62,93,32,7,25,0.403,0.206,0.075,13150,16.783686,59,119,0.767741935483871
"5946",176628,"AVILA UNIVERSITY",1,0,2002,129,70,59,29,5,24,0.343,0.225,0.085,13900,18.820939,62,94,0.728682170542636
"5947",176628,"AVILA UNIVERSITY",1,0,2003,152,93,59,36,5,31,0.333,0.237,0.085,14700,16.596704,63,111,0.730263157894737
"5948",176628,"AVILA UNIVERSITY",1,0,2004,129,88,41,39,3,36,0.409,0.302,0.073,15500,17.772888,63,104,0.806201550387597
"5949",176628,"Avila University",1,0,2005,154,95,59,38,11,27,0.284,0.247,0.186,16300,18.251429,64,111,0.720779220779221
"5950",176628,"Avila University",1,0,2006,138,78,60,34,11,23,0.295,0.246,0.183,17300,19.239054,69,107,0.77536231884058
"5951",176628,"Avila University",1,0,2007,114,79,35,30,5,25,0.316,0.263,0.143,18300,19.985781,72,96,0.842105263157895
"5952",176628,"Avila University",1,0,2008,183,105,78,45,9,36,0.343,0.246,0.115,19500,21.15874,64,156,0.852459016393443
"5953",176628,"Avila University",1,0,2009,118,79,39,36,9,27,0.342,0.305,0.231,20250,22.954078,65,93,0.788135593220339
"5954",176628,"Avila University",1,0,2010,166,94,72,46,11,35,0.372,0.277,0.153,21050,22.889901,63,111,0.668674698795181
"5955",176947,"CENTRAL METHODIST COLLEGE",1,0,1991,240,109,131,52,22,30,0.275,0.217,0.168,6710,10.50416,60,210,0.875
"5956",176947,"CENTRAL METHODIST COLLEGE",1,0,1992,209,79,130,42,20,22,0.278,0.201,0.154,7050,10.888047,53,178,0.851674641148325
"5957",176947,"CENTRAL METHODIST COLLEGE",1,0,1993,238,108,130,62,21,41,0.38,0.261,0.162,7780,11.900811,56,207,0.869747899159664
"5958",176947,"CENTRAL METHODIST COLLEGE",1,0,1995,229,95,134,73,36,37,0.39,0.319,0.269,9160,13.235308,53,196,0.85589519650655
"5959",176947,"CENTRAL METHODIST COLLEGE",1,0,1996,212,82,130,48,19,29,0.354,0.226,0.146,9570,13.945466,55,189,0.891509433962264
"5960",176947,"CENTRAL METHODIST COLLEGE",1,0,1997,233,115,118,72,25,47,0.409,0.309,0.212,10220,10.332493,55,193,0.828326180257511
"5961",176947,"CENTRAL METHODIST COLLEGE",1,0,1998,218,111,107,59,19,40,0.36,0.271,0.178,10620,11.134571,60,183,0.839449541284404
"5962",176947,"CENTRAL METHODIST COLLEGE",1,0,1999,228,108,120,62,25,37,0.343,0.272,0.208,10860,10.179421,60,205,0.899122807017544
"5963",176947,"CENTRAL METHODIST COLLEGE",1,0,2000,216,102,114,68,17,51,0.5,0.315,0.149,11390,12.416124,61.5,174,0.805555555555556
"5964",176947,"CENTRAL METHODIST COLLEGE",1,0,2001,240,116,124,67,23,44,0.379,0.279,0.185,11950,13.578959,63,208,0.866666666666667
"5965",176947,"CENTRAL METHODIST COLLEGE",1,0,2002,232,100,132,61,16,45,0.45,0.263,0.121,12420,13.666994,53,196,0.844827586206897
"5966",176947,"CENTRAL METHODIST COLLEGE",1,0,2003,223,93,130,64,25,39,0.419,0.287,0.192,13160,14.627296,52,183,0.820627802690583
"5967",176947,"CENTRAL METHODIST UNIV-COLL OF LIBERAL ARTS & SCIENCES",1,0,2004,193,86,107,64,21,43,0.5,0.332,0.196,13800,14.152312,54,168,0.870466321243523
"5968",176947,"Central Methodist University-College of Liberal Arts & Sciences",1,0,2005,223,96,127,73,29,44,0.458,0.327,0.228,14490,14.470584,51,198,0.887892376681614
"5969",176947,"Central Methodist University-College of Liberal Arts & Sciences",1,0,2006,207,111,96,81,28,53,0.478,0.391,0.292,15500,15.729449,57,190,0.917874396135266
"5970",176947,"Central Methodist University-College of Liberal Arts & Sciences",1,0,2007,270,123,147,69,31,38,0.309,0.256,0.211,16430,16.860972,55,228,0.844444444444444
"5971",176947,"Central Methodist University-College of Liberal Arts & Sciences",1,0,2008,300,141,159,110,47,63,0.447,0.367,0.296,17250,17.921025,59,254,0.846666666666667
"5972",176947,"Central Methodist University-College of Liberal Arts & Sciences",1,0,2009,260,129,131,106,42,64,0.496,0.408,0.321,17940,20.162093,59,221,0.85
"5973",176947,"Central Methodist University-College of Liberal Arts & Sciences",1,0,2010,314,147,167,109,33,76,0.517,0.347,0.198,18660,21.446582,60,266,0.847133757961783
"5974",176965,"CENTRAL MISSOURI STATE UNIVERSITY",1,0,1991,1952,1038,914,273,107,166,0.16,0.14,0.117,1860,91.332903,447,1691,0.866290983606557
"5975",176965,"CENTRAL MISSOURI STATE UNIVERSITY",1,0,1992,1763,921,842,240,105,135,0.147,0.136,0.125,2040,92.277853,444,1564,0.88712422007941
"5976",176965,"CENTRAL MISSOURI STATE UNIVERSITY",1,0,1993,1433,757,676,213,72,141,0.186,0.149,0.107,2160,97.087651,454,1232,0.85973482205164
"5977",176965,"CENTRAL MISSOURI STATE UNIVERSITY",1,0,1995,1428,755,673,243,79,164,0.217,0.17,0.117,2460,99.180631,455,1259,0.881652661064426
"5978",176965,"CENTRAL MISSOURI STATE UNIVERSITY",1,0,1996,1252,655,597,221,77,144,0.22,0.177,0.129,2520,107.811935,433,1138,0.908945686900958
"5979",176965,"CENTRAL MISSOURI STATE UNIVERSITY",1,0,1997,1323,718,605,298,88,210,0.292,0.225,0.145,2640,107.249098,432,1195,0.903250188964475
"5980",176965,"CENTRAL MISSOURI STATE UNIVERSITY",1,0,1998,1408,730,678,317,107,210,0.288,0.225,0.158,2730,117.273505,425,1250,0.887784090909091
"5981",176965,"CENTRAL MISSOURI STATE UNIVERSITY",1,0,1999,1329,725,604,300,94,206,0.284,0.226,0.156,2970,123.551092,446,1191,0.896162528216704
"5982",176965,"CENTRAL MISSOURI STATE UNIVERSITY",1,0,2000,1455,794,661,380,146,234,0.295,0.261,0.221,3210,126.653488,441.5,1274,0.875601374570447
"5983",176965,"CENTRAL MISSOURI STATE UNIVERSITY",1,0,2001,1437,789,648,275,33,242,0.307,0.191,0.051,3450,135.395398,437,1191,0.828810020876827
"5984",176965,"CENTRAL MISSOURI STATE UNIVERSITY",1,0,2002,1248,668,580,306,106,200,0.299,0.245,0.183,3240,127.522797,425,1041,0.834134615384615
"5985",176965,"CENTRAL MISSOURI STATE UNIVERSITY",1,0,2003,1355,737,618,323,115,208,0.282,0.238,0.186,3696,123.351662,428,1098,0.810332103321033
"5986",176965,"CENTRAL MISSOURI STATE UNIVERSITY",1,0,2004,1434,798,636,369,120,249,0.312,0.257,0.189,3936,127.349812,430,1232,0.859135285913529
"5987",176965,"Central Missouri State University",1,0,2005,1484,810,674,410,164,246,0.304,0.276,0.243,4104,144.586582,448,1245,0.838948787061995
"5988",176965,"University of Central Missouri",1,0,2006,1505,871,634,416,134,282,0.324,0.276,0.211,5415,144.641174,457,1188,0.78936877076412
"5989",176965,"University of Central Missouri",1,0,2007,1426,786,640,428,148,280,0.356,0.3,0.231,4500,150.311208,453,1166,0.817671809256662
"5990",176965,"University of Central Missouri",1,0,2008,1583,854,729,463,185,278,0.325,0.292,0.254,4687,156.274442,456,1290,0.814908401768793
"5991",176965,"University of Central Missouri",1,0,2009,1478,822,656,452,148,304,0.37,0.306,0.226,5859,158.657083,460,1197,0.809878213802436
"5992",176965,"University of Central Missouri",1,0,2010,1546,862,684,496,176,320,0.371,0.321,0.257,5859,161.048459,459,1179,0.76261319534282
"5993",177418,"FONTBONNE COLLEGE",1,0,1991,114,87,27,38,9,29,0.333,0.333,0.333,7390,6.909627,43,93,0.815789473684211
"5994",177418,"FONTBONNE COLLEGE",1,0,1992,144,110,34,56,5,51,0.464,0.389,0.147,7750,7.744583,44,118,0.819444444444444
"5995",177418,"FONTBONNE COLLEGE",1,0,1993,126,95,31,50,7,43,0.453,0.397,0.226,8140,9.533992,42,102,0.80952380952381
"5996",177418,"FONTBONNE COLLEGE",1,0,1995,143,110,33,51,11,40,0.364,0.357,0.333,8890,10.702188,40,120,0.839160839160839
"5997",177418,"FONTBONNE COLLEGE",1,0,1996,146,104,42,66,13,53,0.51,0.452,0.31,9660,11.508253,43,131,0.897260273972603
"5998",177418,"FONTBONNE COLLEGE",1,0,1997,171,124,47,50,10,40,0.323,0.292,0.213,10000,11.73589,45,143,0.83625730994152
"5999",177418,"FONTBONNE COLLEGE",1,0,1998,156,111,45,59,11,48,0.432,0.378,0.244,10810,12.756346,46,129,0.826923076923077
"6000",177418,"FONTBONNE COLLEGE",1,0,1999,144,94,50,60,14,46,0.489,0.417,0.28,11184,14.919941,48,115,0.798611111111111
"6001",177418,"FONTBONNE COLLEGE",1,0,2000,164,124,40,57,4,53,0.427,0.348,0.1,11686,15.872982,53.5,129,0.786585365853659
"6002",177418,"FONTBONNE UNIVERSITY",1,0,2001,153,111,42,50,12,38,0.342,0.327,0.286,12596,17.064389,59,129,0.843137254901961
"6003",177418,"FONTBONNE UNIVERSITY",1,0,2002,183,134,49,76,16,60,0.448,0.415,0.327,13414,21.707807,55,157,0.85792349726776
"6004",177418,"FONTBONNE UNIVERSITY",1,0,2003,194,143,51,61,14,47,0.329,0.314,0.275,14200,23.289494,59,152,0.783505154639175
"6005",177418,"FONTBONNE UNIVERSITY",1,0,2004,190,132,58,52,16,36,0.273,0.274,0.276,15100,24.715951,59,141,0.742105263157895
"6006",177418,"Fontbonne University",1,0,2005,187,136,51,44,9,35,0.257,0.235,0.176,16000,27.656099,66,141,0.754010695187166
"6007",177418,"Fontbonne University",1,0,2006,187,98,89,30,11,19,0.194,0.16,0.124,17120,30.347366,65,140,0.748663101604278
"6008",177418,"Fontbonne University",1,0,2007,193,110,83,5,1,4,0.036,0.026,0.012,18000,32.929373,73,143,0.740932642487047
"6009",177418,"Fontbonne University",1,0,2008,187,112,75,44,12,32,0.286,0.235,0.16,19000,35.669114,82,130,0.695187165775401
"6010",177418,"Fontbonne University",1,0,2009,173,104,69,65,19,46,0.442,0.376,0.275,19475,38.560141,75,127,0.734104046242775
"6011",177418,"Fontbonne University",1,0,2010,151,77,74,53,21,32,0.416,0.351,0.284,20060,35.820237,82,119,0.788079470198676
"6012",178059,"MARYVILLE UNIVERSITY OF SAINT LOUIS",1,0,1991,102,61,41,63,22,41,0.672,0.618,0.537,7800,16.664831,78,94,0.92156862745098
"6013",178059,"MARYVILLE UNIVERSITY OF SAINT LOUIS",1,0,1992,129,93,36,70,19,51,0.548,0.543,0.528,8200,19.733891,81,121,0.937984496124031
"6014",178059,"MARYVILLE UNIVERSITY OF SAINT LOUIS",1,0,1993,165,109,56,73,20,53,0.486,0.442,0.357,8700,20.147305,78,149,0.903030303030303
"6015",178059,"MARYVILLE UNIVERSITY OF SAINT LOUIS",1,0,1995,167,123,44,77,16,61,0.496,0.461,0.364,9800,22.87999,80,144,0.862275449101796
"6016",178059,"MARYVILLE UNIVERSITY OF SAINT LOUIS",1,0,1996,185,127,58,100,28,72,0.567,0.541,0.483,10280,24.022652,85,169,0.913513513513514
"6017",178059,"MARYVILLE UNIVERSITY OF SAINT LOUIS",1,0,1997,223,173,50,114,26,88,0.509,0.511,0.52,10850,21.649188,87,199,0.89237668161435
"6018",178059,"MARYVILLE UNIVERSITY OF SAINT LOUIS",1,0,1998,225,158,67,100,26,74,0.468,0.444,0.388,11600,22.58019,86,214,0.951111111111111
"6019",178059,"MARYVILLE UNIVERSITY OF SAINT LOUIS",1,0,1999,198,133,65,101,26,75,0.564,0.51,0.4,12160,26.083695,91,164,0.828282828282828
"6020",178059,"MARYVILLE UNIVERSITY OF SAINT LOUIS",1,0,2000,231,186,45,122,18,104,0.559,0.528,0.4,12880,27.230718,86.5,206,0.891774891774892
"6021",178059,"MARYVILLE UNIVERSITY OF SAINT LOUIS",1,0,2001,247,183,64,141,31,110,0.601,0.571,0.484,13650,29.841536,82,206,0.834008097165992
"6022",178059,"MARYVILLE UNIVERSITY OF SAINT LOUIS",1,0,2002,279,194,85,132,46,86,0.443,0.473,0.541,14400,29.651812,83,233,0.835125448028674
"6023",178059,"MARYVILLE UNIVERSITY OF SAINT LOUIS",1,0,2003,318,236,82,163,39,124,0.525,0.513,0.476,15200,31.817352,85,286,0.89937106918239
"6024",178059,"MARYVILLE UNIVERSITY OF SAINT LOUIS",1,0,2004,313,248,65,160,29,131,0.528,0.511,0.446,16000,34.787103,93,266,0.849840255591054
"6025",178059,"Maryville University of Saint Louis",1,0,2005,322,232,90,182,42,140,0.603,0.565,0.467,17000,37.496079,95,296,0.919254658385093
"6026",178059,"Maryville University of Saint Louis",1,0,2006,290,237,53,152,26,126,0.532,0.524,0.491,17800,39.586581,101,261,0.9
"6027",178059,"Maryville University of Saint Louis",1,0,2007,294,211,83,149,43,106,0.502,0.507,0.518,18600,43.748658,107,257,0.874149659863946
"6028",178059,"Maryville University of Saint Louis",1,0,2008,318,236,82,149,39,110,0.466,0.469,0.476,19650,45.152529,110,283,0.889937106918239
"6029",178059,"Maryville University of Saint Louis",1,0,2009,340,233,107,190,57,133,0.571,0.559,0.533,20384,46.670811,107,278,0.817647058823529
"6030",178059,"Maryville University of Saint Louis",1,0,2010,338,242,96,192,49,143,0.591,0.568,0.51,21100,49.713711,113,271,0.801775147928994
"6031",178341,"MISSOURI SOUTHERN STATE COLLEGE",1,0,1991,758,397,361,71,24,47,0.118,0.094,0.066,1272,25.918638,198,729,0.961741424802111
"6032",178341,"MISSOURI SOUTHERN STATE COLLEGE",1,0,1992,702,381,321,63,24,39,0.102,0.09,0.075,1598,26.431545,189,655,0.933048433048433
"6033",178341,"MISSOURI SOUTHERN STATE COLLEGE",1,0,1993,701,362,339,51,16,35,0.097,0.073,0.047,2018,28.416787,187,665,0.948644793152639
"6034",178341,"MISSOURI SOUTHERN STATE COLLEGE",1,0,1995,720,359,361,77,37,40,0.111,0.107,0.102,2205,29.752573,190,672,0.933333333333333
"6035",178341,"MISSOURI SOUTHERN STATE COLLEGE",1,0,1996,685,373,312,77,25,52,0.139,0.112,0.08,2310,34.047345,196,644,0.94014598540146
"6036",178341,"MISSOURI SOUTHERN STATE COLLEGE",1,0,1997,675,368,307,61,19,42,0.114,0.09,0.062,2376,34.746438,205,632,0.936296296296296
"6037",178341,"MISSOURI SOUTHERN STATE COLLEGE",1,0,1998,857,469,388,95,30,65,0.139,0.111,0.077,2471,38.249381,202,794,0.926487747957993
"6038",178341,"MISSOURI SOUTHERN STATE COLLEGE",1,0,1999,804,434,370,104,40,64,0.148,0.129,0.108,2265,41.870527,204,738,0.917910447761194
"6039",178341,"MISSOURI SOUTHERN STATE COLLEGE",1,0,2000,771,427,344,129,50,79,0.185,0.167,0.145,2370,44.299716,204,713,0.924773022049287
"6040",178341,"MISSOURI SOUTHERN STATE COLLEGE",1,0,2001,786,411,375,117,47,70,0.17,0.149,0.125,2700,47.658124,204,686,0.872773536895674
"6041",178341,"MISSOURI SOUTHERN STATE COLLEGE",1,0,2002,614,334,280,78,27,51,0.153,0.127,0.096,3720,43.955908,202,544,0.885993485342019
"6042",178341,"MISSOURI SOUTHERN STATE UNIVERSITY",1,0,2003,568,319,249,76,25,51,0.16,0.134,0.1,3810,46.285086,198,511,0.899647887323944
"6043",178341,"MISSOURI SOUTHERN STATE UNIVERSITY",1,0,2004,695,368,327,97,33,64,0.174,0.14,0.101,3810,46.756754,200,626,0.900719424460432
"6044",178341,"Missouri Southern State University",1,0,2005,836,466,370,106,32,74,0.159,0.127,0.086,3750,49.637878,203,709,0.848086124401914
"6045",178341,"Missouri Southern State University",1,0,2006,851,484,367,106,40,66,0.136,0.125,0.109,3900,53.887061,208,715,0.840188014101058
"6046",178341,"Missouri Southern State University",1,0,2007,766,416,350,110,29,81,0.195,0.144,0.083,4050,59.180412,211,656,0.856396866840731
"6047",178341,"Missouri Southern State University",1,0,2008,727,398,329,106,34,72,0.181,0.146,0.103,4290,61.362912,215,621,0.854195323246217
"6048",178341,"Missouri Southern State University",1,0,2009,811,395,416,119,53,66,0.167,0.147,0.127,4290,55.899518,208,669,0.824907521578298
"6049",178341,"Missouri Southern State University",1,0,2010,844,439,405,88,35,53,0.121,0.104,0.086,4290,60.285521,207,687,0.813981042654028
"6050",178387,"MISSOURI WESTERN STATE COLLEGE",1,0,1991,806,435,371,71,27,44,0.101,0.088,0.073,1648,24.730695,160,699,0.867245657568238
"6051",178387,"MISSOURI WESTERN STATE COLLEGE",1,0,1992,794,445,349,85,22,63,0.142,0.107,0.063,1822,26.111429,162,696,0.876574307304786
"6052",178387,"MISSOURI WESTERN STATE COLLEGE",1,0,1993,928,514,414,86,30,56,0.109,0.093,0.072,1930,28.917039,161,784,0.844827586206897
"6053",178387,"MISSOURI WESTERN STATE COLLEGE",1,0,1995,923,530,393,92,24,68,0.128,0.1,0.061,2258,31.52932,165,801,0.867822318526544
"6054",178387,"MISSOURI WESTERN STATE COLLEGE",1,0,1996,963,564,399,113,28,85,0.151,0.117,0.07,2414,33.921534,176,836,0.868120456905504
"6055",178387,"MISSOURI WESTERN STATE COLLEGE",1,0,1997,985,572,413,135,42,93,0.163,0.137,0.102,2534,37.867187,181,846,0.858883248730964
"6056",178387,"MISSOURI WESTERN STATE COLLEGE",1,0,1998,983,577,406,127,27,100,0.173,0.129,0.067,2660,40.580774,185,827,0.841302136317396
"6057",178387,"MISSOURI WESTERN STATE COLLEGE",1,0,1999,980,575,405,113,35,78,0.136,0.115,0.086,2622,44.799531,188,832,0.848979591836735
"6058",178387,"MISSOURI WESTERN STATE COLLEGE",1,0,2000,908,532,376,91,20,71,0.134,0.1,0.053,2754,47.070129,188,740,0.814977973568282
"6059",178387,"MISSOURI WESTERN STATE COLLEGE",1,0,2001,1079,666,413,140,44,96,0.144,0.13,0.107,2928,49.35054,188,903,0.836886005560704
"6060",178387,"MISSOURI WESTERN STATE COLLEGE",1,0,2002,1131,655,476,134,52,82,0.125,0.118,0.109,3768,46.282386,184,907,0.801945181255526
"6061",178387,"MISSOURI WESTERN STATE COLLEGE",1,0,2003,994,572,422,111,27,84,0.147,0.112,0.064,4098,44.311719,180,783,0.787726358148893
"6062",178387,"MISSOURI WESTERN STATE COLLEGE",1,0,2004,1021,573,448,109,26,83,0.145,0.107,0.058,4380,44.486042,179,801,0.784524975514202
"6063",178387,"Missouri Western State University",1,0,2005,1005,557,448,111,42,69,0.124,0.11,0.094,4380,47.762841,179,758,0.754228855721393
"6064",178387,"Missouri Western State University",1,0,2006,936,516,420,102,39,63,0.122,0.109,0.093,4650,51.334924,178,723,0.772435897435897
"6065",178387,"Missouri Western State University",1,0,2007,935,538,397,126,36,90,0.167,0.135,0.091,4800,52.18681,184,699,0.747593582887701
"6066",178387,"Missouri Western State University",1,0,2008,956,536,420,146,44,102,0.19,0.153,0.105,3994,54.492906,187,766,0.801255230125523
"6067",178387,"Missouri Western State University",1,0,2009,1004,572,432,127,35,92,0.161,0.126,0.081,3994,58.709902,192,793,0.789840637450199
"6068",178387,"Missouri Western State University",1,0,2010,1083,559,524,145,55,90,0.161,0.134,0.105,3994,59.160959,195,841,0.776546629732225
"6069",178396,"UNIVERSITY OF MISSOURI-COLUMBIA",1,0,1991,3368,1820,1548,959,356,603,0.331,0.285,0.23,2432,561.938061,899,2906,0.862826603325416
"6070",178396,"UNIVERSITY OF MISSOURI-COLUMBIA",1,0,1992,2904,1600,1304,828,305,523,0.327,0.285,0.234,2812,594.756333,883,2493,0.858471074380165
"6071",178396,"UNIVERSITY OF MISSOURI-COLUMBIA",1,0,1993,2898,1511,1387,828,320,508,0.336,0.286,0.231,3125,638.392836,899,2499,0.86231884057971
"6072",178396,"UNIVERSITY OF MISSOURI-COLUMBIA",1,0,1995,3782,2099,1683,1210,420,790,0.376,0.32,0.25,3771,741.631902,879,3232,0.854574299312533
"6073",178396,"UNIVERSITY OF MISSOURI-COLUMBIA",1,0,1996,3687,2046,1641,1282,462,820,0.401,0.348,0.282,4121,787.209426,910,3153,0.855166802278275
"6074",178396,"UNIVERSITY OF MISSOURI-COLUMBIA",1,0,1997,3512,1935,1577,1290,461,829,0.428,0.367,0.292,4280,820.647145,913,2952,0.840546697038724
"6075",178396,"UNIVERSITY OF MISSOURI-COLUMBIA",1,0,1998,3785,2077,1708,1425,500,925,0.445,0.376,0.293,4439,853.072658,899,3251,0.85891677675033
"6076",178396,"UNIVERSITY OF MISSOURI-COLUMBIA",1,0,1999,3871,2138,1733,1468,525,943,0.441,0.379,0.303,3978,883.038999,930,3350,0.865409454921209
"6077",178396,"UNIVERSITY OF MISSOURI-COLUMBIA",1,0,2000,4170,2247,1923,1657,609,1048,0.466,0.397,0.317,4104,996.6778,968,3598,0.862829736211031
"6078",178396,"UNIVERSITY OF MISSOURI-COLUMBIA",1,0,2001,4112,2175,1937,1686,643,1043,0.48,0.41,0.332,4245,1083.580372,1006,3577,0.869892996108949
"6079",178396,"UNIVERSITY OF MISSOURI-COLUMBIA",1,0,2002,4379,2284,2095,1813,669,1144,0.501,0.414,0.319,4602,1073.08736,1219,3763,0.859328613838776
"6080",178396,"UNIVERSITY OF MISSOURI-COLUMBIA",1,0,2003,4605,2443,2162,1985,737,1248,0.511,0.431,0.341,5838,1137.707886,1093,3951,0.857980456026059
"6081",178396,"UNIVERSITY OF MISSOURI-COLUMBIA",1,0,2004,4625,2442,2183,1993,765,1228,0.503,0.431,0.35,6276,1183.806953,1544,3957,0.855567567567568
"6082",178396,"University of Missouri-Columbia",1,0,2005,4662,2513,2149,2087,810,1277,0.508,0.448,0.377,6062,1357.803723,1242,3954,0.848133848133848
"6083",178396,"University of Missouri-Columbia",1,0,2006,4783,2562,2221,2234,835,1399,0.546,0.467,0.376,6364,1437.990316,1276,3953,0.826468743466444
"6084",178396,"University of Missouri-Columbia",1,0,2007,4897,2672,2225,2305,829,1476,0.552,0.471,0.373,7077,1513.270999,1292,4143,0.846028180518685
"6085",178396,"University of Missouri-Columbia",1,0,2008,5698,3031,2667,2622,1004,1618,0.534,0.46,0.376,7368,1607.479553,1295,4740,0.831870831870832
"6086",178396,"University of Missouri-Columbia",1,0,2009,5492,2958,2534,2527,907,1620,0.548,0.46,0.358,7368,1641.980498,1284,4491,0.817734887108521
"6087",178396,"University of Missouri-Columbia",1,0,2010,5996,3175,2821,2641,963,1678,0.528,0.44,0.341,7368,1678.184727,1329,4904,0.817878585723816
"6088",178402,"UNIVERSITY OF MISSOURI-KANSAS CITY",1,0,1991,494,270,224,55,26,29,0.107,0.111,0.116,2457,125.329762,454,345,0.698380566801619
"6089",178402,"UNIVERSITY OF MISSOURI-KANSAS CITY",1,0,1992,480,257,223,42,13,29,0.113,0.088,0.058,2841,132.473878,421,335,0.697916666666667
"6090",178402,"UNIVERSITY OF MISSOURI-KANSAS CITY",1,0,1993,515,266,249,53,18,35,0.132,0.103,0.072,3154,138.675318,434,353,0.685436893203883
"6091",178402,"UNIVERSITY OF MISSOURI-KANSAS CITY",1,0,1995,568,318,250,70,25,45,0.142,0.123,0.1,3799,151.880681,457,387,0.681338028169014
"6092",178402,"UNIVERSITY OF MISSOURI-KANSAS CITY",1,0,1996,567,299,268,86,33,53,0.177,0.152,0.123,4121,173.00539,460,389,0.686067019400353
"6093",178402,"UNIVERSITY OF MISSOURI-KANSAS CITY",1,0,1997,588,321,267,79,27,52,0.162,0.134,0.101,4273,185.698934,468,433,0.736394557823129
"6094",178402,"UNIVERSITY OF MISSOURI-KANSAS CITY",1,0,1998,618,336,282,114,39,75,0.223,0.184,0.138,4421,195.75608,469,418,0.676375404530744
"6095",178402,"UNIVERSITY OF MISSOURI-KANSAS CITY",1,0,1999,639,356,283,105,46,59,0.166,0.164,0.163,3978,207.48399,484,458,0.716744913928013
"6096",178402,"UNIVERSITY OF MISSOURI-KANSAS CITY",1,0,2000,688,391,297,120,44,76,0.194,0.174,0.148,4104,220.033678,504,453,0.658430232558139
"6097",178402,"UNIVERSITY OF MISSOURI-KANSAS CITY",1,0,2001,734,444,290,106,36,70,0.158,0.144,0.124,4245,231.693949,524,501,0.682561307901907
"6098",178402,"UNIVERSITY OF MISSOURI-KANSAS CITY",1,0,2002,747,454,293,128,41,87,0.192,0.171,0.14,4602,218.131001,593,481,0.643908969210174
"6099",178402,"UNIVERSITY OF MISSOURI-KANSAS CITY",1,0,2003,758,455,303,124,38,86,0.189,0.164,0.125,5838,250.788022,562,435,0.573878627968338
"6100",178402,"UNIVERSITY OF MISSOURI-KANSAS CITY",1,0,2004,904,540,364,160,50,110,0.204,0.177,0.137,6276,260.595452,608,539,0.596238938053097
"6101",178402,"University of Missouri-Kansas City",1,0,2005,1007,574,433,173,61,112,0.195,0.172,0.141,6495,275.657824,662,611,0.606752730883813
"6102",178402,"University of Missouri-Kansas City",1,0,2006,928,545,383,220,86,134,0.246,0.237,0.225,6819,287.614753,669,539,0.580818965517241
"6103",178402,"University of Missouri-Kansas City",1,0,2007,916,568,348,188,59,129,0.227,0.205,0.17,7077,288.775407,696,505,0.551310043668122
"6104",178402,"University of Missouri-Kansas City",1,0,2008,971,589,382,218,68,150,0.255,0.225,0.178,7368,305.487912,706,570,0.5870236869207
"6105",178402,"University of Missouri-Kansas City",1,0,2009,979,610,369,224,62,162,0.266,0.229,0.168,7368,319.769108,716,559,0.570990806945863
"6106",178402,"University of Missouri-Kansas City",1,0,2010,1109,673,436,246,92,154,0.229,0.222,0.211,7368,331.875611,721,640,0.577096483318305
"6107",178411,"UNIVERSITY OF MISSOURI-ROLLA",1,0,1991,711,135,576,58,43,15,0.111,0.082,0.075,2543,70.273207,282,630,0.886075949367089
"6108",178411,"UNIVERSITY OF MISSOURI-ROLLA",1,0,1992,809,174,635,64,40,24,0.138,0.079,0.063,2932,72.133675,256,704,0.870210135970334
"6109",178411,"UNIVERSITY OF MISSOURI-ROLLA",1,0,1993,786,190,596,78,58,20,0.105,0.099,0.097,3254,82.582543,253,707,0.899491094147583
"6110",178411,"UNIVERSITY OF MISSOURI-ROLLA",1,0,1995,804,190,614,121,75,46,0.242,0.15,0.122,3899,89.86291,263,704,0.875621890547264
"6111",178411,"UNIVERSITY OF MISSOURI-ROLLA",1,0,1996,777,179,598,121,77,44,0.246,0.156,0.129,4213,96.963938,272,684,0.88030888030888
"6112",178411,"UNIVERSITY OF MISSOURI-ROLLA",1,0,1997,692,168,524,99,76,23,0.137,0.143,0.145,4373,101.063257,267,631,0.911849710982659
"6113",178411,"UNIVERSITY OF MISSOURI-ROLLA",1,0,1998,717,151,566,106,81,25,0.166,0.148,0.143,4522,105.399336,276,641,0.894002789400279
"6114",178411,"UNIVERSITY OF MISSOURI-ROLLA",1,0,1999,679,140,539,112,77,35,0.25,0.165,0.143,3978,110.098689,272,588,0.865979381443299
"6115",178411,"UNIVERSITY OF MISSOURI-ROLLA",1,0,2000,672,146,526,143,98,45,0.308,0.213,0.186,4104,113.618519,271.5,583,0.867559523809524
"6116",178411,"UNIVERSITY OF MISSOURI-ROLLA",1,0,2001,691,126,565,144,109,35,0.278,0.208,0.193,4245,119.521426,271,586,0.848046309696093
"6117",178411,"UNIVERSITY OF MISSOURI-ROLLA",1,0,2002,785,150,635,175,128,47,0.313,0.223,0.202,4602,109.077808,305,690,0.878980891719745
"6118",178411,"UNIVERSITY OF MISSOURI-ROLLA",1,0,2003,870,181,689,217,154,63,0.348,0.249,0.224,5838,116.808518,296,752,0.864367816091954
"6119",178411,"UNIVERSITY OF MISSOURI-ROLLA",1,0,2004,836,169,667,211,162,49,0.29,0.252,0.243,6276,126.317731,318,721,0.86244019138756
"6120",178411,"University of Missouri-Rolla",1,0,2005,877,168,709,224,154,70,0.417,0.255,0.217,6495,135.55577,314,772,0.880273660205245
"6121",178411,"University of Missouri-Rolla",1,0,2006,929,216,713,258,176,82,0.38,0.278,0.247,6819,144.912767,323,802,0.863293864370291
"6122",178411,"Missouri University of Science and Technology",1,0,2007,1018,208,810,257,180,77,0.37,0.252,0.222,7077,140.733961,330,885,0.869351669941061
"6123",178411,"Missouri University of Science and Technology",1,0,2008,1036,234,802,253,181,72,0.308,0.244,0.226,7368,154.944998,343,872,0.841698841698842
"6124",178411,"Missouri University of Science and Technology",1,0,2009,1099,260,839,263,180,83,0.319,0.239,0.215,7368,155.962145,333,904,0.822565969062784
"6125",178411,"Missouri University of Science and Technology",1,0,2010,1138,250,888,246,166,80,0.32,0.216,0.187,7368,160.634162,329,970,0.852372583479789
"6126",178420,"UNIVERSITY OF MISSOURI-SAINT LOUIS",1,0,1991,637,341,296,72,28,44,0.129,0.113,0.095,2379,77.270186,327,513,0.805337519623234
"6127",178420,"UNIVERSITY OF MISSOURI-SAINT LOUIS",1,0,1992,474,224,250,49,18,31,0.138,0.103,0.072,2740,78.000872,299,388,0.818565400843882
"6128",178420,"UNIVERSITY OF MISSOURI-ST LOUIS",1,0,1993,458,231,227,52,17,35,0.152,0.114,0.075,3073,81.158641,304,361,0.7882096069869
"6129",178420,"UNIVERSITY OF MISSOURI-ST LOUIS",1,0,1995,552,315,237,85,31,54,0.171,0.154,0.131,3761,101.876381,332,436,0.789855072463768
"6130",178420,"UNIVERSITY OF MISSOURI-ST LOUIS",1,0,1996,632,351,281,78,20,58,0.165,0.123,0.071,4145,111.864341,345,484,0.765822784810127
"6131",178420,"UNIVERSITY OF MISSOURI-ST LOUIS",1,0,1997,458,242,216,60,12,48,0.198,0.131,0.056,4323,116.942727,348,378,0.825327510917031
"6132",178420,"UNIVERSITY OF MISSOURI-ST LOUIS",1,0,1998,528,274,254,114,46,68,0.248,0.216,0.181,4636,128.03058,330,443,0.839015151515151
"6133",178420,"UNIVERSITY OF MISSOURI-ST LOUIS",1,0,1999,539,274,265,122,43,79,0.288,0.226,0.162,3978,135.699443,330,415,0.769944341372913
"6134",178420,"UNIVERSITY OF MISSOURI-ST LOUIS",1,0,2000,497,279,218,100,35,65,0.233,0.201,0.161,4104,146.900396,329,388,0.780684104627767
"6135",178420,"UNIVERSITY OF MISSOURI-ST LOUIS",1,0,2001,515,313,202,96,25,71,0.227,0.186,0.124,4245,155.503124,328,376,0.730097087378641
"6136",178420,"UNIVERSITY OF MISSOURI-ST LOUIS",1,0,2002,426,234,192,96,29,67,0.286,0.225,0.151,4602,153.381894,415,324,0.76056338028169
"6137",178420,"UNIVERSITY OF MISSOURI-ST LOUIS",1,0,2003,464,280,184,97,26,71,0.254,0.209,0.141,5838,149.677106,414,356,0.767241379310345
"6138",178420,"UNIVERSITY OF MISSOURI-ST LOUIS",1,0,2004,398,235,163,82,25,57,0.243,0.206,0.153,6276,164.827885,442,283,0.71105527638191
"6139",178420,"University of Missouri-St Louis",1,0,2005,497,288,209,124,41,83,0.288,0.249,0.196,5196,173.602203,462,337,0.678068410462777
"6140",178420,"University of Missouri-St Louis",1,0,2006,476,273,203,106,33,73,0.267,0.223,0.163,6819,183.633869,497,297,0.623949579831933
"6141",178420,"University of Missouri-St Louis",1,0,2007,462,280,182,94,25,69,0.246,0.203,0.137,7077,192.582838,501,270,0.584415584415584
"6142",178420,"University of Missouri-St Louis",1,0,2008,437,244,193,92,34,58,0.238,0.211,0.176,7368,203.620957,504,279,0.638443935926774
"6143",178420,"University of Missouri-St Louis",1,0,2009,494,295,199,109,34,75,0.254,0.221,0.171,7368,203.59809,494,266,0.538461538461538
"6144",178420,"University of Missouri-St Louis",1,0,2010,479,282,197,141,51,90,0.319,0.294,0.259,7368,200.632476,493,298,0.622129436325679
"6145",178615,"NORTHEAST MISSOURI STATE UNIVERSITY",1,0,1991,1375,784,591,459,153,306,0.39,0.334,0.259,1800,50.047944,337,1262,0.917818181818182
"6146",178615,"NORTHEAST MISSOURI STATE UNIVERSITY",1,0,1992,1384,786,598,539,167,372,0.473,0.389,0.279,2235,52.327113,337,1238,0.894508670520231
"6147",178615,"NORTHEAST MISSOURI STATE UNIVERSITY",1,0,1993,1614,962,652,597,178,419,0.436,0.37,0.273,2456,56.611946,328,1451,0.899008674101611
"6148",178615,"TRUMAN STATE UNIVERSITY",1,0,1995,1498,883,615,577,183,394,0.446,0.385,0.298,2872,64.820118,349,1021,0.681575433911882
"6149",178615,"TRUMAN STATE UNIVERSITY",1,0,1996,1480,868,612,592,185,407,0.469,0.4,0.302,3008,69.483811,347,1124,0.759459459459459
"6150",178615,"TRUMAN STATE UNIVERSITY",1,0,1997,1654,1020,634,593,175,418,0.41,0.359,0.276,3256,75.01615,356,1461,0.883313180169287
"6151",178615,"TRUMAN STATE UNIVERSITY",1,0,1998,1482,914,568,562,181,381,0.417,0.379,0.319,3408,88.683639,357,1304,0.879892037786775
"6152",178615,"TRUMAN STATE UNIVERSITY",1,0,1999,1446,884,562,594,201,393,0.445,0.411,0.358,3544,85.908302,363,1245,0.860995850622407
"6153",178615,"TRUMAN STATE UNIVERSITY",1,0,2000,1396,840,556,537,181,356,0.424,0.385,0.326,3680,89.670827,366.5,1222,0.875358166189112
"6154",178615,"TRUMAN STATE UNIVERSITY",1,0,2001,1456,865,591,666,232,434,0.502,0.457,0.393,3800,92.019951,370,1249,0.85782967032967
"6155",178615,"TRUMAN STATE UNIVERSITY",1,0,2002,1441,872,569,654,227,427,0.49,0.454,0.399,4144,84.360164,366,1242,0.861901457321305
"6156",178615,"TRUMAN STATE UNIVERSITY",1,0,2003,1310,787,523,612,198,414,0.526,0.467,0.379,4700,79.215678,354,1113,0.849618320610687
"6157",178615,"TRUMAN STATE UNIVERSITY",1,0,2004,1477,872,605,631,228,403,0.462,0.427,0.377,5410,80.147429,347,1310,0.886932972241029
"6158",178615,"Truman State University",1,0,2005,1441,830,611,626,232,394,0.475,0.434,0.38,5740,84.72657,353,1232,0.854961832061069
"6159",178615,"Truman State University",1,0,2006,1365,826,539,781,258,523,0.633,0.572,0.479,5970,89.301579,339,1111,0.813919413919414
"6160",178615,"Truman State University",1,0,2007,1402,814,588,754,248,506,0.622,0.538,0.422,6210,88.830078,344,1146,0.817403708987161
"6161",178615,"Truman State University",1,0,2008,1334,779,555,757,251,506,0.65,0.567,0.452,6458,95.367415,357,1074,0.805097451274363
"6162",178615,"Truman State University",1,0,2009,1337,776,561,739,263,476,0.613,0.553,0.469,6458,98.137455,345,1006,0.75243081525804
"6163",178615,"Truman State University",1,0,2010,1416,881,535,800,260,540,0.613,0.565,0.486,6458,94.607524,338,1184,0.836158192090395
"6164",179043,"ROCKHURST COLLEGE",1,0,1991,228,142,86,121,44,77,0.542,0.531,0.512,8200,19.772302,83,167,0.732456140350877
"6165",179043,"ROCKHURST COLLEGE",1,0,1992,198,121,77,92,30,62,0.512,0.465,0.39,8830,19.675633,96,156,0.787878787878788
"6166",179043,"ROCKHURST COLLEGE",1,0,1993,345,194,151,169,74,95,0.49,0.49,0.49,9090,21.008036,99,295,0.855072463768116
"6167",179043,"ROCKHURST COLLEGE",1,0,1995,288,161,127,174,74,100,0.621,0.604,0.583,10440,26.259141,105,255,0.885416666666667
"6168",179043,"ROCKHURST COLLEGE",1,0,1996,362,196,166,9,3,6,0.031,0.025,0.018,11270,29.579649,107,302,0.834254143646409
"6169",179043,"ROCKHURST COLLEGE",1,0,1997,319,175,144,181,78,103,0.589,0.567,0.542,11850,33.547313,108,268,0.84012539184953
"6170",179043,"ROCKHURST COLLEGE",1,0,1998,280,153,127,141,50,91,0.595,0.504,0.394,12240,34.857028,107,241,0.860714285714286
"6171",179043,"ROCKHURST UNIVERSITY",1,0,1999,303,177,126,152,61,91,0.514,0.502,0.484,12500,36.098379,114,250,0.825082508250825
"6172",179043,"ROCKHURST UNIVERSITY",1,0,2000,267,141,126,135,61,74,0.525,0.506,0.484,13500,31.221249,125.5,216,0.808988764044944
"6173",179043,"ROCKHURST UNIVERSITY",1,0,2001,298,150,148,165,76,89,0.593,0.554,0.514,14800,61.919929,137,246,0.825503355704698
"6174",179043,"ROCKHURST UNIVERSITY",1,0,2002,214,133,81,119,44,75,0.564,0.556,0.543,15980,99.534135,126,179,0.836448598130841
"6175",179043,"ROCKHURST UNIVERSITY",1,0,2003,244,130,114,141,60,81,0.623,0.578,0.526,16950,135.941196,121,209,0.85655737704918
"6176",179043,"ROCKHURST UNIVERSITY",1,0,2004,305,176,129,184,76,108,0.614,0.603,0.589,17950,135.624051,125,267,0.875409836065574
"6177",179043,"Rockhurst University",1,0,2005,370,203,167,237,110,127,0.626,0.641,0.659,18900,150.649651,125,312,0.843243243243243
"6178",179043,"Rockhurst University",1,0,2006,396,260,136,237,73,164,0.631,0.598,0.537,20200,154.11923,129,345,0.871212121212121
"6179",179043,"Rockhurst University",1,0,2007,367,230,137,222,81,141,0.613,0.605,0.591,22000,141.635584,118,298,0.811989100817439
"6180",179043,"Rockhurst University",1,0,2008,358,237,121,223,69,154,0.65,0.623,0.57,23760,129.332095,124,270,0.754189944134078
"6181",179043,"Rockhurst University",1,0,2009,417,263,154,251,84,167,0.635,0.602,0.545,24950,112.819543,127,331,0.793764988009592
"6182",179043,"Rockhurst University",1,0,2010,370,232,138,228,79,149,0.642,0.616,0.572,26450,87.040991,129,291,0.786486486486486
"6183",179159,"SAINT LOUIS UNIVERSITY MAIN CAMPUS",1,0,1991,914,479,435,355,121,234,0.489,0.388,0.278,9160,385.859209,360,720,0.787746170678337
"6184",179159,"SAINT LOUIS UNIVERSITY MAIN CAMPUS",1,0,1992,1051,546,505,473,187,286,0.524,0.45,0.37,9880,436.077344,375,823,0.783063748810657
"6185",179159,"SAINT LOUIS UNIVERSITY-MAIN CAMPUS",1,0,1993,1066,578,488,500,188,312,0.54,0.469,0.385,10820,467.77191,394,850,0.797373358348968
"6186",179159,"SAINT LOUIS UNIVERSITY-MAIN CAMPUS",1,0,1995,1055,604,451,501,195,306,0.507,0.475,0.432,12800,528.878881,436,817,0.774407582938389
"6187",179159,"SAINT LOUIS UNIVERSITY-MAIN CAMPUS",1,0,1996,1047,609,438,577,202,375,0.616,0.551,0.461,13900,483.495043,454,803,0.766953199617956
"6188",179159,"SAINT LOUIS UNIVERSITY-MAIN CAMPUS",1,0,1997,1084,609,475,601,246,355,0.583,0.554,0.518,14940,509.244147,511,802,0.739852398523985
"6189",179159,"SAINT LOUIS UNIVERSITY-MAIN CAMPUS",1,0,1998,1239,694,545,684,251,433,0.624,0.552,0.461,16100,494.836809,530,962,0.776432606941082
"6190",179159,"SAINT LOUIS UNIVERSITY-MAIN CAMPUS",1,0,1999,1252,695,557,764,314,450,0.647,0.61,0.564,17230,390.56619,547,974,0.777955271565495
"6191",179159,"SAINT LOUIS UNIVERSITY-MAIN CAMPUS",1,0,2000,1405,748,657,886,397,489,0.654,0.631,0.604,18400,410.74239,559.5,1163,0.827758007117438
"6192",179159,"SAINT LOUIS UNIVERSITY-MAIN CAMPUS",1,0,2001,1329,695,634,827,374,453,0.652,0.622,0.59,19670,429.00106,572,1047,0.787810383747178
"6193",179159,"SAINT LOUIS UNIVERSITY-MAIN CAMPUS",1,0,2002,1409,762,647,867,366,501,0.657,0.615,0.566,20840,442.915023,591,1131,0.802696948190206
"6194",179159,"SAINT LOUIS UNIVERSITY-MAIN CAMPUS",1,0,2003,1377,752,625,832,338,494,0.657,0.604,0.541,22050,471.084885,629,1124,0.816267247639797
"6195",179159,"SAINT LOUIS UNIVERSITY-MAIN CAMPUS",1,0,2004,1456,864,592,892,336,556,0.643,0.613,0.568,23360,509.573132,620,1132,0.777472527472527
"6196",179159,"Saint Louis University-Main Campus",1,0,2005,1521,859,662,925,377,548,0.638,0.608,0.569,24760,517.205481,616,1180,0.775805391190007
"6197",179159,"Saint Louis University-Main Campus",1,0,2006,1567,940,627,946,358,588,0.625,0.604,0.571,26250,546.394297,615,1218,0.777281429483089
"6198",179159,"Saint Louis University-Main Campus",1,0,2007,1629,933,696,988,380,608,0.652,0.607,0.546,28480,555.219646,614,1234,0.757519950890117
"6199",179159,"Saint Louis University-Main Campus",1,0,2008,1624,923,701,945,365,580,0.628,0.582,0.521,30330,591.622887,672,1138,0.700738916256158
"6200",179159,"Saint Louis University-Main Campus",1,0,2009,1714,966,748,1026,393,633,0.655,0.599,0.525,30940,607.623525,639,1183,0.690198366394399
"6201",179159,"Saint Louis University-Main Campus",1,0,2010,1724,1004,720,1063,381,682,0.679,0.617,0.529,32180,626.870988,707,1184,0.68677494199536
"6202",179557,"SOUTHEAST MISSOURI STATE UNIVERSITY",1,0,1991,1487,815,672,222,70,152,0.186,0.149,0.104,1716,66.227474,367,1319,0.887020847343645
"6203",179557,"SOUTHEAST MISSOURI STATE UNIVERSITY",1,0,1992,1405,806,599,236,67,169,0.21,0.168,0.112,2113,68.136035,389,1259,0.896085409252669
"6204",179557,"SOUTHEAST MISSOURI STATE UNIVERSITY",1,0,1993,1229,733,496,226,58,168,0.229,0.184,0.117,2434,71.8051,363,1119,0.910496338486574
"6205",179557,"SOUTHEAST MISSOURI STATE UNIVERSITY",1,0,1995,1385,824,561,334,90,244,0.296,0.241,0.16,2760,77.230371,376,1283,0.926353790613718
"6206",179557,"SOUTHEAST MISSOURI STATE UNIVERSITY",1,0,1996,1212,681,531,294,82,212,0.311,0.243,0.154,2874,84.157447,376,1117,0.921617161716172
"6207",179557,"SOUTHEAST MISSOURI STATE UNIVERSITY",1,0,1997,1124,713,411,248,65,183,0.257,0.221,0.158,3000,90.163836,378,1041,0.926156583629893
"6208",179557,"SOUTHEAST MISSOURI STATE UNIVERSITY",1,0,1998,1239,757,482,300,75,225,0.297,0.242,0.156,3105,92.561044,380,1132,0.9136400322841
"6209",179557,"SOUTHEAST MISSOURI STATE UNIVERSITY",1,0,1999,1391,816,575,320,87,233,0.286,0.23,0.151,2979,100.32825,369,1273,0.915168943206326
"6210",179557,"SOUTHEAST MISSOURI STATE UNIVERSITY",1,0,2000,1433,817,616,372,103,269,0.329,0.26,0.167,3099,109.579841,383.5,1244,0.868108862526169
"6211",179557,"SOUTHEAST MISSOURI STATE UNIVERSITY",1,0,2001,1502,910,592,356,98,258,0.284,0.237,0.166,3234,116.546998,398,1328,0.884154460719041
"6212",179557,"SOUTHEAST MISSOURI STATE UNIVERSITY",1,0,2002,1457,858,599,361,105,256,0.298,0.248,0.175,3744,106.107538,404,1276,0.875772134522992
"6213",179557,"SOUTHEAST MISSOURI STATE UNIVERSITY",1,0,2003,1410,826,584,336,98,238,0.288,0.238,0.168,4254,110.410401,405,1215,0.861702127659574
"6214",179557,"SOUTHEAST MISSOURI STATE UNIVERSITY",1,0,2004,1386,823,563,334,98,236,0.287,0.241,0.174,4554,116.167813,406,1194,0.861471861471861
"6215",179557,"Southeast Missouri State University",1,0,2005,1538,918,620,369,102,267,0.291,0.24,0.165,4764,124.153655,387,1267,0.823797139141743
"6216",179557,"Southeast Missouri State University",1,0,2006,1383,853,530,318,92,226,0.265,0.23,0.174,5034,131.633857,396,1087,0.785972523499638
"6217",179557,"Southeast Missouri State University",1,0,2007,1650,946,704,438,158,280,0.296,0.265,0.224,5304,136.396299,401,1263,0.765454545454545
"6218",179557,"Southeast Missouri State University",1,0,2008,1672,1054,618,492,141,351,0.333,0.294,0.228,5544,147.23058,421,1423,0.851076555023923
"6219",179557,"Southeast Missouri State University",1,0,2009,1640,943,697,455,165,290,0.308,0.277,0.237,5544,153.991018,419,1392,0.848780487804878
"6220",179557,"Southeast Missouri State University",1,0,2010,1813,1097,716,526,165,361,0.329,0.29,0.23,5544,159.237011,411,1482,0.817429674572532
"6221",179566,"SOUTHWEST MISSOURI STATE UNIVERSITY",1,0,1991,2895,1571,1324,676,241,435,0.277,0.234,0.182,1594,110.898181,648,2658,0.918134715025907
"6222",179566,"SOUTHWEST MISSOURI STATE UNIVERSITY",1,0,1992,2925,1621,1304,420,110,310,0.191,0.144,0.084,1752,113.88271,642,2636,0.901196581196581
"6223",179566,"SOUTHWEST MISSOURI STATE UNIVERSITY",1,0,1993,2800,1493,1307,376,109,267,0.179,0.134,0.083,1904,122.522961,671,2577,0.920357142857143
"6224",179566,"SOUTHWEST MISSOURI STATE UNIVERSITY",1,0,1995,2479,1394,1085,440,156,284,0.204,0.177,0.144,2758,129.705096,646,2297,0.926583299717628
"6225",179566,"SOUTHWEST MISSOURI STATE UNIVERSITY",1,0,1996,2447,1404,1043,433,127,306,0.218,0.177,0.122,2888,138.450647,661,2160,0.88271352676747
"6226",179566,"SOUTHWEST MISSOURI STATE UNIVERSITY",1,0,1997,2704,1543,1161,522,180,342,0.222,0.193,0.155,3060,153.879549,673,2436,0.900887573964497
"6227",179566,"SOUTHWEST MISSOURI STATE UNIVERSITY",1,0,1998,2739,1545,1194,607,192,415,0.269,0.222,0.161,3214,160.073147,694,2446,0.893026652062797
"6228",179566,"SOUTHWEST MISSOURI STATE UNIVERSITY",1,0,1999,2581,1439,1142,605,223,382,0.266,0.234,0.195,3030,168.088843,706,2310,0.89500193723363
"6229",179566,"SOUTHWEST MISSOURI STATE UNIVERSITY",1,0,2000,2496,1477,1019,613,204,409,0.277,0.246,0.2,3180,179.800914,674,2243,0.89863782051282
"6230",179566,"SOUTHWEST MISSOURI STATE UNIVERSITY",1,0,2001,2508,1417,1091,672,213,459,0.324,0.268,0.195,3330,188.246019,642,2278,0.90829346092504
"6231",179566,"SOUTHWEST MISSOURI STATE UNIVERSITY",1,0,2002,2702,1609,1093,720,205,515,0.32,0.266,0.188,3840,190.812943,731,2474,0.915618060695781
"6232",179566,"SOUTHWEST MISSOURI STATE UNIVERSITY",1,0,2003,2645,1495,1150,1044,382,662,0.443,0.395,0.332,4140,188.380406,725,2297,0.868431001890359
"6233",179566,"SOUTHWEST MISSOURI STATE UNIVERSITY",1,0,2004,2663,1572,1091,755,234,521,0.331,0.284,0.214,4620,190.48531,726,2357,0.885092001502065
"6234",179566,"Missouri State University",1,0,2005,2575,1490,1085,822,273,549,0.368,0.319,0.252,4920,200.801081,728,2281,0.885825242718447
"6235",179566,"Missouri State University",1,0,2006,2732,1622,1110,854,306,548,0.338,0.313,0.276,5190,207.80739,716,2420,0.885797950219619
"6236",179566,"Missouri State University",1,0,2007,2610,1514,1096,796,263,533,0.352,0.305,0.24,5370,224.294407,698,2268,0.868965517241379
"6237",179566,"Missouri State University",1,0,2008,2532,1464,1068,785,258,527,0.36,0.31,0.242,5580,241.169867,724,2236,0.883096366508689
"6238",179566,"Missouri State University",1,0,2009,2625,1542,1083,768,225,543,0.352,0.293,0.208,5580,260.87541,721,2222,0.84647619047619
"6239",179566,"Missouri State University-Springfield",1,0,2010,2645,1574,1071,796,266,530,0.337,0.301,0.248,5580,269.904078,685,2256,0.852930056710775
"6240",179867,"WASHINGTON UNIVERSITY",1,0,1991,1131,544,587,863,417,446,0.82,0.763,0.71,16110,620.500232,610,834,0.737400530503979
"6241",179867,"WASHINGTON UNIVERSITY",1,0,1992,1070,513,557,831,421,410,0.799,0.777,0.756,16918,682.980057,605,779,0.72803738317757
"6242",179867,"WASHINGTON UNIVERSITY",1,0,1993,1229,569,660,930,460,470,0.826,0.757,0.697,17776,755.309145,620,937,0.762408462164361
"6243",179867,"WASHINGTON UNIVERSITY",1,0,1995,1180,608,572,911,411,500,0.822,0.772,0.719,19291,854.983785,642,820,0.694915254237288
"6244",179867,"WASHINGTON UNIVERSITY",1,0,1996,1275,642,633,1006,463,543,0.846,0.789,0.731,20200,925.644815,645,836,0.655686274509804
"6245",179867,"WASHINGTON UNIVERSITY",1,0,1997,1230,646,584,976,424,552,0.855,0.793,0.726,21210,826.991,666,778,0.632520325203252
"6246",179867,"WASHINGTON UNIVERSITY",1,0,1998,1465,770,695,1221,570,651,0.846,0.833,0.82,22422,865.54,589,1011,0.690102389078498
"6247",179867,"WASHINGTON UNIVERSITY",1,0,1999,1369,684,685,1125,548,577,0.844,0.822,0.8,23400,949.79,548,893,0.652300949598247
"6248",179867,"WASHINGTON UNIVERSITY",1,0,2000,1392,761,631,1158,498,660,0.867,0.832,0.789,24500,1023.75,554,926,0.665229885057471
"6249",179867,"WASHINGTON UNIVERSITY IN ST LOUIS",1,0,2001,1262,637,625,1049,494,555,0.871,0.831,0.79,25700,1155.101,560,832,0.659270998415214
"6250",179867,"WASHINGTON UNIVERSITY IN ST LOUIS",1,0,2002,1329,699,630,1127,513,614,0.878,0.848,0.814,26900,1236.304,582,883,0.664409330323552
"6251",179867,"WASHINGTON UNIVERSITY IN ST LOUIS",1,0,2003,1349,699,650,1138,517,621,0.888,0.844,0.795,28300,1354.222,572,880,0.652335063009637
"6252",179867,"WASHINGTON UNIVERSITY IN ST LOUIS",1,0,2004,1436,725,711,1233,592,641,0.884,0.859,0.833,29700,1418.897,698,868,0.604456824512535
"6253",179867,"Washington University in St Louis",1,0,2005,1372,715,657,1186,544,642,0.898,0.864,0.828,31100,1515.37,754,817,0.595481049562682
"6254",179867,"Washington University in St Louis",1,0,2006,1456,714,742,1284,628,656,0.919,0.882,0.846,32800,1625.531,773,881,0.605082417582418
"6255",179867,"Washington University in St Louis",1,0,2007,1325,645,680,1169,593,576,0.893,0.882,0.872,34500,1720.965,783,776,0.585660377358491
"6256",179867,"Washington University in St Louis",1,0,2008,1408,711,697,1270,605,665,0.935,0.902,0.868,36200,1793.958,794,817,0.580255681818182
"6257",179867,"Washington University in St Louis",1,0,2009,1481,720,761,1280,622,658,0.914,0.864,0.817,37800,1922.616,810,812,0.548278190411884
"6258",179867,"Washington University in St Louis",1,0,2010,1619,776,843,1430,716,714,0.92,0.883,0.849,39400,1981.401,817,929,0.573810994441013
"6259",179894,"WEBSTER UNIVERSITY",1,0,1991,187,110,77,65,24,41,0.373,0.348,0.312,7300,46.314629,105,149,0.796791443850267
"6260",179894,"WEBSTER UNIVERSITY",1,0,1992,201,114,87,68,22,46,0.404,0.338,0.253,8000,51.529136,107,165,0.82089552238806
"6261",179894,"WEBSTER UNIVERSITY",1,0,1993,227,132,95,81,28,53,0.401,0.357,0.295,8560,49.985192,115,201,0.885462555066079
"6262",179894,"WEBSTER UNIVERSITY",1,0,1995,227,105,122,90,52,38,0.362,0.396,0.426,9710,59.413269,125,153,0.674008810572687
"6263",179894,"WEBSTER UNIVERSITY",1,0,1996,270,139,131,116,50,66,0.475,0.43,0.382,10292,65.228998,132,211,0.781481481481481
"6264",179894,"WEBSTER UNIVERSITY",1,0,1997,314,193,121,124,41,83,0.43,0.395,0.339,10860,72.064598,133,264,0.840764331210191
"6265",179894,"WEBSTER UNIVERSITY",1,0,1998,339,198,141,123,50,73,0.369,0.363,0.355,11460,79.592274,147,274,0.808259587020649
"6266",179894,"WEBSTER UNIVERSITY",1,0,1999,369,214,155,156,52,104,0.486,0.423,0.335,12150,87.345027,147,299,0.81029810298103
"6267",179894,"WEBSTER UNIVERSITY",1,0,2000,412,242,170,168,60,108,0.446,0.408,0.353,12880,94.614164,149.5,327,0.793689320388349
"6268",179894,"WEBSTER UNIVERSITY",1,0,2001,399,250,149,179,64,115,0.46,0.449,0.43,13720,100.465325,152,330,0.827067669172932
"6269",179894,"WEBSTER UNIVERSITY",1,0,2002,385,226,159,178,67,111,0.491,0.462,0.421,14600,111.365049,157,287,0.745454545454545
"6270",179894,"WEBSTER UNIVERSITY",1,0,2003,419,260,159,201,62,139,0.535,0.48,0.39,15480,124.895776,166,333,0.794749403341289
"6271",179894,"WEBSTER UNIVERSITY",1,0,2004,448,256,192,229,89,140,0.547,0.511,0.464,16250,140.052634,166,359,0.801339285714286
"6272",179894,"Webster University",1,0,2005,394,224,170,175,76,99,0.442,0.444,0.447,17210,146.586519,169,288,0.730964467005076
"6273",179894,"Webster University",1,0,2006,418,240,178,198,69,129,0.537,0.474,0.388,18240,147.328722,169,328,0.784688995215311
"6274",179894,"Webster University",1,0,2007,483,278,205,224,80,144,0.518,0.464,0.39,19330,157.048737,170,350,0.72463768115942
"6275",179894,"Webster University",1,0,2008,407,250,157,173,58,115,0.46,0.425,0.369,20440,166.618378,175,290,0.712530712530713
"6276",179894,"Webster University",1,0,2009,486,289,197,219,78,141,0.488,0.451,0.396,21056,169.668091,182,332,0.683127572016461
"6277",179894,"Webster University",1,0,2010,413,238,175,187,67,120,0.504,0.453,0.383,21688,178.297686,186,279,0.675544794188862
"6278",179946,"WESTMINSTER COLLEGE",1,0,1991,194,83,111,99,56,43,0.518,0.51,0.505,8400,9.746476,50,181,0.93298969072165
"6279",179946,"WESTMINSTER COLLEGE",1,0,1992,203,89,114,75,39,36,0.404,0.369,0.342,8950,9.872169,50,191,0.940886699507389
"6280",179946,"WESTMINSTER COLLEGE",1,0,1993,180,71,109,73,39,34,0.479,0.406,0.358,9950,10.341443,50,168,0.933333333333333
"6281",179946,"WESTMINSTER COLLEGE",1,0,1995,190,88,102,91,47,44,0.5,0.479,0.461,11150,11.786444,46,174,0.91578947368421
"6282",179946,"WESTMINSTER COLLEGE",1,0,1996,214,84,130,100,62,38,0.452,0.467,0.477,11700,12.058025,45,195,0.911214953271028
"6283",179946,"WESTMINSTER COLLEGE",1,0,1997,190,71,119,78,40,38,0.535,0.411,0.336,12300,10.424074,49,177,0.931578947368421
"6284",179946,"WESTMINSTER COLLEGE",1,0,1998,205,94,111,78,40,38,0.404,0.38,0.36,13205,11.78487,35,178,0.868292682926829
"6285",179946,"WESTMINSTER COLLEGE",1,0,1999,201,90,111,94,41,53,0.589,0.468,0.369,13490,13.269606,50,180,0.895522388059702
"6286",179946,"WESTMINSTER COLLEGE",1,0,2000,173,75,98,82,37,45,0.6,0.474,0.378,14060,14.029032,60,155,0.895953757225434
"6287",179946,"WESTMINSTER COLLEGE",1,0,2001,248,102,146,97,42,55,0.539,0.391,0.288,14630,15.673522,70,218,0.879032258064516
"6288",179946,"WESTMINSTER COLLEGE",1,0,2002,207,93,114,100,48,52,0.559,0.483,0.421,15360,16.954642,57,172,0.830917874396135
"6289",179946,"WESTMINSTER COLLEGE",1,0,2003,240,93,147,96,56,40,0.43,0.4,0.381,16128,17.256158,52,188,0.783333333333333
"6290",179946,"WESTMINSTER COLLEGE",1,0,2004,231,108,123,105,54,51,0.472,0.455,0.439,12990,17.876379,50,195,0.844155844155844
"6291",179946,"Westminster College",1,0,2005,287,125,162,143,65,78,0.624,0.498,0.401,13750,17.8548,57,203,0.707317073170732
"6292",179946,"Westminster College",1,0,2006,278,139,139,163,73,90,0.647,0.586,0.525,14120,19.508066,58,212,0.762589928057554
"6293",179946,"Westminster College",1,0,2007,223,95,128,115,57,58,0.61,0.516,0.445,15500,20.165342,54,169,0.757847533632287
"6294",179946,"Westminster College",1,0,2008,244,108,136,123,67,56,0.519,0.504,0.493,16650,20.618641,58,181,0.741803278688525
"6295",179946,"Westminster College",1,0,2009,311,152,159,149,61,88,0.579,0.479,0.384,17990,22.244471,61,217,0.697749196141479
"6296",179946,"Westminster College",1,0,2010,315,139,176,175,75,100,0.719,0.556,0.426,18990,23.61551,62,227,0.720634920634921
"6297",180179,"EASTERN MONTANA COLLEGE",1,0,1991,248,168,80,17,4,13,0.077,0.069,0.05,1524,25.712343,137,211,0.850806451612903
"6298",180179,"EASTERN MONTANA COLLEGE",1,0,1992,285,200,85,27,9,18,0.09,0.095,0.106,1835,27.670253,138,253,0.887719298245614
"6299",180179,"EASTERN MONTANA COLLEGE",1,0,1993,386,261,125,25,3,22,0.084,0.065,0.024,1916,27.672417,141,348,0.901554404145078
"6300",180179,"MONTANA STATE UNIVERSITY-BILLINGS",1,0,1995,384,255,129,12,2,10,0.039,0.031,0.016,2304,28.578762,143,358,0.932291666666667
"6301",180179,"MONTANA STATE UNIVERSITY-BILLINGS",1,0,1996,520,332,188,79,28,51,0.154,0.152,0.149,2388,33.427778,142,466,0.896153846153846
"6302",180179,"MONTANA STATE UNIVERSITY-BILLINGS",1,0,1997,508,334,174,121,28,93,0.278,0.238,0.161,2517,34.649536,137,431,0.848425196850394
"6303",180179,"MONTANA STATE UNIVERSITY-BILLINGS",1,0,1998,539,325,214,52,10,42,0.129,0.096,0.047,2816,36.245837,139,450,0.834879406307978
"6304",180179,"MONTANA STATE UNIVERSITY-BILLINGS",1,0,1999,629,384,245,56,15,41,0.107,0.089,0.061,2922,38.583502,131,532,0.845786963434022
"6305",180179,"MONTANA STATE UNIVERSITY-BILLINGS",1,0,2000,538,352,186,48,10,38,0.108,0.089,0.054,3052,40.867917,142,424,0.788104089219331
"6306",180179,"MONTANA STATE UNIVERSITY-BILLINGS",1,0,2001,526,346,180,48,15,33,0.095,0.091,0.083,3429,45.121786,153,438,0.832699619771863
"6307",180179,"MONTANA STATE UNIVERSITY-BILLINGS",1,0,2002,542,357,185,48,9,39,0.109,0.089,0.049,3973,44.879453,148,458,0.845018450184502
"6308",180179,"MONTANA STATE UNIVERSITY-BILLINGS",1,0,2003,588,380,208,54,13,41,0.108,0.092,0.062,4180,48.005299,154,513,0.872448979591837
"6309",180179,"MONTANA STATE UNIVERSITY-BILLINGS",1,0,2004,502,338,164,64,18,46,0.136,0.127,0.11,4550,52.418451,164,423,0.842629482071713
"6310",180179,"Montana State University-Billings",1,0,2005,796,463,333,79,26,53,0.114,0.099,0.078,3762,53.775165,157,677,0.850502512562814
"6311",180179,"Montana State University-Billings",1,0,2006,646,339,307,59,17,42,0.124,0.091,0.055,3951,55.908551,157,567,0.877708978328173
"6312",180179,"Montana State University-Billings",1,0,2007,724,393,331,60,16,44,0.112,0.083,0.048,3988,58.757416,155,615,0.849447513812155
"6313",180179,"Montana State University-Billings",1,0,2008,692,402,290,47,14,33,0.082,0.068,0.048,3988,62.273244,154,577,0.833815028901734
"6314",180179,"Montana State University-Billings",1,0,2009,715,400,315,51,19,32,0.08,0.071,0.06,3988,62.554304,154,619,0.865734265734266
"6315",180179,"Montana State University-Billings",1,0,2010,829,434,395,44,11,33,0.076,0.053,0.028,3988,63.418451,150,674,0.813027744270205
"6316",180461,"MONTANA STATE UNIVERSITY",1,0,1991,1445,652,793,156,60,96,0.147,0.108,0.076,1550,106.431242,494,1227,0.849134948096886
"6317",180461,"MONTANA STATE UNIVERSITY",1,0,1992,1530,646,884,155,65,90,0.139,0.101,0.074,1839,129.330347,483,1313,0.858169934640523
"6318",180461,"MONTANA STATE UNIVERSITY",1,0,1993,1716,756,960,195,89,106,0.14,0.114,0.093,2002,137.592702,468,1511,0.880536130536131
"6319",180461,"MONTANA STATE UNIVERSITY-BOZEMAN",1,0,1995,1744,714,1030,224,101,123,0.172,0.128,0.098,2378,153.065178,460,1565,0.897362385321101
"6320",180461,"MONTANA STATE UNIVERSITY-BOZEMAN",1,0,1996,1740,780,960,246,120,126,0.161,0.141,0.125,2504,157.734937,461,1531,0.879885057471264
"6321",180461,"MONTANA STATE UNIVERSITY-BOZEMAN",1,0,1997,1819,784,1035,259,116,143,0.182,0.142,0.112,2677,182.327007,442,1616,0.888400219901045
"6322",180461,"MONTANA STATE UNIVERSITY-BOZEMAN",1,0,1998,1886,846,1040,299,140,159,0.188,0.159,0.135,2869,170.400113,430,1666,0.883351007423118
"6323",180461,"MONTANA STATE UNIVERSITY-BOZEMAN",1,0,1999,1894,891,1003,354,164,190,0.213,0.187,0.164,2177,193.864945,464,1659,0.875923970432946
"6324",180461,"MONTANA STATE UNIVERSITY-BOZEMAN",1,0,2000,1852,841,1011,357,160,197,0.234,0.193,0.158,2272,218.829928,467.5,1698,0.916846652267819
"6325",180461,"MONTANA STATE UNIVERSITY-BOZEMAN",1,0,2001,1720,731,989,292,148,144,0.197,0.17,0.15,2567,221.109025,471,1583,0.920348837209302
"6326",180461,"MONTANA STATE UNIVERSITY-BOZEMAN",1,0,2002,1924,833,1091,307,130,177,0.212,0.16,0.119,2900,232.756434,496,1765,0.917359667359667
"6327",180461,"MONTANA STATE UNIVERSITY-BOZEMAN",1,0,2003,2004,837,1167,383,193,190,0.227,0.191,0.165,3256,252.41398,496,1861,0.928642714570858
"6328",180461,"MONTANA STATE UNIVERSITY-BOZEMAN",1,0,2004,1998,836,1162,341,159,182,0.218,0.171,0.137,3654,267.864013,483,1832,0.916916916916917
"6329",180461,"Montana State University-Bozeman",1,0,2005,1980,843,1137,412,198,214,0.254,0.208,0.174,4106,283.12704,538,1843,0.930808080808081
"6330",180461,"Montana State University-Bozeman",1,0,2006,1940,814,1126,381,173,208,0.256,0.196,0.154,4501,301.715158,545,1782,0.918556701030928
"6331",180461,"Montana State University",1,0,2007,1852,791,1061,371,162,209,0.264,0.2,0.153,4559,313.423037,540,1668,0.900647948164147
"6332",180461,"Montana State University",1,0,2008,1805,765,1040,354,154,200,0.261,0.196,0.148,4559,333.379547,541,1627,0.901385041551247
"6333",180461,"Montana State University",1,0,2009,1795,728,1067,387,190,197,0.271,0.216,0.178,4696,352.650932,559,1627,0.906406685236769
"6334",180461,"Montana State University",1,0,2010,2115,877,1238,502,219,283,0.323,0.237,0.177,4836,354.973063,579,1870,0.884160756501182
"6335",180522,"NORTHERN MONTANA COLLEGE",0,1,1991,188,86,102,27,18,9,0.105,0.144,0.176,1440,13.281672,79,151,0.803191489361702
"6336",180522,"NORTHERN MONTANA COLLEGE",1,0,1992,188,98,90,20,13,7,0.071,0.106,0.144,1732,14.271352,75,160,0.851063829787234
"6337",180522,"NORTHERN MONTANA COLLEGE",1,0,1993,223,106,117,20,9,11,0.104,0.09,0.077,1802,15.291383,79,182,0.816143497757848
"6338",180522,"MONTANA STATE UNIVERSITY-NORTHERN",1,0,1995,192,99,93,38,16,22,0.222,0.198,0.172,2221,16.035143,77,150,0.78125
"6339",180522,"MONTANA STATE UNIVERSITY-NORTHERN",1,0,1996,218,96,122,24,13,11,0.115,0.11,0.107,2350,16.487839,73,108,0.495412844036697
"6340",180522,"MONTANA STATE UNIVERSITY-NORTHERN",1,0,1997,235,89,146,28,16,12,0.135,0.119,0.11,2484,17.398322,70,182,0.774468085106383
"6341",180522,"MONTANA STATE UNIVERSITY-NORTHERN",1,0,1998,253,107,146,25,15,10,0.094,0.099,0.103,2692,17.971379,65,213,0.841897233201581
"6342",180522,"MONTANA STATE UNIVERSITY-NORTHERN",1,0,1999,261,112,149,30,16,14,0.125,0.115,0.107,1988,18.27533,64,210,0.804597701149425
"6343",180522,"MONTANA STATE UNIVERSITY-NORTHERN",1,0,2000,187,85,102,28,17,11,0.129,0.15,0.167,1988,18.333848,63,152,0.812834224598931
"6344",180522,"MONTANA STATE UNIVERSITY-NORTHERN",1,0,2001,177,76,101,16,10,6,0.079,0.09,0.099,2436,19.094478,62,128,0.72316384180791
"6345",180522,"MONTANA STATE UNIVERSITY-NORTHERN",1,0,2002,185,87,98,23,13,10,0.115,0.124,0.133,2796,19.605546,67,136,0.735135135135135
"6346",180522,"MONTANA STATE UNIVERSITY-NORTHERN",1,0,2003,214,108,106,36,20,16,0.148,0.168,0.189,2769,20.662917,63,177,0.827102803738318
"6347",180522,"MONTANA STATE UNIVERSITY-NORTHERN",1,0,2004,175,57,118,19,12,7,0.123,0.109,0.102,3101,20.670199,64,140,0.8
"6348",180522,"Montana State University-Northern",1,0,2005,192,55,137,15,10,5,0.091,0.078,0.073,3335,19.870262,66,140,0.729166666666667
"6349",180522,"Montana State University-Northern",1,0,2006,193,66,127,12,5,7,0.106,0.062,0.039,3586,22.032229,68,160,0.829015544041451
"6350",180522,"Montana State University-Northern",1,0,2007,186,69,117,19,12,7,0.101,0.102,0.103,3586,21.339651,67,136,0.731182795698925
"6351",180522,"Montana State University-Northern",1,0,2008,199,70,129,14,5,9,0.129,0.07,0.039,3586,21.574333,63,153,0.768844221105528
"6352",180522,"Montana State University-Northern",1,0,2009,233,71,162,21,13,8,0.113,0.09,0.08,3586,21.62503,60,178,0.763948497854077
"6353",180522,"Montana State University-Northern",1,0,2010,226,78,148,16,10,6,0.077,0.071,0.068,3586,22.957323,62,160,0.707964601769911
"6354",180984,"CONCORDIA TEACHERS COLLEGE",1,0,1991,204,117,87,58,17,41,0.35,0.284,0.195,7110,10.286791,57,194,0.950980392156863
"6355",180984,"CONCORDIA TEACHERS COLLEGE",1,0,1992,202,114,88,73,24,49,0.43,0.361,0.273,8090,11.408214,59,189,0.935643564356436
"6356",180984,"CONCORDIA TEACHERS COLLEGE",1,0,1993,230,114,116,87,31,56,0.491,0.378,0.267,8506,12.42474,54,210,0.91304347826087
"6357",180984,"CONCORDIA TEACHERS COLLEGE",1,0,1995,227,128,99,92,37,55,0.43,0.405,0.374,9480,14.489698,65,220,0.969162995594714
"6358",180984,"CONCORDIA TEACHERS COLLEGE",1,0,1996,247,133,114,67,27,40,0.301,0.271,0.237,10150,16.076739,59,214,0.866396761133603
"6359",180984,"CONCORDIA TEACHERS COLLEGE",1,0,1997,277,152,125,64,22,42,0.276,0.231,0.176,10750,12.662992,58,262,0.945848375451264
"6360",180984,"CONCORDIA UNIVERSITY",1,0,1998,294,172,122,90,25,65,0.378,0.306,0.205,11310,13.746239,55,273,0.928571428571429
"6361",180984,"CONCORDIA UNIVERSITY",1,0,1999,324,149,175,86,41,45,0.302,0.265,0.234,11876,15.265017,57,209,0.645061728395062
"6362",180984,"CONCORDIA UNIVERSITY",1,0,2000,329,173,156,84,42,42,0.243,0.255,0.269,12470,15.815894,56.5,317,0.963525835866261
"6363",180984,"CONCORDIA UNIVERSITY",1,0,2001,265,163,102,71,23,48,0.294,0.268,0.225,13468,18.259049,56,245,0.924528301886792
"6364",180984,"CONCORDIA UNIVERSITY",1,0,2002,319,175,144,130,41,89,0.509,0.408,0.285,14546,18.401317,51,299,0.93730407523511
"6365",180984,"CONCORDIA UNIVERSITY",1,0,2003,222,138,84,77,25,52,0.377,0.347,0.298,16000,18.128441,52,200,0.900900900900901
"6366",180984,"CONCORDIA UNIVERSITY",1,0,2004,278,146,132,103,28,75,0.514,0.371,0.212,16880,18.821657,52,247,0.888489208633094
"6367",180984,"Concordia University",1,0,2005,289,146,143,113,33,80,0.548,0.391,0.231,17724,20.089695,54,199,0.688581314878893
"6368",180984,"Concordia University",1,0,2006,302,153,149,114,43,71,0.464,0.377,0.289,18750,21.476806,57,265,0.877483443708609
"6369",180984,"Concordia University",1,0,2007,264,141,123,111,41,70,0.496,0.42,0.333,19670,23.018715,56,239,0.90530303030303
"6370",180984,"Concordia University",1,0,2008,273,129,144,125,57,68,0.527,0.458,0.396,20580,23.283767,58,245,0.897435897435897
"6371",180984,"Concordia University",1,0,2009,288,139,149,117,47,70,0.504,0.406,0.315,21100,23.950575,55,259,0.899305555555556
"6372",180984,"Concordia University-Seward",1,0,2010,276,139,137,138,57,81,0.583,0.5,0.416,21940,25.003792,58,254,0.920289855072464
"6373",181002,"CREIGHTON UNIVERSITY",1,0,1991,750,445,305,430,170,260,0.584,0.573,0.557,8996,143.757323,334,648,0.864
"6374",181002,"CREIGHTON UNIVERSITY",1,0,1992,843,517,326,509,190,319,0.617,0.604,0.583,9670,159.745528,344,728,0.863582443653618
"6375",181002,"CREIGHTON UNIVERSITY",1,0,1993,833,492,341,438,164,274,0.557,0.526,0.481,10252,165.952,342,711,0.853541416566627
"6376",181002,"CREIGHTON UNIVERSITY",1,0,1995,746,441,305,421,157,264,0.599,0.564,0.515,11964,184.232714,370,608,0.815013404825737
"6377",181002,"CREIGHTON UNIVERSITY",1,0,1996,832,494,338,489,194,295,0.597,0.588,0.574,12210,197.673913,373,642,0.771634615384615
"6378",181002,"CREIGHTON UNIVERSITY",1,0,1997,798,457,341,466,184,282,0.617,0.584,0.54,12756,188.129167,373,627,0.785714285714286
"6379",181002,"CREIGHTON UNIVERSITY",1,0,1998,794,462,332,481,195,286,0.619,0.606,0.587,13394,195.048159,394,627,0.789672544080604
"6380",181002,"CREIGHTON UNIVERSITY",1,0,1999,822,499,323,516,209,307,0.615,0.628,0.647,13566,208.33758,374,677,0.82360097323601
"6381",181002,"CREIGHTON UNIVERSITY",1,0,2000,881,535,346,537,197,340,0.635,0.61,0.569,14312,217.954618,508.5,719,0.816118047673099
"6382",181002,"CREIGHTON UNIVERSITY",1,0,2001,760,440,320,454,170,284,0.645,0.597,0.531,16500,241.519322,643,643,0.846052631578947
"6383",181002,"CREIGHTON UNIVERSITY",1,0,2002,802,488,314,534,191,343,0.703,0.666,0.608,18200,253.675065,642,675,0.841645885286783
"6384",181002,"CREIGHTON UNIVERSITY",1,0,2003,933,567,366,601,223,378,0.667,0.644,0.609,19202,273.154099,424,792,0.84887459807074
"6385",181002,"CREIGHTON UNIVERSITY",1,0,2004,968,584,384,633,246,387,0.663,0.654,0.641,20354,291.447346,431,796,0.822314049586777
"6386",181002,"Creighton University",1,0,2005,970,562,408,640,257,383,0.682,0.66,0.63,21576,315.184207,432,789,0.81340206185567
"6387",181002,"Creighton University",1,0,2006,965,591,374,653,257,396,0.67,0.677,0.687,24166,333.307793,441,783,0.81139896373057
"6388",181002,"Creighton University",1,0,2007,947,577,370,638,254,384,0.665,0.674,0.686,25616,362.535,454,740,0.781414994720169
"6389",181002,"Creighton University",1,0,2008,984,582,402,647,257,390,0.67,0.658,0.639,27282,397.717,474,751,0.763211382113821
"6390",181002,"Creighton University",1,0,2009,1052,635,417,709,275,434,0.683,0.674,0.659,28232,397.536,474,807,0.767110266159696
"6391",181002,"Creighton University",1,0,2010,1010,606,404,676,248,428,0.706,0.669,0.614,29226,399.909,475,736,0.728712871287129
"6392",181020,"DOANE COLLEGE",1,0,1991,230,116,114,117,42,75,0.647,0.509,0.368,8320,13.039821,54,216,0.939130434782609
"6393",181020,"DOANE COLLEGE",1,0,1992,241,125,116,136,55,81,0.648,0.564,0.474,8770,14.14552,55,223,0.925311203319502
"6394",181020,"DOANE COLLEGE",1,0,1993,246,135,111,127,52,75,0.556,0.516,0.468,9390,15.732051,57,236,0.959349593495935
"6395",181020,"DOANE COLLEGE",1,0,1995,243,130,113,140,56,84,0.646,0.576,0.496,10410,18.162436,61,236,0.97119341563786
"6396",181020,"DOANE COLLEGE",1,0,1996,276,139,137,146,62,84,0.604,0.529,0.453,10950,19.431858,62,260,0.942028985507246
"6397",181020,"DOANE COLLEGE",1,0,1997,260,134,126,135,55,80,0.597,0.519,0.437,11450,20.472314,64,236,0.907692307692308
"6398",181020,"DOANE COLLEGE",1,0,1998,266,123,143,156,70,86,0.699,0.586,0.49,11800,15.593151,63,256,0.962406015037594
"6399",181020,"DOANE COLLEGE",1,0,1999,278,141,137,174,79,95,0.674,0.626,0.577,12010,16.973116,63,257,0.924460431654676
"6400",181020,"DOANE COLLEGE",1,0,2000,300,160,140,174,75,99,0.619,0.58,0.536,12500,18.190459,69,282,0.94
"6401",181020,"DOANE COLLEGE",1,0,2001,218,118,100,128,62,66,0.559,0.587,0.62,13150,20.088405,75,202,0.926605504587156
"6402",181020,"DOANE COLLEGE",1,0,2002,273,142,131,178,84,94,0.662,0.652,0.641,13960,21.123196,76,255,0.934065934065934
"6403",181020,"DOANE COLLEGE",1,0,2003,288,152,136,173,75,98,0.645,0.601,0.551,15080,22.324833,79,260,0.902777777777778
"6404",181020,"DOANE COLLEGE",1,0,2004,303,172,131,162,67,95,0.552,0.535,0.511,15620,24.150064,80,247,0.815181518151815
"6405",181020,"Doane College",1,0,2005,256,146,110,153,56,97,0.664,0.598,0.509,17186,24.80299,81,234,0.9140625
"6406",181020,"Doane College",1,0,2006,247,147,100,149,54,95,0.646,0.603,0.54,18420,21.816658,74,208,0.842105263157895
"6407",181020,"Doane College",1,0,2007,259,115,144,132,65,67,0.583,0.51,0.451,18800,23.085298,73,204,0.787644787644788
"6408",181020,"Doane College",1,0,2008,247,105,142,135,62,73,0.695,0.547,0.437,19750,23.739208,73,205,0.82995951417004
"6409",181020,"Doane College",1,0,2009,309,167,142,175,65,110,0.659,0.566,0.458,20540,24.708025,70,278,0.899676375404531
"6410",181020,"Doane College-Crete",1,0,2010,327,179,148,163,52,111,0.62,0.498,0.351,21570,24.736539,71,277,0.847094801223242
"6411",181127,"HASTINGS COLLEGE",1,0,1991,255,111,144,102,55,47,0.423,0.4,0.382,8090,11.331783,67,227,0.890196078431372
"6412",181127,"HASTINGS COLLEGE",1,0,1992,254,124,130,112,43,69,0.556,0.441,0.331,8720,11.99066,67,235,0.925196850393701
"6413",181127,"HASTINGS COLLEGE",1,0,1993,266,147,119,119,48,71,0.483,0.447,0.403,9296,12.822125,66,250,0.93984962406015
"6414",181127,"HASTINGS COLLEGE",1,0,1995,271,134,137,117,44,73,0.545,0.432,0.321,10164,14.456406,67,257,0.948339483394834
"6415",181127,"HASTINGS COLLEGE",1,0,1996,262,140,122,138,51,87,0.621,0.527,0.418,10724,15.1115,68,250,0.954198473282443
"6416",181127,"HASTINGS COLLEGE",1,0,1997,282,145,137,145,50,95,0.655,0.514,0.365,11368,12.062364,68,272,0.964539007092199
"6417",181127,"HASTINGS COLLEGE",1,0,1998,309,168,141,160,57,103,0.613,0.518,0.404,11940,12.781665,68,289,0.935275080906149
"6418",181127,"HASTINGS COLLEGE",1,0,1999,286,141,145,146,54,92,0.652,0.51,0.372,11916,14.211337,70,267,0.933566433566434
"6419",181127,"HASTINGS COLLEGE",1,0,2000,271,119,152,129,61,68,0.571,0.476,0.401,12396,14.70112,71.5,256,0.944649446494465
"6420",181127,"HASTINGS COLLEGE",1,0,2001,252,125,127,130,55,75,0.6,0.516,0.433,13116,15.566798,73,235,0.932539682539683
"6421",181127,"HASTINGS COLLEGE",1,0,2002,276,132,144,148,57,91,0.689,0.536,0.396,13972,16.087049,74,261,0.945652173913043
"6422",181127,"HASTINGS COLLEGE",1,0,2003,338,143,195,185,87,98,0.685,0.547,0.446,14782,17.140354,80,313,0.92603550295858
"6423",181127,"HASTINGS COLLEGE",1,0,2004,289,140,149,152,60,92,0.657,0.526,0.403,15640,18.528913,81,265,0.916955017301038
"6424",181127,"Hastings College",1,0,2005,312,133,179,143,69,74,0.556,0.458,0.385,16578,20.190245,79,288,0.923076923076923
"6425",181127,"Hastings College",1,0,2006,262,111,151,122,57,65,0.586,0.466,0.377,17572,21.583446,84,242,0.923664122137405
"6426",181127,"Hastings College",1,0,2007,302,117,185,131,70,61,0.521,0.434,0.378,18822,22.614822,87,275,0.910596026490066
"6427",181127,"Hastings College",1,0,2008,320,151,169,153,63,90,0.596,0.478,0.373,19952,22.965026,86,282,0.88125
"6428",181127,"Hastings College",1,0,2009,290,150,140,132,50,82,0.547,0.455,0.357,20912,23.846967,86,252,0.868965517241379
"6429",181127,"Hastings College",1,0,2010,312,150,162,144,66,78,0.52,0.462,0.407,21720,23.656297,81,277,0.887820512820513
"6430",181215,"UNIVERSITY OF NEBRASKA AT KEARNEY",1,0,1991,1230,665,565,141,54,87,0.131,0.115,0.096,1572,40.468921,296,1099,0.89349593495935
"6431",181215,"UNIVERSITY OF NEBRASKA AT KEARNEY",1,0,1992,1322,723,599,137,38,99,0.137,0.104,0.063,1720,44.011438,309,1151,0.870650529500756
"6432",181215,"UNIVERSITY OF NEBRASKA AT KEARNEY",1,0,1993,936,501,435,124,37,87,0.174,0.132,0.085,1811,47.394372,309,844,0.901709401709402
"6433",181215,"UNIVERSITY OF NEBRASKA AT KEARNEY",1,0,1995,1306,729,577,138,46,92,0.126,0.106,0.08,2061,48.439098,311,1154,0.883614088820827
"6434",181215,"UNIVERSITY OF NEBRASKA AT KEARNEY",1,0,1996,1279,707,572,174,59,115,0.163,0.136,0.103,2145,50.085079,317,1117,0.873338545738858
"6435",181215,"UNIVERSITY OF NEBRASKA AT KEARNEY",1,0,1997,1005,570,435,174,60,114,0.2,0.173,0.138,2268,54.415376,314,885,0.880597014925373
"6436",181215,"UNIVERSITY OF NEBRASKA AT KEARNEY",1,0,1998,1022,598,424,204,55,149,0.249,0.2,0.13,2508,53.665269,316,895,0.87573385518591
"6437",181215,"UNIVERSITY OF NEBRASKA AT KEARNEY",1,0,1999,1035,579,456,212,71,141,0.244,0.205,0.156,2122,57.681132,321,949,0.916908212560386
"6438",181215,"UNIVERSITY OF NEBRASKA AT KEARNEY",1,0,2000,996,550,446,159,48,111,0.202,0.16,0.108,2243,58.561904,316.5,897,0.900602409638554
"6439",181215,"UNIVERSITY OF NEBRASKA AT KEARNEY",1,0,2001,1038,602,436,213,62,151,0.251,0.205,0.142,2468,63.241473,312,896,0.863198458574181
"6440",181215,"UNIVERSITY OF NEBRASKA AT KEARNEY",1,0,2002,1022,574,448,216,69,147,0.256,0.211,0.154,2715,64.40106,307,865,0.846379647749511
"6441",181215,"UNIVERSITY OF NEBRASKA AT KEARNEY",1,0,2003,1012,588,424,229,73,156,0.265,0.226,0.172,3120,67.975016,294,864,0.853754940711462
"6442",181215,"UNIVERSITY OF NEBRASKA AT KEARNEY",1,0,2004,1061,589,472,238,85,153,0.26,0.224,0.18,3495,67.738314,298,906,0.853911404335532
"6443",181215,"University of Nebraska at Kearney",1,0,2005,1013,584,429,228,71,157,0.269,0.225,0.166,3668,72.825848,306,848,0.837117472852912
"6444",181215,"University of Nebraska at Kearney",1,0,2006,937,521,416,202,80,122,0.234,0.216,0.192,3885,75.743712,309,771,0.822838847385272
"6445",181215,"University of Nebraska at Kearney",1,0,2007,915,484,431,193,74,119,0.246,0.211,0.172,4118,79.638296,305,729,0.79672131147541
"6446",181215,"University of Nebraska at Kearney",1,0,2008,1019,530,489,232,87,145,0.274,0.228,0.178,4365,81.018845,304,816,0.800785083415113
"6447",181215,"University of Nebraska at Kearney",1,0,2009,974,548,426,231,81,150,0.274,0.237,0.19,4538,86.640085,305,764,0.784394250513347
"6448",181215,"University of Nebraska at Kearney",1,0,2010,1124,656,468,305,96,209,0.319,0.271,0.205,4808,89.655008,306,922,0.820284697508897
"6449",181394,"UNIVERSITY OF NEBRASKA AT OMAHA",1,0,1991,1275,635,640,70,31,39,0.061,0.055,0.048,1242,82.800372,399,1049,0.822745098039216
"6450",181394,"UNIVERSITY OF NEBRASKA AT OMAHA",1,0,1992,1256,630,626,54,19,35,0.056,0.043,0.03,1467,90.009848,398,982,0.781847133757962
"6451",181394,"UNIVERSITY OF NEBRASKA AT OMAHA",1,0,1993,1220,664,556,52,14,38,0.057,0.043,0.025,1535,91.560554,403,1025,0.840163934426229
"6452",181394,"UNIVERSITY OF NEBRASKA AT OMAHA",1,0,1995,1123,607,516,64,20,44,0.072,0.057,0.039,1790,90.728434,415,929,0.827248441674087
"6453",181394,"UNIVERSITY OF NEBRASKA AT OMAHA",1,0,1996,1129,588,541,87,32,55,0.094,0.077,0.059,1848,97.266842,422,954,0.844995571302037
"6454",181394,"UNIVERSITY OF NEBRASKA AT OMAHA",1,0,1997,1185,615,570,95,33,62,0.101,0.08,0.058,1926,102.97243,438,960,0.810126582278481
"6455",181394,"UNIVERSITY OF NEBRASKA AT OMAHA",1,0,1998,1296,701,595,120,42,78,0.111,0.093,0.071,2144,107.920237,434,1072,0.827160493827161
"6456",181394,"UNIVERSITY OF NEBRASKA AT OMAHA",1,0,1999,1477,762,715,151,45,106,0.139,0.102,0.063,2393,114.610928,423,1251,0.846987136086662
"6457",181394,"UNIVERSITY OF NEBRASKA AT OMAHA",1,0,2000,1517,825,692,157,55,102,0.124,0.103,0.079,2528,119.99646,434,1273,0.839156229400132
"6458",181394,"UNIVERSITY OF NEBRASKA AT OMAHA",1,0,2001,1588,857,731,170,62,108,0.126,0.107,0.085,2226,129.097646,445,1338,0.842569269521411
"6459",181394,"UNIVERSITY OF NEBRASKA AT OMAHA",1,0,2002,1601,851,750,199,77,122,0.143,0.124,0.103,3060,142.998354,467,1355,0.846346033728919
"6460",181394,"UNIVERSITY OF NEBRASKA AT OMAHA",1,0,2003,1465,787,678,189,85,104,0.132,0.129,0.125,3518,141.786214,452,1261,0.860750853242321
"6461",181394,"UNIVERSITY OF NEBRASKA AT OMAHA",1,0,2004,1577,878,699,201,78,123,0.14,0.127,0.112,3938,143.621846,448,1366,0.866201648700063
"6462",181394,"University of Nebraska at Omaha",1,0,2005,1690,911,779,259,105,154,0.169,0.153,0.135,4133,151.900435,465,1402,0.829585798816568
"6463",181394,"University of Nebraska at Omaha",1,0,2006,1637,864,773,231,95,136,0.157,0.141,0.123,4380,157.736019,472,1349,0.824068417837508
"6464",181394,"University of Nebraska at Omaha",1,0,2007,1596,834,762,228,106,122,0.146,0.143,0.139,4643,162.760139,474,1279,0.801378446115288
"6465",181394,"University of Nebraska at Omaha",1,0,2008,1755,920,835,286,107,179,0.195,0.163,0.128,4920,172.893965,479,1419,0.808547008547009
"6466",181394,"University of Nebraska at Omaha",1,0,2009,1747,932,815,278,93,185,0.198,0.159,0.114,5115,186.648714,483,1393,0.797366914710933
"6467",181394,"University of Nebraska at Omaha",1,0,2010,1703,925,778,14,8,6,0.007,0.008,0.01,5423,192.040731,466,1281,0.752201996476806
"6468",181446,"NEBRASKA WESLEYAN UNIVERSITY",1,0,1991,343,192,151,170,72,98,0.51,0.496,0.477,8226,17.034855,87,319,0.93002915451895
"6469",181446,"NEBRASKA WESLEYAN UNIVERSITY",1,0,1992,366,212,154,174,72,102,0.481,0.475,0.468,8430,17.569952,86,348,0.950819672131147
"6470",181446,"NEBRASKA WESLEYAN UNIVERSITY",1,0,1993,382,218,164,153,62,91,0.417,0.401,0.378,8894,18.344613,87,363,0.950261780104712
"6471",181446,"NEBRASKA WESLEYAN UNIVERSITY",1,0,1995,362,214,148,164,57,107,0.5,0.453,0.385,9890,19.622125,91,338,0.933701657458563
"6472",181446,"NEBRASKA WESLEYAN UNIVERSITY",1,0,1996,383,225,158,202,79,123,0.547,0.527,0.5,10284,20.199394,89,367,0.95822454308094
"6473",181446,"NEBRASKA WESLEYAN UNIVERSITY",1,0,1997,437,250,187,205,87,118,0.472,0.469,0.465,11220,17.507521,86,422,0.965675057208238
"6474",181446,"NEBRASKA WESLEYAN UNIVERSITY",1,0,1998,429,246,183,200,76,124,0.504,0.466,0.415,12004,18.854985,89,415,0.967365967365967
"6475",181446,"NEBRASKA WESLEYAN UNIVERSITY",1,0,1999,358,204,154,197,84,113,0.554,0.55,0.545,12584,19.457026,92,343,0.958100558659218
"6476",181446,"NEBRASKA WESLEYAN UNIVERSITY",1,0,2000,423,254,169,235,87,148,0.583,0.556,0.515,13452,21.626948,95.5,403,0.952718676122931
"6477",181446,"NEBRASKA WESLEYAN UNIVERSITY",1,0,2001,392,223,169,219,84,135,0.605,0.559,0.497,14380,23.536416,99,374,0.954081632653061
"6478",181446,"NEBRASKA WESLEYAN UNIVERSITY",1,0,2002,336,187,149,157,70,87,0.465,0.467,0.47,15372,24.366841,95,316,0.94047619047619
"6479",181446,"NEBRASKA WESLEYAN UNIVERSITY",1,0,2003,417,241,176,216,83,133,0.552,0.518,0.472,16140,23.602744,101,396,0.949640287769784
"6480",181446,"NEBRASKA WESLEYAN UNIVERSITY",1,0,2004,428,238,190,223,101,122,0.513,0.521,0.532,17090,25.706157,103,406,0.948598130841122
"6481",181446,"Nebraska Wesleyan University",1,0,2005,406,237,169,236,82,154,0.65,0.581,0.485,18100,28.125978,105,394,0.970443349753695
"6482",181446,"Nebraska Wesleyan University",1,0,2006,413,212,201,212,94,118,0.557,0.513,0.468,18980,30.622,109,385,0.932203389830508
"6483",181446,"Nebraska Wesleyan University",1,0,2007,438,272,166,239,74,165,0.607,0.546,0.446,19930,31.192336,110,414,0.945205479452055
"6484",181446,"Nebraska Wesleyan University",1,0,2008,383,212,171,211,76,135,0.637,0.551,0.444,20950,32.964,115,352,0.919060052219321
"6485",181446,"Nebraska Wesleyan University",1,0,2009,393,233,160,201,63,138,0.592,0.511,0.394,21980,33.645,113,364,0.926208651399491
"6486",181446,"Nebraska Wesleyan University",1,0,2010,427,237,190,256,106,150,0.633,0.6,0.558,23124,34.671,118,376,0.88056206088993
"6487",181464,"UNIVERSITY OF NEBRASKA AT LINCOLN",1,0,1991,3386,1641,1745,379,121,258,0.157,0.112,0.069,2040,337.727423,1127,3162,0.933845245126994
"6488",181464,"UNIVERSITY OF NEBRASKA AT LINCOLN",1,0,1992,3392,1651,1741,330,124,206,0.125,0.097,0.071,2187,351.232634,1126,3154,0.929834905660377
"6489",181464,"UNIVERSITY OF NEBRASKA AT LINCOLN",1,0,1993,3325,1571,1754,449,170,279,0.178,0.135,0.097,2283,374.848426,1127,3079,0.926015037593985
"6490",181464,"UNIVERSITY OF NEBRASKA AT LINCOLN",1,0,1995,3891,1925,1966,620,256,364,0.189,0.159,0.13,2555,402.380083,1115,3514,0.903109740426626
"6491",181464,"UNIVERSITY OF NEBRASKA AT LINCOLN",1,0,1996,3625,1814,1811,654,248,406,0.224,0.18,0.137,2638,426.433479,1100,3258,0.898758620689655
"6492",181464,"UNIVERSITY OF NEBRASKA AT LINCOLN",1,0,1997,3195,1596,1599,681,259,422,0.264,0.213,0.162,2829,438.946659,1127,2863,0.896087636932707
"6493",181464,"UNIVERSITY OF NEBRASKA AT LINCOLN",1,0,1998,3353,1619,1734,740,275,465,0.287,0.221,0.159,3083,458.991962,1129,3026,0.902475395168506
"6494",181464,"UNIVERSITY OF NEBRASKA AT LINCOLN",1,0,1999,3592,1778,1814,807,317,490,0.276,0.225,0.175,2617,476.891263,1154,3259,0.907293986636971
"6495",181464,"UNIVERSITY OF NEBRASKA AT LINCOLN",1,0,2000,3598,1783,1815,823,326,497,0.279,0.229,0.18,2760,501.365402,1135,3123,0.867982212340189
"6496",181464,"UNIVERSITY OF NEBRASKA AT LINCOLN",1,0,2001,3480,1691,1789,788,308,480,0.284,0.226,0.172,3038,528.298783,1116,3090,0.887931034482759
"6497",181464,"UNIVERSITY OF NEBRASKA AT LINCOLN",1,0,2002,3615,1878,1737,919,358,561,0.299,0.254,0.206,3345,568.031448,1088,3158,0.873582295988935
"6498",181464,"UNIVERSITY OF NEBRASKA AT LINCOLN",1,0,2003,3639,1825,1814,904,341,563,0.308,0.248,0.188,3847,597.065435,1035,3184,0.87496564990382
"6499",181464,"UNIVERSITY OF NEBRASKA AT LINCOLN",1,0,2004,3236,1559,1677,950,394,556,0.357,0.294,0.235,4312,598.279547,1038,2817,0.870519159456119
"6500",181464,"University of Nebraska at Lincoln",1,0,2005,3533,1671,1862,1118,505,613,0.367,0.316,0.271,4530,636.364245,1129,3012,0.852533257854515
"6501",181464,"University of Nebraska at Lincoln",1,0,2006,3828,1805,2023,1126,503,623,0.345,0.294,0.249,4800,696.872283,1131,3245,0.847701149425287
"6502",181464,"University of Nebraska-Lincoln",1,0,2007,4214,2061,2153,1363,555,808,0.392,0.323,0.258,5085,718.615513,1164,3423,0.812292358803987
"6503",181464,"University of Nebraska-Lincoln",1,0,2008,4164,2015,2149,1377,566,811,0.402,0.331,0.263,5392,768.039632,1166,3582,0.860230547550432
"6504",181464,"University of Nebraska-Lincoln",1,0,2009,3965,1870,2095,1308,552,756,0.404,0.33,0.263,5610,773.014038,1152,3409,0.859773013871375
"6505",181464,"University of Nebraska-Lincoln",1,0,2010,4039,1889,2150,1461,647,814,0.431,0.362,0.301,5948,810.080585,1180,3510,0.86902698687794
"6506",181534,"PERU STATE COLLEGE",1,0,1991,235,129,106,24,7,17,0.132,0.102,0.066,1589,8.714263,49,211,0.897872340425532
"6507",181534,"PERU STATE COLLEGE",1,0,1992,264,135,129,27,9,18,0.133,0.102,0.07,1671,9.312664,48,247,0.935606060606061
"6508",181534,"PERU STATE COLLEGE",1,0,1993,211,112,99,22,4,18,0.161,0.104,0.04,1687,9.188715,50,200,0.947867298578199
"6509",181534,"PERU STATE COLLEGE",1,0,1995,225,122,103,45,19,26,0.213,0.2,0.184,1848,10.458102,47,205,0.911111111111111
"6510",181534,"PERU STATE COLLEGE",1,0,1996,223,97,126,38,11,27,0.278,0.17,0.087,1936,10.166059,46,199,0.89237668161435
"6511",181534,"PERU STATE COLLEGE",1,0,1997,258,107,151,38,16,22,0.206,0.147,0.106,2018,11.022961,43,222,0.86046511627907
"6512",181534,"PERU STATE COLLEGE",1,0,1998,213,91,122,22,3,19,0.209,0.103,0.025,2161,12.232947,42,184,0.863849765258216
"6513",181534,"PERU STATE COLLEGE",1,0,1999,192,87,105,65,31,34,0.391,0.339,0.295,1875,11.681835,43,168,0.875
"6514",181534,"PERU STATE COLLEGE",1,0,2000,201,93,108,26,7,19,0.204,0.129,0.065,1973,12.576754,41.5,170,0.845771144278607
"6515",181534,"PERU STATE COLLEGE",1,0,2001,186,85,101,16,5,11,0.129,0.086,0.05,2093,13.572083,40,164,0.881720430107527
"6516",181534,"PERU STATE COLLEGE",1,0,2002,171,85,86,29,10,19,0.224,0.17,0.116,2288,12.767281,41,149,0.871345029239766
"6517",181534,"PERU STATE COLLEGE",1,0,2003,188,89,99,29,9,20,0.225,0.154,0.091,2610,12.214534,39,161,0.856382978723404
"6518",181534,"PERU STATE COLLEGE",1,0,2004,217,114,103,21,5,16,0.14,0.097,0.049,2850,12.469766,40,189,0.870967741935484
"6519",181534,"Peru State College",1,0,2005,213,112,101,26,7,19,0.17,0.122,0.069,2932,13.664281,45,174,0.816901408450704
"6520",181534,"Peru State College",1,0,2006,204,95,109,37,17,20,0.211,0.181,0.156,3296,14.97906,47,166,0.813725490196078
"6521",181534,"Peru State College",1,0,2007,197,89,108,38,13,25,0.281,0.193,0.12,3300,15.82754,45,159,0.807106598984772
"6522",181534,"Peru State College",1,0,2008,210,101,109,23,10,13,0.129,0.11,0.092,3495,16.306709,48,178,0.847619047619048
"6523",181534,"Peru State College",1,0,2009,227,113,114,35,12,23,0.204,0.154,0.105,3675,17.649246,46,190,0.837004405286344
"6524",181534,"Peru State College",1,0,2010,243,117,126,32,6,26,0.222,0.132,0.048,3863,18.936703,46,209,0.860082304526749
"6525",181783,"WAYNE STATE COLLEGE",1,0,1991,681,357,324,103,38,65,0.182,0.151,0.117,1515,18.322659,120,649,0.953010279001468
"6526",181783,"WAYNE STATE COLLEGE",1,0,1992,630,348,282,117,39,78,0.224,0.186,0.138,1599,20.530338,124,605,0.96031746031746
"6527",181783,"WAYNE STATE COLLEGE",1,0,1993,718,398,320,105,25,80,0.201,0.146,0.078,1690,22.240775,125,674,0.938718662952646
"6528",181783,"WAYNE STATE COLLEGE",1,0,1995,722,382,340,146,45,101,0.264,0.202,0.132,1839,22.569584,131,666,0.922437673130194
"6529",181783,"WAYNE STATE COLLEGE",1,0,1996,690,397,293,147,53,94,0.237,0.213,0.181,1938,23.071494,132,636,0.921739130434783
"6530",181783,"WAYNE STATE COLLEGE",1,0,1997,707,407,300,161,42,119,0.292,0.228,0.14,2080,25.384873,138,641,0.906647807637907
"6531",181783,"WAYNE STATE COLLEGE",1,0,1998,700,402,298,177,56,121,0.301,0.253,0.188,2163,28.450133,138,636,0.908571428571429
"6532",181783,"WAYNE STATE COLLEGE",1,0,1999,659,387,272,150,41,109,0.282,0.228,0.151,1875,28.738649,140,601,0.911987860394537
"6533",181783,"WAYNE STATE COLLEGE",1,0,2000,623,366,257,168,49,119,0.325,0.27,0.191,1973,28.394852,134.5,573,0.919743178170145
"6534",181783,"WAYNE STATE COLLEGE",1,0,2001,583,359,224,138,40,98,0.273,0.237,0.179,2093,29.874686,129,524,0.898799313893654
"6535",181783,"WAYNE STATE COLLEGE",1,0,2002,602,325,277,155,66,89,0.274,0.257,0.238,2288,28.458899,126,533,0.885382059800664
"6536",181783,"WAYNE STATE COLLEGE",1,0,2003,598,342,256,163,59,104,0.304,0.273,0.23,2610,30.177919,126,536,0.896321070234114
"6537",181783,"WAYNE STATE COLLEGE",1,0,2004,552,310,242,128,39,89,0.287,0.232,0.161,2850,29.469265,127,494,0.894927536231884
"6538",181783,"Wayne State College",1,0,2005,587,320,267,162,71,91,0.284,0.276,0.266,2346,32.263826,126,533,0.908006814310051
"6539",181783,"Wayne State College",1,0,2006,606,335,271,166,53,113,0.337,0.274,0.196,2460,34.403301,130,527,0.86963696369637
"6540",181783,"Wayne State College",1,0,2007,654,364,290,162,48,114,0.313,0.248,0.166,2640,36.975172,132,554,0.847094801223242
"6541",181783,"Wayne State College",1,0,2008,653,345,308,148,52,96,0.278,0.227,0.169,2796,38.256194,125,568,0.869831546707504
"6542",181783,"Wayne State College",1,0,2009,663,361,302,158,56,102,0.283,0.238,0.185,3675,40.006081,123,537,0.809954751131222
"6543",181783,"Wayne State College",1,0,2010,677,366,311,172,58,114,0.312,0.254,0.186,3863,39.772973,125,537,0.793205317577548
"6544",182281,"UNIVERSITY OF NEVADA-LAS VEGAS",1,0,1991,1172,604,568,125,47,78,0.129,0.107,0.083,1470,128.59707,598,796,0.679180887372014
"6545",182281,"UNIVERSITY OF NEVADA-LAS VEGAS",1,0,1992,1213,641,572,128,44,84,0.131,0.106,0.077,1665,136.56647,593,838,0.690849134377576
"6546",182281,"UNIVERSITY OF NEVADA-LAS VEGAS",1,0,1993,1281,669,612,127,47,80,0.12,0.099,0.077,1665,132.663452,642,828,0.646370023419204
"6547",182281,"UNIVERSITY OF NEVADA-LAS VEGAS",1,0,1995,1324,748,576,161,54,107,0.143,0.122,0.094,1830,161.243842,612,837,0.632175226586103
"6548",182281,"UNIVERSITY OF NEVADA-LAS VEGAS",1,0,1996,1509,797,712,179,49,130,0.163,0.119,0.069,1920,170.948752,607,911,0.603711066931743
"6549",182281,"UNIVERSITY OF NEVADA-LAS VEGAS",1,0,1997,1491,773,718,183,54,129,0.167,0.123,0.075,1995,185.518,612,903,0.605633802816901
"6550",182281,"UNIVERSITY OF NEVADA-LAS VEGAS",1,0,1998,1546,885,661,186,58,128,0.145,0.12,0.088,2070,201.028,632,910,0.588615782664942
"6551",182281,"UNIVERSITY OF NEVADA-LAS VEGAS",1,0,1999,1486,805,681,204,73,131,0.163,0.137,0.107,2145,221.58,676,886,0.596231493943472
"6552",182281,"UNIVERSITY OF NEVADA-LAS VEGAS",1,0,2000,2126,1182,944,240,70,170,0.144,0.113,0.074,2340,238.686,698.5,1224,0.575729068673565
"6553",182281,"UNIVERSITY OF NEVADA-LAS VEGAS",1,0,2001,2424,1411,1013,324,99,225,0.16,0.134,0.098,2415,258.243,721,1368,0.564356435643564
"6554",182281,"UNIVERSITY OF NEVADA-LAS VEGAS",1,0,2002,2383,1373,1010,293,80,213,0.155,0.123,0.079,2490,289.486,755,1292,0.542173730591691
"6555",182281,"UNIVERSITY OF NEVADA-LAS VEGAS",1,0,2003,2827,1596,1231,338,107,231,0.145,0.12,0.087,2670,327.822,776,1496,0.529182879377432
"6556",182281,"UNIVERSITY OF NEVADA-LAS VEGAS",1,0,2004,3108,1760,1348,428,134,294,0.167,0.138,0.099,2850,361.73,810,1604,0.516087516087516
"6557",182281,"University of Nevada-Las Vegas",1,0,2005,2964,1694,1270,402,134,268,0.158,0.136,0.106,3060,400.752,851,1140,0.384615384615385
"6558",182281,"University of Nevada-Las Vegas",1,0,2006,2532,1410,1122,368,130,238,0.169,0.145,0.116,3278,442.719,950,1225,0.483807266982622
"6559",182281,"University of Nevada-Las Vegas",1,0,2007,2780,1596,1184,406,117,289,0.181,0.146,0.099,3623,496.268,960,1305,0.469424460431655
"6560",182281,"University of Nevada-Las Vegas",1,0,2008,3020,1709,1311,422,142,280,0.164,0.14,0.108,4005,506.07,904,1318,0.436423841059603
"6561",182281,"University of Nevada-Las Vegas",1,0,2009,3083,1659,1424,397,146,251,0.151,0.129,0.103,4485,535.183,897,1307,0.423937722997081
"6562",182281,"University of Nevada-Las Vegas",1,0,2010,2923,1621,1302,341,117,224,0.138,0.117,0.09,5196,528.454,842,1141,0.39035237769415
"6563",182290,"UNIVERSITY OF NEVADA-RENO",1,0,1991,966,482,484,101,43,58,0.12,0.105,0.089,1104,154.949042,390,751,0.777432712215321
"6564",182290,"UNIVERSITY OF NEVADA-RENO",1,0,1992,1058,523,535,119,41,78,0.149,0.112,0.077,1308,174.740001,404,855,0.808128544423441
"6565",182290,"UNIVERSITY OF NEVADA-RENO",1,0,1993,1140,563,577,155,49,106,0.188,0.136,0.085,1332,186.56419,403,915,0.802631578947368
"6566",182290,"UNIVERSITY OF NEVADA-RENO",1,0,1995,1035,591,444,170,52,118,0.2,0.164,0.117,1464,211.175647,386,790,0.763285024154589
"6567",182290,"UNIVERSITY OF NEVADA-RENO",1,0,1996,1123,605,518,163,46,117,0.193,0.145,0.089,1650,236.116925,429,871,0.77560106856634
"6568",182290,"UNIVERSITY OF NEVADA-RENO",1,0,1997,1165,654,511,171,54,117,0.179,0.147,0.106,1710,249.917881,430,888,0.762231759656652
"6569",182290,"UNIVERSITY OF NEVADA-RENO",1,0,1998,1260,675,585,181,60,121,0.179,0.144,0.103,1770,266.116997,424,973,0.772222222222222
"6570",182290,"UNIVERSITY OF NEVADA-RENO",1,0,1999,1466,792,674,241,78,163,0.206,0.164,0.116,1704,278.997644,434,1116,0.761255115961801
"6571",182290,"UNIVERSITY OF NEVADA-RENO",1,0,2000,1930,1090,840,293,95,198,0.182,0.152,0.113,2340,302.193675,447,1461,0.75699481865285
"6572",182290,"UNIVERSITY OF NEVADA-RENO",1,0,2001,1956,1125,831,268,78,190,0.169,0.137,0.094,2415,325.222048,460,1504,0.768916155419223
"6573",182290,"UNIVERSITY OF NEVADA-RENO",1,0,2002,2066,1137,929,308,102,206,0.181,0.149,0.11,2490,345.544002,750,1571,0.760406582768635
"6574",182290,"UNIVERSITY OF NEVADA-RENO",1,0,2003,2047,1154,893,254,76,178,0.154,0.124,0.085,2670,370.375597,712,1479,0.722520762090865
"6575",182290,"UNIVERSITY OF NEVADA-RENO",1,0,2004,2132,1157,975,289,104,185,0.16,0.136,0.107,2850,405.526548,639,1467,0.688086303939963
"6576",182290,"University of Nevada-Reno",1,0,2005,2362,1300,1062,383,136,247,0.19,0.162,0.128,3060,430.31635,639,1598,0.676545300592718
"6577",182290,"University of Nevada-Reno",1,0,2006,2358,1300,1058,407,146,261,0.201,0.173,0.138,3278,470.571744,656,1576,0.668363019508058
"6578",182290,"University of Nevada-Reno",1,0,2007,2226,1166,1060,349,131,218,0.187,0.157,0.124,3623,494.500285,658,1498,0.672955974842767
"6579",182290,"University of Nevada-Reno",1,0,2008,2260,1211,1049,467,179,288,0.238,0.207,0.171,4005,518.632844,660,1513,0.669469026548673
"6580",182290,"University of Nevada-Reno",1,0,2009,2124,1144,980,467,172,295,0.258,0.22,0.176,4485,530.395743,645,1484,0.698681732580038
"6581",182290,"University of Nevada-Reno",1,0,2010,2693,1430,1263,610,233,377,0.264,0.227,0.184,5063,517.013048,631,1785,0.662829558113628
"6582",182634,"COLBY-SAWYER COLLEGE",1,0,1991,215,137,78,99,29,70,0.511,0.46,0.372,11900,9.580816,34,213,0.990697674418605
"6583",182634,"COLBY-SAWYER COLLEGE",1,0,1992,160,106,54,73,23,50,0.472,0.456,0.426,12775,11.259958,34,158,0.9875
"6584",182634,"COLBY-SAWYER COLLEGE",1,0,1993,179,115,64,72,24,48,0.417,0.402,0.375,13375,12.451295,38,173,0.966480446927374
"6585",182634,"COLBY-SAWYER COLLEGE",1,0,1995,240,154,86,115,46,69,0.448,0.479,0.535,14720,15.371654,40,230,0.958333333333333
"6586",182634,"COLBY-SAWYER COLLEGE",1,0,1996,227,158,69,91,31,60,0.38,0.401,0.449,15530,20.331074,41,220,0.969162995594714
"6587",182634,"COLBY-SAWYER COLLEGE",1,0,1997,240,172,68,111,29,82,0.477,0.462,0.426,16310,14.952938,40,214,0.891666666666667
"6588",182634,"COLBY-SAWYER COLLEGE",1,0,1998,235,162,73,111,29,82,0.506,0.472,0.397,17270,16.330069,41,221,0.940425531914894
"6589",182634,"COLBY-SAWYER COLLEGE",1,0,1999,236,151,85,115,47,68,0.45,0.487,0.553,18060,16.479783,42,224,0.949152542372881
"6590",182634,"COLBY-SAWYER COLLEGE",1,0,2000,274,180,94,148,47,101,0.561,0.54,0.5,18960,18.05402,45,262,0.956204379562044
"6591",182634,"COLBY-SAWYER COLLEGE",1,0,2001,285,184,101,140,43,97,0.527,0.491,0.426,20130,22.028442,48,254,0.891228070175439
"6592",182634,"COLBY-SAWYER COLLEGE",1,0,2002,270,172,98,133,54,79,0.459,0.493,0.551,21140,21.559013,50,261,0.966666666666667
"6593",182634,"COLBY-SAWYER COLLEGE",1,0,2003,304,207,97,158,34,124,0.599,0.52,0.351,22200,23.947025,47,294,0.967105263157895
"6594",182634,"COLBY-SAWYER COLLEGE",1,0,2004,263,179,84,140,42,98,0.547,0.532,0.5,23310,25.306955,53,255,0.96958174904943
"6595",182634,"Colby-Sawyer College",1,0,2005,280,179,101,130,42,88,0.492,0.464,0.416,24700,25.791426,54,271,0.967857142857143
"6596",182634,"Colby-Sawyer College",1,0,2006,220,151,69,95,22,73,0.483,0.432,0.319,26350,26.888222,55,200,0.909090909090909
"6597",182634,"Colby-Sawyer College",1,0,2007,353,240,113,169,44,125,0.521,0.479,0.389,28010,27.909484,47,306,0.86685552407932
"6598",182634,"Colby-Sawyer College",1,0,2008,376,251,125,138,44,94,0.375,0.367,0.352,29620,28.21481,51,323,0.859042553191489
"6599",182634,"Colby-Sawyer College",1,0,2009,432,313,119,190,45,145,0.463,0.44,0.378,31090,29.64645,60,357,0.826388888888889
"6600",182634,"Colby-Sawyer College",1,0,2010,393,266,127,185,51,134,0.504,0.471,0.402,32640,32.101843,64,271,0.689567430025445
"6601",182795,"FRANKLIN PIERCE COLLEGE",1,0,1991,429,192,237,124,57,67,0.349,0.289,0.241,11510,24.741925,73,337,0.785547785547786
"6602",182795,"FRANKLIN PIERCE COLLEGE",1,0,1992,469,236,233,178,82,96,0.407,0.38,0.352,12430,26.546376,75,340,0.724946695095949
"6603",182795,"FRANKLIN PIERCE COLLEGE",1,0,1993,410,186,224,117,64,53,0.285,0.285,0.286,12820,28.721347,76,377,0.919512195121951
"6604",182795,"FRANKLIN PIERCE COLLEGE",1,0,1995,464,220,244,174,75,99,0.45,0.375,0.307,14445,28.815591,61,383,0.825431034482759
"6605",182795,"FRANKLIN PIERCE COLLEGE",1,0,1996,438,210,228,181,81,100,0.476,0.413,0.355,15375,33.011747,67,313,0.714611872146119
"6606",182795,"FRANKLIN PIERCE COLLEGE",1,0,1997,489,257,232,178,69,109,0.424,0.364,0.297,16325,30.306025,69,398,0.813905930470348
"6607",182795,"FRANKLIN PIERCE COLLEGE",1,0,1998,429,203,226,145,59,86,0.424,0.338,0.261,17022,29.927875,68,330,0.769230769230769
"6608",182795,"FRANKLIN PIERCE COLLEGE",1,0,1999,429,184,245,189,103,86,0.467,0.441,0.42,17250,31.9021,67,363,0.846153846153846
"6609",182795,"FRANKLIN PIERCE COLLEGE",1,0,2000,530,262,268,227,101,126,0.481,0.428,0.377,18150,32.388557,66,442,0.833962264150943
"6610",182795,"FRANKLIN PIERCE COLLEGE",1,0,2001,477,249,228,153,67,86,0.345,0.321,0.294,18900,34.227107,65,387,0.811320754716981
"6611",182795,"FRANKLIN PIERCE COLLEGE",1,0,2002,505,252,253,197,88,109,0.432,0.39,0.348,19560,36.375182,61,417,0.825742574257426
"6612",182795,"FRANKLIN PIERCE COLLEGE",1,0,2003,514,244,270,172,74,98,0.402,0.335,0.274,20790,38.063215,69,403,0.784046692607004
"6613",182795,"FRANKLIN PIERCE COLLEGE",1,0,2004,568,285,283,232,97,135,0.474,0.408,0.343,21900,39.877689,70,452,0.795774647887324
"6614",182795,"Franklin Pierce College",1,0,2005,532,270,262,2,0,2,0.007,0.004,0,23100,43.667384,71,443,0.832706766917293
"6615",182795,"Franklin Pierce College",1,0,2006,553,260,293,226,103,123,0.473,0.409,0.352,24300,44.933776,86,438,0.792043399638336
"6616",182795,"Franklin Pierce University",1,0,2007,533,239,294,207,100,107,0.448,0.388,0.34,25516,47.40239,92,402,0.75422138836773
"6617",182795,"Franklin Pierce University",1,0,2008,474,205,269,185,89,96,0.468,0.39,0.331,27000,49.845665,97,360,0.759493670886076
"6618",182795,"Franklin Pierce University",1,0,2009,388,175,213,138,62,76,0.434,0.356,0.291,27700,50.101771,99,307,0.791237113402062
"6619",182795,"Franklin Pierce University",1,0,2010,399,179,220,142,50,92,0.514,0.356,0.227,27700,47.933533,99,295,0.739348370927318
"6620",183062,"KEENE STATE COLLEGE",1,0,1991,731,444,287,159,41,118,0.266,0.218,0.143,2680,37.203863,191,630,0.861833105335157
"6621",183062,"KEENE STATE COLLEGE",1,0,1992,754,447,307,179,50,129,0.289,0.237,0.163,2845,39.20154,160,699,0.927055702917772
"6622",183062,"KEENE STATE COLLEGE",1,0,1993,809,488,321,170,43,127,0.26,0.21,0.134,3120,43.082617,180,765,0.945611866501854
"6623",183062,"KEENE STATE COLLEGE",1,0,1995,988,588,400,251,86,165,0.281,0.254,0.215,3604,47.61022,179,941,0.952429149797571
"6624",183062,"KEENE STATE COLLEGE",1,0,1996,839,499,340,211,68,143,0.287,0.251,0.2,3794,52.026641,185,788,0.939213349225268
"6625",183062,"KEENE STATE COLLEGE",1,0,1997,845,501,344,193,71,122,0.244,0.228,0.206,4320,52.826005,182,789,0.933727810650888
"6626",183062,"KEENE STATE COLLEGE",1,0,1998,773,470,303,178,53,125,0.266,0.23,0.175,4750,56.669779,175,716,0.926261319534282
"6627",183062,"KEENE STATE COLLEGE",1,0,1999,1014,649,365,262,70,192,0.296,0.258,0.192,3830,58.619855,181,964,0.95069033530572
"6628",183062,"KEENE STATE COLLEGE",1,0,2000,935,576,359,243,69,174,0.302,0.26,0.192,4060,61.657106,188.5,909,0.972192513368984
"6629",183062,"KEENE STATE COLLEGE",1,0,2001,942,561,381,283,94,189,0.337,0.3,0.247,4220,65.149046,196,895,0.950106157112527
"6630",183062,"KEENE STATE COLLEGE",1,0,2002,1170,668,502,333,119,214,0.32,0.285,0.237,4450,64.167278,199,1118,0.955555555555556
"6631",183062,"KEENE STATE COLLEGE",1,0,2003,991,598,393,369,126,243,0.406,0.372,0.321,4750,71.640315,183,942,0.950554994954591
"6632",183062,"KEENE STATE COLLEGE",1,0,2004,1068,649,419,425,148,277,0.427,0.398,0.353,5060,71.372831,183,1003,0.939138576779026
"6633",183062,"Keene State College",1,0,2005,1001,565,436,434,172,262,0.464,0.434,0.394,5410,76.830187,180,943,0.942057942057942
"6634",183062,"Keene State College",1,0,2006,1139,718,421,559,194,365,0.508,0.491,0.461,5780,83.192097,181,1083,0.950834064969271
"6635",183062,"Keene State College",1,0,2007,1295,762,533,666,252,414,0.543,0.514,0.473,6180,89.6953,185,1235,0.953667953667954
"6636",183062,"Keene State College",1,0,2008,1287,777,510,667,238,429,0.552,0.518,0.467,6600,96.352189,185,1226,0.952602952602953
"6637",183062,"Keene State College",1,0,2009,1171,712,459,616,228,388,0.545,0.526,0.497,7000,100.895909,194,1093,0.933390264730999
"6638",183062,"Keene State College",1,0,2010,1201,718,483,643,252,391,0.545,0.535,0.522,7650,106.345869,197,976,0.812656119900083
"6639",183080,"PLYMOUTH STATE COLLEGE",1,0,1991,729,377,352,219,83,136,0.361,0.3,0.236,2716,35.74347,164,655,0.898491083676269
"6640",183080,"PLYMOUTH STATE COLLEGE",1,0,1992,775,403,372,206,79,127,0.315,0.266,0.212,2926,38.268967,162,702,0.905806451612903
"6641",183080,"PLYMOUTH STATE COLLEGE",1,0,1993,748,364,384,163,63,100,0.275,0.218,0.164,3281,40.534131,164,688,0.919786096256685
"6642",183080,"PLYMOUTH STATE COLLEGE",1,0,1995,872,426,446,204,80,124,0.291,0.234,0.179,3754,43.480558,153,820,0.940366972477064
"6643",183080,"PLYMOUTH STATE COLLEGE",1,0,1996,894,433,461,196,87,109,0.252,0.219,0.189,3926,45.947525,159,837,0.936241610738255
"6644",183080,"PLYMOUTH STATE COLLEGE",1,0,1997,844,396,448,163,75,88,0.222,0.193,0.167,4342,47.63226,168,775,0.91824644549763
"6645",183080,"PLYMOUTH STATE COLLEGE",1,0,1998,784,375,409,190,81,109,0.291,0.242,0.198,4780,49.941728,164,715,0.911989795918367
"6646",183080,"PLYMOUTH STATE COLLEGE",1,0,1999,772,377,395,204,75,129,0.342,0.264,0.19,3830,50.716589,161,677,0.876943005181347
"6647",183080,"PLYMOUTH STATE COLLEGE",1,0,2000,902,454,448,241,97,144,0.317,0.267,0.217,4060,52.25032,163.5,836,0.926829268292683
"6648",183080,"PLYMOUTH STATE COLLEGE",1,0,2001,872,463,409,272,89,183,0.395,0.312,0.218,4220,54.478384,166,804,0.922018348623853
"6649",183080,"PLYMOUTH STATE COLLEGE",1,0,2002,940,447,493,279,120,159,0.356,0.297,0.243,4450,55.426387,168,856,0.91063829787234
"6650",183080,"PLYMOUTH STATE UNIVERSITY",1,0,2003,900,469,431,310,134,176,0.375,0.344,0.311,4750,58.280243,171,811,0.901111111111111
"6651",183080,"PLYMOUTH STATE UNIVERSITY",1,0,2004,1052,524,528,356,156,200,0.382,0.338,0.295,5060,62.579417,183,959,0.911596958174905
"6652",183080,"Plymouth State University",1,0,2005,999,473,526,401,193,208,0.44,0.401,0.367,5410,67.493457,181,921,0.921921921921922
"6653",183080,"Plymouth State University",1,0,2006,1008,446,562,402,191,211,0.473,0.399,0.34,5780,75.134403,185,870,0.863095238095238
"6654",183080,"Plymouth State University",1,0,2007,1006,444,562,414,206,208,0.469,0.412,0.367,6180,79.266392,187,788,0.783300198807157
"6655",183080,"Plymouth State University",1,0,2008,1087,500,587,476,214,262,0.524,0.438,0.365,6600,85.026804,188,889,0.817847286108556
"6656",183080,"Plymouth State University",1,0,2009,971,450,521,430,196,234,0.52,0.443,0.376,7000,88.008091,184,835,0.859938208032956
"6657",183080,"Plymouth State University",1,0,2010,1056,520,536,456,186,270,0.519,0.432,0.347,7650,90.421694,187,817,0.773674242424242
"6658",183239,"SAINT ANSELM COLLEGE",1,0,1991,545,303,242,365,155,210,0.693,0.67,0.64,10160,26.985758,114,535,0.981651376146789
"6659",183239,"SAINT ANSELM COLLEGE",1,0,1992,493,274,219,325,141,184,0.672,0.659,0.644,10870,31.031787,113,479,0.971602434077079
"6660",183239,"SAINT ANSELM COLLEGE",1,0,1993,510,284,226,323,128,195,0.687,0.633,0.566,11840,31.441468,109,496,0.972549019607843
"6661",183239,"SAINT ANSELM COLLEGE",1,0,1995,612,369,243,424,163,261,0.707,0.693,0.671,13720,34.987541,108,592,0.967320261437909
"6662",183239,"SAINT ANSELM COLLEGE",1,0,1996,549,301,248,397,172,225,0.748,0.723,0.694,14550,37.023711,113,527,0.959927140255009
"6663",183239,"SAINT ANSELM COLLEGE",1,0,1997,508,283,225,350,134,216,0.763,0.689,0.596,15430,28.366217,115,483,0.950787401574803
"6664",183239,"SAINT ANSELM COLLEGE",1,0,1998,528,296,232,392,159,233,0.787,0.742,0.685,16370,30.086498,120,512,0.96969696969697
"6665",183239,"SAINT ANSELM COLLEGE",1,0,1999,534,280,254,376,160,216,0.771,0.704,0.63,17300,33.041413,113,509,0.953183520599251
"6666",183239,"SAINT ANSELM COLLEGE",1,0,2000,518,280,238,349,142,207,0.739,0.674,0.597,18350,34.734557,116.5,502,0.969111969111969
"6667",183239,"SAINT ANSELM COLLEGE",1,0,2001,535,286,249,363,152,211,0.738,0.679,0.61,19460,37.318927,120,502,0.938317757009346
"6668",183239,"SAINT ANSELM COLLEGE",1,0,2002,570,330,240,406,148,258,0.782,0.712,0.617,20390,40.416054,124,531,0.931578947368421
"6669",183239,"SAINT ANSELM COLLEGE",1,0,2003,587,336,251,418,172,246,0.732,0.712,0.685,21410,43.517344,126,497,0.846678023850085
"6670",183239,"SAINT ANSELM COLLEGE",1,0,2004,516,284,232,370,149,221,0.778,0.717,0.642,22700,45.996291,129,241,0.467054263565891
"6671",183239,"Saint Anselm College",1,0,2005,519,296,223,372,145,227,0.767,0.717,0.65,23990,48.09486,132,410,0.789980732177264
"6672",183239,"Saint Anselm College",1,0,2006,568,343,225,410,151,259,0.755,0.722,0.671,25430,50.782202,135,471,0.829225352112676
"6673",183239,"Saint Anselm College",1,0,2007,568,300,268,404,169,235,0.783,0.711,0.631,26960,53.548968,136,515,0.90669014084507
"6674",183239,"Saint Anselm College",1,0,2008,500,286,214,351,143,208,0.727,0.702,0.668,28440,62.849204,136,454,0.908
"6675",183239,"Saint Anselm College",1,0,2009,528,285,243,372,154,218,0.765,0.705,0.634,29720,64.930081,143,448,0.848484848484849
"6676",183239,"Saint Anselm College",1,0,2010,535,295,240,369,142,227,0.77,0.69,0.592,30760,62.800103,141,455,0.850467289719626
"6677",183822,"BLOOMFIELD COLLEGE",1,0,1991,267,179,88,18,6,12,0.067,0.067,0.068,7450,16.447433,42,67,0.250936329588015
"6678",183822,"BLOOMFIELD COLLEGE",1,0,1992,266,170,96,15,6,9,0.053,0.056,0.062,7750,18.766137,45,66,0.24812030075188
"6679",183822,"BLOOMFIELD COLLEGE",1,0,1993,270,192,78,20,5,15,0.078,0.074,0.064,8050,20.667201,46,78,0.288888888888889
"6680",183822,"BLOOMFIELD COLLEGE",1,0,1995,275,196,79,40,11,29,0.148,0.145,0.139,8850,19.259306,56,63,0.229090909090909
"6681",183822,"BLOOMFIELD COLLEGE",1,0,1996,227,150,77,36,6,30,0.2,0.159,0.078,9100,20.104169,54,41,0.180616740088106
"6682",183822,"BLOOMFIELD COLLEGE",1,0,1997,312,213,99,26,8,18,0.084,0.083,0.081,9500,19.394316,56,52,0.166666666666667
"6683",183822,"BLOOMFIELD COLLEGE",1,0,1998,247,170,77,25,7,18,0.106,0.101,0.091,9900,20.170978,62,20,0.0809716599190283
"6684",183822,"BLOOMFIELD COLLEGE",1,0,1999,242,155,87,13,4,9,0.058,0.054,0.046,10300,21.562216,64,28,0.115702479338843
"6685",183822,"BLOOMFIELD COLLEGE",1,0,2000,236,135,101,13,8,5,0.037,0.055,0.079,10800,23.517672,62,25,0.105932203389831
"6686",183822,"BLOOMFIELD COLLEGE",1,0,2001,250,150,100,41,16,25,0.167,0.164,0.16,11300,25.20845,60,47,0.188
"6687",183822,"BLOOMFIELD COLLEGE",1,0,2002,339,216,123,57,15,42,0.194,0.168,0.122,12100,25.745856,60,42,0.123893805309735
"6688",183822,"BLOOMFIELD COLLEGE",1,0,2003,341,215,126,39,6,33,0.154,0.114,0.048,12900,28.46491,62,44,0.129032258064516
"6689",183822,"BLOOMFIELD COLLEGE",1,0,2004,361,233,128,32,14,18,0.077,0.089,0.109,13700,31.445083,66,53,0.146814404432133
"6690",183822,"Bloomfield College",1,0,2005,367,210,157,37,15,22,0.105,0.101,0.096,14850,29.148146,62,60,0.163487738419619
"6691",183822,"Bloomfield College",1,0,2006,316,183,133,47,18,29,0.158,0.149,0.135,16100,31.737045,69,49,0.15506329113924
"6692",183822,"Bloomfield College",1,0,2007,313,176,137,45,24,21,0.119,0.144,0.175,17500,32.695997,69,47,0.150159744408946
"6693",183822,"Bloomfield College",1,0,2008,392,237,155,23,10,13,0.055,0.059,0.065,19080,33.329673,69,46,0.11734693877551
"6694",183822,"Bloomfield College",1,0,2009,439,278,161,32,16,16,0.058,0.073,0.099,20000,36.004861,68,38,0.0865603644646925
"6695",183822,"Bloomfield College",1,0,2010,379,225,154,44,22,22,0.098,0.116,0.143,21200,38.857628,66,33,0.0870712401055409
"6696",183974,"CENTENARY COLLEGE",1,0,1991,89,66,23,22,3,19,0.288,0.247,0.13,10300,8.685361,31,52,0.584269662921348
"6697",183974,"CENTENARY COLLEGE",1,0,1992,113,86,27,19,4,15,0.174,0.168,0.148,10911,9.304396,35,68,0.601769911504425
"6698",183974,"CENTENARY COLLEGE",1,0,1993,95,77,18,20,2,18,0.234,0.211,0.111,11600,10.605854,36,50,0.526315789473684
"6699",183974,"CENTENARY COLLEGE",1,0,1995,73,53,20,19,3,16,0.302,0.26,0.15,12104,11.754957,38,46,0.63013698630137
"6700",183974,"CENTENARY COLLEGE",1,0,1996,86,63,23,21,0,21,0.333,0.244,0,12608,12.983505,40,42,0.488372093023256
"6701",183974,"CENTENARY COLLEGE",1,0,1997,104,65,39,24,8,16,0.246,0.231,0.205,13120,10.882727,41,24,0.230769230769231
"6702",183974,"CENTENARY COLLEGE",1,0,1998,124,77,47,26,8,18,0.234,0.21,0.17,13730,11.492408,37,41,0.330645161290323
"6703",183974,"CENTENARY COLLEGE",1,0,1999,136,98,38,58,17,41,0.418,0.426,0.447,13800,12.807669,44,69,0.507352941176471
"6704",183974,"CENTENARY COLLEGE",1,0,2000,145,114,31,56,7,49,0.43,0.386,0.226,14500,13.429021,45.5,96,0.662068965517241
"6705",183974,"CENTENARY COLLEGE",1,0,2001,195,141,54,57,6,51,0.362,0.292,0.111,15100,15.942563,47,120,0.615384615384615
"6706",183974,"CENTENARY COLLEGE",1,0,2002,236,147,89,97,27,70,0.476,0.411,0.303,15700,17.598123,49,165,0.699152542372881
"6707",183974,"CENTENARY COLLEGE",1,0,2003,221,126,95,112,47,65,0.516,0.507,0.495,17100,21.360409,47,147,0.665158371040724
"6708",183974,"CENTENARY COLLEGE",1,0,2004,258,169,89,123,38,85,0.503,0.477,0.427,18450,25.088188,53,170,0.65891472868217
"6709",183974,"Centenary College",1,0,2005,240,160,80,115,35,80,0.5,0.479,0.438,19840,29.705,62,172,0.716666666666667
"6710",183974,"Centenary College",1,0,2006,303,211,92,147,41,106,0.502,0.485,0.446,21230,34.646,64,211,0.696369636963696
"6711",183974,"Centenary College",1,0,2007,275,175,100,154,54,100,0.571,0.56,0.54,22930,38.759,67,204,0.741818181818182
"6712",183974,"Centenary College",1,0,2008,310,196,114,188,63,125,0.638,0.606,0.553,23900,42.024,68,227,0.732258064516129
"6713",183974,"Centenary College",1,0,2009,270,165,105,156,50,106,0.642,0.578,0.476,25334,45.444,69,186,0.688888888888889
"6714",183974,"Centenary College",1,0,2010,252,144,108,115,35,80,0.556,0.456,0.324,26854,44.067,72,161,0.638888888888889
"6715",184348,"DREW UNIVERSITY",1,0,1991,269,166,103,188,70,118,0.711,0.699,0.68,16424,46.449,119,184,0.684014869888476
"6716",184348,"DREW UNIVERSITY",1,0,1992,332,203,129,246,92,154,0.759,0.741,0.713,17294,46.759,120,244,0.734939759036145
"6717",184348,"DREW UNIVERSITY",1,0,1993,312,190,122,226,84,142,0.747,0.724,0.689,18058,47.33203,119,224,0.717948717948718
"6718",184348,"DREW UNIVERSITY",1,0,1995,433,255,178,312,122,190,0.745,0.721,0.685,19642,52.506,127,291,0.672055427251732
"6719",184348,"DREW UNIVERSITY",1,0,1996,371,203,168,265,118,147,0.724,0.714,0.702,20402,57.217355,130,240,0.646900269541779
"6720",184348,"DREW UNIVERSITY",1,0,1997,418,243,175,294,117,177,0.728,0.703,0.669,21396,48.617,131,300,0.717703349282297
"6721",184348,"DREW UNIVERSITY",1,0,1998,337,213,124,226,84,142,0.667,0.671,0.677,22232,51.439,145,224,0.664688427299703
"6722",184348,"DREW UNIVERSITY",1,0,1999,407,225,182,279,118,161,0.716,0.686,0.648,22462,52.63,141,249,0.611793611793612
"6723",184348,"DREW UNIVERSITY",1,0,2000,419,265,154,291,98,193,0.728,0.695,0.636,23472,70.612,143.5,283,0.675417661097852
"6724",184348,"DREW UNIVERSITY",1,0,2001,395,254,141,261,89,172,0.677,0.661,0.631,24576,74.467,146,251,0.635443037974683
"6725",184348,"DREW UNIVERSITY",1,0,2002,396,231,165,281,110,171,0.74,0.71,0.667,25800,95.9,147,248,0.626262626262626
"6726",184348,"DREW UNIVERSITY",1,0,2003,419,247,172,289,109,180,0.729,0.69,0.634,27360,63.661,146,276,0.658711217183771
"6727",184348,"DREW UNIVERSITY",1,0,2004,418,243,175,264,98,166,0.683,0.632,0.56,29000,65.576,146,290,0.69377990430622
"6728",184348,"Drew University",1,0,2005,391,218,173,240,103,137,0.628,0.614,0.595,30740,69.644,154,279,0.713554987212276
"6729",184348,"Drew University",1,0,2006,479,316,163,315,103,212,0.671,0.658,0.632,32508,74.003,155,298,0.622129436325679
"6730",184348,"Drew University",1,0,2007,452,268,184,293,107,186,0.694,0.648,0.582,34230,77.213,160,266,0.588495575221239
"6731",184348,"Drew University",1,0,2008,390,256,134,222,75,147,0.574,0.569,0.56,35910,81.378,160,229,0.587179487179487
"6732",184348,"Drew University",1,0,2009,505,296,209,317,114,203,0.686,0.628,0.545,37310,83.519,161,292,0.578217821782178
"6733",184348,"Drew University",1,0,2010,494,311,183,280,96,184,0.592,0.567,0.525,38766,84.488379,164,260,0.526315789473684
"6734",184603,"FAIRLEIGH DICKINSON UNIVERSITY (ALL CAMPUSES)",1,0,1991,908,436,472,78,32,46,0.106,0.086,0.068,10460,103.538907,326,445,0.490088105726872
"6735",184603,"FAIRLEIGH DICKINSON UNIVERSITY (ALL CAMPUSES)",1,0,1992,938,466,472,114,53,61,0.131,0.122,0.112,10483,103.871735,306,455,0.485074626865672
"6736",184603,"FAIRLEIGH DICKINSON UNIVERSITY-ALL CAMPUSES",1,0,1993,860,422,438,128,46,82,0.194,0.149,0.105,11091,112.132754,303,434,0.504651162790698
"6737",184603,"FAIRLEIGH DICKINSON UNIVERSITY-ALL CAMPUSES",1,0,1995,781,396,385,128,57,71,0.179,0.164,0.148,12370,89.049141,285,452,0.578745198463508
"6738",184603,"FAIRLEIGH DICKINSON UNIVERSITY-ALL CAMPUSES",1,0,1996,915,494,421,187,76,111,0.225,0.204,0.181,13404,104.115,265,477,0.521311475409836
"6739",184603,"FAIRLEIGH DICKINSON UNIVERSITY-ALL CAMPUSES",1,0,1997,519,265,254,83,27,56,0.211,0.16,0.106,14126,87.871314,264,179,0.344894026974952
"6740",184603,"FAIRLEIGH DICKINSON UNIVERSITY-ALL CAMPUSES",1,0,1998,566,307,259,90,30,60,0.195,0.159,0.116,14836,89.465698,260,165,0.291519434628975
"6741",184603,"FAIRLEIGH DICKINSON UNIVERSITY-ALL CAMPUSES",1,0,1999,526,281,245,96,31,65,0.231,0.183,0.127,14732,93.667823,262,161,0.306083650190114
"6742",184603,"FAIRLEIGH DICKINSON UNIVERSITY-ALL CAMPUSES",1,0,2000,535,300,235,79,32,47,0.157,0.148,0.136,16346,100.245345,268.5,154,0.28785046728972
"6743",184603,"FAIRLEIGH DICKINSON UNIVERSITY-ALL CAMPUSES",1,0,2001,448,260,188,80,27,53,0.204,0.179,0.144,17474,107.568414,275,116,0.258928571428571
"6744",184603,"FAIRLEIGH DICKINSON UNIVERSITY-ALL CAMPUSES",1,0,2002,474,281,193,87,34,53,0.189,0.184,0.176,18654,114.571209,277,159,0.335443037974684
"6745",184603,"FAIRLEIGH DICKINSON UNIVERSITY-METROPOLITAN CAMPUS",1,0,2003,540,303,237,105,40,65,0.214,0.194,0.169,19854,121.372151,160,189,0.35
"6746",184603,"FAIRLEIGH DICKINSON UNIVERSITY-METROPOLITAN CAMPUS",1,0,2004,504,282,222,150,61,89,0.316,0.298,0.275,21224,131.064467,176,142,0.281746031746032
"6747",184603,"Fairleigh Dickinson University-Metropolitan Campus",1,0,2005,425,269,156,100,31,69,0.256,0.235,0.199,22604,140.349335,169,149,0.350588235294118
"6748",184603,"Fairleigh Dickinson University-Metropolitan Campus",1,0,2006,452,254,198,119,37,82,0.323,0.263,0.187,24072,151.611944,182,156,0.345132743362832
"6749",184603,"Fairleigh Dickinson University-Metropolitan Campus",1,0,2007,400,210,190,117,30,87,0.414,0.292,0.158,25624,165.695194,183,131,0.3275
"6750",184603,"Fairleigh Dickinson University-Metropolitan Campus",1,0,2008,461,276,185,126,39,87,0.315,0.273,0.211,27136,168.425643,185,122,0.264642082429501
"6751",184603,"Fairleigh Dickinson University-Metropolitan Campus",1,0,2009,641,361,280,175,57,118,0.327,0.273,0.204,28194,174.017193,184,129,0.201248049921997
"6752",184603,"Fairleigh Dickinson University-Metropolitan Campus",1,0,2010,694,400,294,133,48,85,0.212,0.192,0.163,30140,181.399474,186,131,0.188760806916427
"6753",184612,"FELICIAN COLLEGE",1,0,1991,93,79,14,9,3,6,0.076,0.097,0.214,6970,5.270013,38,49,0.526881720430108
"6754",184612,"FELICIAN COLLEGE",1,0,1992,116,103,13,16,1,15,0.146,0.138,0.077,7430,6.644367,39,78,0.672413793103448
"6755",184612,"FELICIAN COLLEGE",1,0,1993,129,105,24,10,0,10,0.095,0.078,0,7765,7.938826,44,82,0.635658914728682
"6756",184612,"FELICIAN COLLEGE",1,0,1995,87,70,17,18,9,9,0.129,0.207,0.529,8790,8.812335,47,53,0.609195402298851
"6757",184612,"FELICIAN COLLEGE",1,0,1996,141,92,49,8,3,5,0.054,0.057,0.061,9502,10.41525,48,87,0.617021276595745
"6758",184612,"FELICIAN COLLEGE",1,0,1997,112,94,18,9,0,9,0.096,0.08,0,10038,9.411961,51,65,0.580357142857143
"6759",184612,"FELICIAN COLLEGE",1,0,1998,151,118,33,20,3,17,0.144,0.132,0.091,10542,11.459593,56,70,0.463576158940397
"6760",184612,"FELICIAN COLLEGE",1,0,1999,224,140,84,7,7,0,0,0.031,0.083,10560,14.413596,59,133,0.59375
"6761",184612,"FELICIAN COLLEGE",1,0,2000,219,173,46,46,7,39,0.225,0.21,0.152,11010,18.003612,63.5,129,0.589041095890411
"6762",184612,"FELICIAN COLLEGE",1,0,2001,272,188,84,46,9,37,0.197,0.169,0.107,11460,21.311917,68,134,0.492647058823529
"6763",184612,"FELICIAN COLLEGE",1,0,2002,208,151,57,45,8,37,0.245,0.216,0.14,12450,19.95,70,94,0.451923076923077
"6764",184612,"FELICIAN COLLEGE",1,0,2003,218,158,60,33,10,23,0.146,0.151,0.167,14500,19.326725,70,111,0.509174311926605
"6765",184612,"FELICIAN COLLEGE",1,0,2004,232,170,62,38,13,25,0.147,0.164,0.21,15900,20.539201,73,114,0.491379310344828
"6766",184612,"Felician College",1,0,2005,236,163,73,38,13,25,0.153,0.161,0.178,17300,22.660946,83,101,0.427966101694915
"6767",184612,"Felician College",1,0,2006,251,172,79,58,20,38,0.221,0.231,0.253,18900,25.894277,81,93,0.370517928286853
"6768",184612,"Felician College",1,0,2007,294,213,81,72,18,54,0.254,0.245,0.222,20500,27.482225,95,106,0.360544217687075
"6769",184612,"Felician College",1,0,2008,245,170,75,42,9,33,0.194,0.171,0.12,22200,32.575787,102,90,0.36734693877551
"6770",184612,"Felician College",1,0,2009,251,172,79,46,17,29,0.169,0.183,0.215,23650,36.615729,112,71,0.282868525896414
"6771",184612,"Felician College",1,0,2010,324,236,88,66,21,45,0.191,0.204,0.239,24950,37.707512,114,90,0.277777777777778
"6772",184782,"GLASSBORO STATE COLLEGE",1,0,1991,892,511,381,212,77,135,0.264,0.238,0.202,2715,75.055196,278,646,0.724215246636771
"6773",184782,"ROWAN COLLEGE OF NEW JERSEY",1,0,1992,771,453,318,154,46,108,0.238,0.2,0.145,2870,80.524902,286,568,0.736705577172503
"6774",184782,"ROWAN COLLEGE OF NEW JERSEY",1,0,1993,713,408,305,152,43,109,0.267,0.213,0.141,2843,83.717828,292,489,0.685834502103787
"6775",184782,"ROWAN COLLEGE OF NEW JERSEY",1,0,1995,927,516,411,226,69,157,0.304,0.244,0.168,3393,90.648498,324,702,0.757281553398058
"6776",184782,"ROWAN COLLEGE OF NEW JERSEY",1,0,1996,1132,609,523,414,173,241,0.396,0.366,0.331,3750,93.800961,320,931,0.82243816254417
"6777",184782,"ROWAN UNIVERSITY",1,0,1997,1038,552,486,321,119,202,0.366,0.309,0.245,4240,98.958292,336,814,0.784200385356455
"6778",184782,"ROWAN UNIVERSITY",1,0,1998,1118,624,494,414,160,254,0.407,0.37,0.324,4550,111.543814,364,868,0.776386404293381
"6779",184782,"ROWAN UNIVERSITY",1,0,1999,1119,587,532,436,183,253,0.431,0.39,0.344,3750,121.968222,360,910,0.813226094727435
"6780",184782,"ROWAN UNIVERSITY",1,0,2000,1053,561,492,444,173,271,0.483,0.422,0.352,4140,133.950554,372.5,819,0.777777777777778
"6781",184782,"ROWAN UNIVERSITY",1,0,2001,1276,680,596,498,201,297,0.437,0.39,0.337,4500,141.502198,385,1021,0.800156739811912
"6782",184782,"ROWAN UNIVERSITY",1,0,2002,1257,637,620,542,224,318,0.499,0.431,0.361,4950,135.116042,369,1019,0.81066030230708
"6783",184782,"ROWAN UNIVERSITY",1,0,2003,1243,600,643,588,265,323,0.538,0.473,0.412,5396,132.141705,403,1032,0.830249396621078
"6784",184782,"ROWAN UNIVERSITY",1,0,2004,1247,622,625,546,255,291,0.468,0.438,0.408,5828,146.912281,434,970,0.777866880513232
"6785",184782,"Rowan University",1,0,2005,1239,607,632,554,270,284,0.468,0.447,0.427,6294,161.577298,441,987,0.796610169491525
"6786",184782,"Rowan University",1,0,2006,1216,602,614,593,271,322,0.535,0.488,0.441,6798,175.350947,436,925,0.760690789473684
"6787",184782,"Rowan University",1,0,2007,1226,506,720,561,301,260,0.514,0.458,0.418,7308,188.136461,407,1053,0.858890701468189
"6788",184782,"Rowan University",1,0,2008,1174,516,658,502,269,233,0.452,0.428,0.409,7840,201.396211,407,965,0.821976149914821
"6789",184782,"Rowan University",1,0,2009,1586,738,848,677,344,333,0.451,0.427,0.406,8074,218.443969,401,1209,0.762295081967213
"6790",184782,"Rowan University",1,0,2010,1485,715,770,713,320,393,0.55,0.48,0.416,8396,216.593002,395,1110,0.747474747474748
"6791",185129,"JERSEY CITY STATE COLLEGE",1,0,1991,618,322,296,34,17,17,0.053,0.055,0.057,2422,55.322,245,264,0.427184466019417
"6792",185129,"JERSEY CITY STATE COLLEGE",1,0,1992,663,324,339,28,16,12,0.037,0.042,0.047,2678,61.366,241,294,0.443438914027149
"6793",185129,"JERSEY CITY STATE COLLEGE",1,0,1993,514,276,238,27,11,16,0.058,0.053,0.046,2798,61.479,237,254,0.494163424124514
"6794",185129,"JERSEY CITY STATE COLLEGE",1,0,1995,457,246,211,40,11,29,0.118,0.088,0.052,3157,70.071,243,193,0.422319474835886
"6795",185129,"JERSEY CITY STATE COLLEGE",1,0,1996,531,283,248,32,10,22,0.078,0.06,0.04,3528,69.493572,248,196,0.369114877589454
"6796",185129,"JERSEY CITY STATE COLLEGE",1,0,1997,455,237,218,34,13,21,0.089,0.075,0.06,3828,75.856757,235,184,0.404395604395604
"6797",185129,"NEW JERSEY CITY COLLEGE",1,0,1998,549,305,244,40,13,27,0.088,0.073,0.053,4113,79.577972,237,203,0.36976320582878
"6798",185129,"NEW JERSEY CITY UNIVERSITY",1,0,1999,603,331,272,54,18,36,0.109,0.09,0.066,3330,85.541374,240,239,0.396351575456053
"6799",185129,"NEW JERSEY CITY UNIVERSITY",1,0,2000,661,357,304,46,20,26,0.073,0.07,0.066,3540,91.389483,242.5,271,0.409984871406959
"6800",185129,"NEW JERSEY CITY UNIVERSITY",1,0,2001,540,304,236,43,14,29,0.095,0.08,0.059,3810,97.02307,245,176,0.325925925925926
"6801",185129,"NEW JERSEY CITY UNIVERSITY",1,0,2002,566,293,273,34,9,25,0.085,0.06,0.033,4185,94.890349,238,199,0.351590106007067
"6802",185129,"NEW JERSEY CITY UNIVERSITY",1,0,2003,652,380,272,49,15,34,0.09,0.075,0.055,4560,93.23617,233,215,0.329754601226994
"6803",185129,"NEW JERSEY CITY UNIVERSITY",1,0,2004,512,300,212,40,12,28,0.093,0.078,0.057,4860,100.584012,241,145,0.283203125
"6804",185129,"New Jersey City University",1,0,2005,601,334,267,39,17,22,0.066,0.065,0.064,5190,107.492351,251,179,0.29783693843594
"6805",185129,"New Jersey City University",1,0,2006,646,379,267,45,13,32,0.084,0.07,0.049,5600,116.135129,242,156,0.241486068111455
"6806",185129,"New Jersey City University",1,0,2007,649,340,309,32,16,16,0.047,0.049,0.052,5936,119.830543,248,143,0.220338983050847
"6807",185129,"New Jersey City University",1,0,2008,563,306,257,42,19,23,0.075,0.075,0.074,6352,127.419559,238,113,0.200710479573712
"6808",185129,"New Jersey City University",1,0,2009,634,358,276,32,12,20,0.056,0.05,0.043,6542,132.502397,246,152,0.239747634069401
"6809",185129,"New Jersey City University",1,0,2010,681,380,301,45,21,24,0.063,0.066,0.07,6804,137.512799,242,145,0.212922173274596
"6810",185572,"MONMOUTH COLLEGE",1,0,1991,387,216,171,74,23,51,0.236,0.191,0.135,10700,43.839104,152,336,0.868217054263566
"6811",185572,"MONMOUTH COLLEGE",1,0,1992,436,230,206,94,39,55,0.239,0.216,0.189,11160,45.918452,142,360,0.825688073394495
"6812",185572,"MONMOUTH COLLEGE",1,0,1993,477,220,257,94,43,51,0.232,0.197,0.167,11820,46.970972,125,382,0.80083857442348
"6813",185572,"MONMOUTH UNIVERSITY",1,0,1995,764,412,352,234,82,152,0.369,0.306,0.233,13140,62.835727,157,634,0.829842931937173
"6814",185572,"MONMOUTH UNIVERSITY",1,0,1996,799,411,388,261,99,162,0.394,0.327,0.255,13800,72.600781,173,653,0.817271589486859
"6815",185572,"MONMOUTH UNIVERSITY",1,0,1997,801,432,369,264,87,177,0.41,0.33,0.236,14442,59.541851,187,640,0.799001248439451
"6816",185572,"MONMOUTH UNIVERSITY",1,0,1998,834,429,405,253,98,155,0.361,0.303,0.242,15068,65.294243,190,661,0.792565947242206
"6817",185572,"MONMOUTH UNIVERSITY",1,0,1999,833,457,376,295,99,196,0.429,0.354,0.263,15138,69.368578,197,644,0.773109243697479
"6818",185572,"MONMOUTH UNIVERSITY",1,0,2000,1033,529,504,377,142,235,0.444,0.365,0.282,15758,74.312782,204,863,0.835430784123911
"6819",185572,"MONMOUTH UNIVERSITY",1,0,2001,881,484,397,339,125,214,0.442,0.385,0.315,16506,80.893566,211,708,0.803632236095346
"6820",185572,"MONMOUTH UNIVERSITY",1,0,2002,948,521,427,351,116,235,0.451,0.37,0.272,17332,81.763337,229,788,0.831223628691983
"6821",185572,"MONMOUTH UNIVERSITY",1,0,2003,904,484,420,358,125,233,0.481,0.396,0.298,18198,90.000228,241,757,0.837389380530973
"6822",185572,"MONMOUTH UNIVERSITY",1,0,2004,946,514,432,341,120,221,0.43,0.36,0.278,19108,97.353202,237,727,0.768498942917548
"6823",185572,"Monmouth University",1,0,2005,942,503,439,436,176,260,0.517,0.463,0.401,20064,101.668061,254,738,0.78343949044586
"6824",185572,"Monmouth University",1,0,2006,959,535,424,425,168,257,0.48,0.443,0.396,21248,109.660183,244,747,0.778936392075078
"6825",185572,"Monmouth University",1,0,2007,944,538,406,393,165,228,0.424,0.416,0.406,22406,116.647221,251,753,0.797669491525424
"6826",185572,"Monmouth University",1,0,2008,960,549,411,473,187,286,0.521,0.493,0.455,23470,125.14237,247,795,0.828125
"6827",185572,"Monmouth University",1,0,2009,998,581,417,504,191,313,0.539,0.505,0.458,24386,130.7141,248,818,0.819639278557114
"6828",185572,"Monmouth University",1,0,2010,962,579,383,532,196,336,0.58,0.553,0.512,25728,136.952114,253,764,0.794178794178794
"6829",185590,"MONTCLAIR STATE COLLEGE",1,0,1991,913,564,349,101,31,70,0.124,0.111,0.089,2612,89.154769,429,544,0.595837897042716
"6830",185590,"MONTCLAIR STATE COLLEGE",1,0,1992,913,530,383,106,32,74,0.14,0.116,0.084,2686,98.565652,420,560,0.613362541073384
"6831",185590,"MONTCLAIR STATE COLLEGE",1,0,1993,868,531,337,117,34,83,0.156,0.135,0.101,2844,99.014206,419,523,0.602534562211982
"6832",185590,"MONTCLAIR STATE UNIVERSITY",1,0,1995,1068,651,417,216,69,147,0.226,0.202,0.165,3162,110.016841,421,662,0.619850187265918
"6833",185590,"MONTCLAIR STATE UNIVERSITY",1,0,1996,1194,706,488,243,64,179,0.254,0.204,0.131,3466,116.626708,444,746,0.624790619765494
"6834",185590,"MONTCLAIR STATE UNIVERSITY",1,0,1997,1148,709,439,230,62,168,0.237,0.2,0.141,3738,122.614618,472,648,0.564459930313589
"6835",185590,"MONTCLAIR STATE UNIVERSITY",1,0,1998,1106,660,446,252,60,192,0.291,0.228,0.135,4120,129.617925,442,637,0.575949367088608
"6836",185590,"MONTCLAIR STATE UNIVERSITY",1,0,1999,1319,823,496,308,81,227,0.276,0.234,0.163,3154,136.441827,444,747,0.56633813495072
"6837",185590,"MONTCLAIR STATE UNIVERSITY",1,0,2000,1324,827,497,351,96,255,0.308,0.265,0.193,3470,147.141801,442.5,776,0.586102719033233
"6838",185590,"MONTCLAIR STATE UNIVERSITY",1,0,2001,1378,826,552,371,102,269,0.326,0.269,0.185,4071,159.732583,441,785,0.56966618287373
"6839",185590,"MONTCLAIR STATE UNIVERSITY",1,0,2002,1470,881,589,410,117,293,0.333,0.279,0.199,4390,152.729511,434,925,0.629251700680272
"6840",185590,"MONTCLAIR STATE UNIVERSITY",1,0,2003,1594,934,660,471,134,337,0.361,0.295,0.203,4785,158.655987,453,972,0.609786700125471
"6841",185590,"MONTCLAIR STATE UNIVERSITY",1,0,2004,1737,1015,722,534,164,370,0.365,0.307,0.227,5168,168.751328,462,1056,0.607944732297064
"6842",185590,"Montclair State University",1,0,2005,1868,1065,803,635,188,447,0.42,0.34,0.234,5581,197.185,474,1146,0.613490364025696
"6843",185590,"Montclair State University",1,0,2006,2018,1197,821,702,214,488,0.408,0.348,0.261,6028,232.445,491,1261,0.624876114965312
"6844",185590,"Montclair State University",1,0,2007,2068,1276,792,711,205,506,0.397,0.344,0.259,6390,240.676,509,1174,0.567698259187621
"6845",185590,"Montclair State University",1,0,2008,2257,1365,892,817,230,587,0.43,0.362,0.258,6836,263.488,524,1190,0.527248560035445
"6846",185590,"Montclair State University",1,0,2009,2100,1284,816,757,219,538,0.419,0.36,0.268,7042,272.629,553,1069,0.509047619047619
"6847",185590,"Montclair State University",1,0,2010,2169,1248,921,850,304,546,0.438,0.392,0.33,7324,288.712,569,1079,0.497464269248502
"6848",185828,"NEW JERSEY INSTITUTE OF TECHNOLOGY",1,0,1991,541,96,445,30,18,12,0.125,0.055,0.04,4288,105.11,319,236,0.436229205175601
"6849",185828,"NEW JERSEY INSTITUTE OF TECHNOLOGY",1,0,1992,501,75,426,34,25,9,0.12,0.068,0.059,4524,108.124,327,247,0.493013972055888
"6850",185828,"NEW JERSEY INSTITUTE OF TECHNOLOGY",1,0,1993,476,90,386,33,22,11,0.122,0.069,0.057,4790,116.154,308,226,0.474789915966387
"6851",185828,"NEW JERSEY INSTITUTE OF TECHNOLOGY",1,0,1995,552,131,421,60,35,25,0.191,0.109,0.083,5220,130.982,348,263,0.476449275362319
"6852",185828,"NEW JERSEY INSTITUTE OF TECHNOLOGY",1,0,1996,599,116,483,60,39,21,0.181,0.1,0.081,5466,144.24,354,295,0.492487479131886
"6853",185828,"NEW JERSEY INSTITUTE OF TECHNOLOGY",1,0,1997,568,105,463,88,73,15,0.143,0.155,0.158,5802,146.382,358,276,0.485915492957746
"6854",185828,"NEW JERSEY INSTITUTE OF TECHNOLOGY",1,0,1998,563,120,443,93,64,29,0.242,0.165,0.144,6214,156.345,362,254,0.451154529307282
"6855",185828,"NEW JERSEY INSTITUTE OF TECHNOLOGY",1,0,1999,649,114,535,116,88,28,0.246,0.179,0.164,5508,163.074,380,261,0.402157164869029
"6856",185828,"NEW JERSEY INSTITUTE OF TECHNOLOGY",1,0,2000,685,117,568,130,98,32,0.274,0.19,0.173,5758,174.948,426.5,285,0.416058394160584
"6857",185828,"NEW JERSEY INSTITUTE OF TECHNOLOGY",1,0,2001,706,129,577,102,70,32,0.248,0.144,0.121,6158,190.815,473,297,0.420679886685552
"6858",185828,"NEW JERSEY INSTITUTE OF TECHNOLOGY",1,0,2002,658,113,545,106,81,25,0.221,0.161,0.149,6758,193.4,408,249,0.378419452887538
"6859",185828,"NEW JERSEY INSTITUTE OF TECHNOLOGY",1,0,2003,685,119,566,118,92,26,0.219,0.172,0.163,7332,195.04,458,283,0.413138686131387
"6860",185828,"NEW JERSEY INSTITUTE OF TECHNOLOGY",1,0,2004,663,130,533,108,74,34,0.262,0.163,0.139,7918,197.553,413,263,0.396681749622926
"6861",185828,"New Jersey Institute of Technology",1,0,2005,746,129,617,126,101,25,0.194,0.169,0.164,8472,209.857,403,295,0.39544235924933
"6862",185828,"New Jersey Institute of Technology",1,0,2006,795,146,649,150,102,48,0.329,0.189,0.157,9066,212.127,389,324,0.407547169811321
"6863",185828,"New Jersey Institute of Technology",1,0,2007,730,148,582,171,117,54,0.365,0.234,0.201,9700,224.519,382,300,0.410958904109589
"6864",185828,"New Jersey Institute of Technology",1,0,2008,779,158,621,185,136,49,0.31,0.237,0.219,10500,234.012,387,326,0.418485237483954
"6865",185828,"New Jersey Institute of Technology",1,0,2009,899,169,730,212,151,61,0.361,0.236,0.207,10816,240.866,406,370,0.411568409343715
"6866",185828,"New Jersey Institute of Technology",1,0,2010,828,187,641,209,141,68,0.364,0.252,0.22,11248,238.208,398,200,0.241545893719807
"6867",186131,"PRINCETON UNIVERSITY",1,0,1991,1122,474,648,1002,582,420,0.886,0.893,0.898,16570,451.601,704,794,0.707664884135472
"6868",186131,"PRINCETON UNIVERSITY",1,0,1992,1135,516,619,1023,544,479,0.928,0.901,0.879,17750,496.8,709,842,0.741850220264317
"6869",186131,"PRINCETON UNIVERSITY",1,0,1993,1152,514,638,1032,563,469,0.912,0.896,0.882,18940,514.829,702,816,0.708333333333333
"6870",186131,"PRINCETON UNIVERSITY",1,0,1995,1207,569,638,1105,579,526,0.924,0.915,0.908,20960,509.39,712,800,0.662800331400166
"6871",186131,"PRINCETON UNIVERSITY",1,0,1996,1123,525,598,1032,540,492,0.937,0.919,0.903,22000,534.988352,691,747,0.665182546749777
"6872",186131,"PRINCETON UNIVERSITY",1,0,1997,1129,511,618,1033,562,471,0.922,0.915,0.909,22920,501.779,689,798,0.70682019486271
"6873",186131,"PRINCETON UNIVERSITY",1,0,1998,1167,560,607,1000,495,505,0.902,0.857,0.815,23820,501.299,699,788,0.675235646958012
"6874",186131,"PRINCETON UNIVERSITY",1,0,1999,1148,556,592,1030,530,500,0.899,0.897,0.895,24630,536.994,717,790,0.68815331010453
"6875",186131,"PRINCETON UNIVERSITY",1,0,2000,1159,569,590,1031,503,528,0.928,0.89,0.853,25430,581.666,742.5,757,0.653149266609146
"6876",186131,"PRINCETON UNIVERSITY",1,0,2001,1184,570,614,1051,526,525,0.921,0.888,0.857,26160,639.664,768,757,0.639358108108108
"6877",186131,"PRINCETON UNIVERSITY",1,0,2002,1164,557,607,1049,542,507,0.91,0.901,0.893,27230,692.922,798,737,0.633161512027491
"6878",186131,"PRINCETON UNIVERSITY",1,0,2003,1161,539,622,1044,549,495,0.918,0.899,0.883,28540,725.705,797,734,0.632213608957795
"6879",186131,"PRINCETON UNIVERSITY",1,0,2004,1170,548,622,1054,549,505,0.922,0.901,0.883,29910,789.489,801,729,0.623076923076923
"6880",186131,"Princeton University",1,0,2005,1224,558,666,1066,562,504,0.903,0.871,0.844,31450,835.031,807,709,0.579248366013072
"6881",186131,"Princeton University",1,0,2006,1228,576,652,1078,561,517,0.898,0.878,0.86,33000,927.942,826,603,0.491042345276873
"6882",186131,"Princeton University",1,0,2007,1243,593,650,1091,553,538,0.907,0.878,0.851,33000,981.281,824,592,0.476267095736122
"6883",186131,"Princeton University",1,0,2008,1243,620,623,1121,545,576,0.929,0.902,0.875,34290,1050.818,848,610,0.490748189863234
"6884",186131,"Princeton University",1,0,2009,1297,643,654,1164,568,596,0.927,0.897,0.869,35340,1161.66,847,635,0.489591364687741
"6885",186131,"Princeton University",1,0,2010,1311,649,662,1169,572,597,0.92,0.892,0.864,36640,1235.024,844,653,0.498093058733791
"6886",186201,"RAMAPO COLLEGE OF NEW JERSEY",1,0,1991,423,205,218,55,17,38,0.185,0.13,0.078,2893,37.032,130,279,0.659574468085106
"6887",186201,"RAMAPO COLLEGE OF NEW JERSEY",1,0,1992,419,216,203,77,25,52,0.241,0.184,0.123,3024,41.103,131,290,0.692124105011933
"6888",186201,"RAMAPO COLLEGE OF NEW JERSEY",1,0,1993,361,199,162,62,21,41,0.206,0.172,0.13,3226,45.83,131,235,0.650969529085873
"6889",186201,"RAMAPO COLLEGE OF NEW JERSEY",1,0,1995,319,190,129,67,20,47,0.247,0.21,0.155,3521,44.338,132,190,0.595611285266458
"6890",186201,"RAMAPO COLLEGE OF NEW JERSEY",1,0,1996,413,240,173,101,29,72,0.3,0.245,0.168,3872,49.687,138,273,0.661016949152542
"6891",186201,"RAMAPO COLLEGE OF NEW JERSEY",1,0,1997,453,228,225,125,53,72,0.316,0.276,0.236,4206,50.965,141,331,0.730684326710817
"6892",186201,"RAMAPO COLLEGE OF NEW JERSEY",1,0,1998,472,271,201,169,56,113,0.417,0.358,0.279,4616,53.692,142,343,0.726694915254237
"6893",186201,"RAMAPO COLLEGE OF NEW JERSEY",1,0,1999,527,293,234,201,66,135,0.461,0.381,0.282,3822,61.225,142,380,0.721062618595825
"6894",186201,"RAMAPO COLLEGE OF NEW JERSEY",1,0,2000,636,392,244,282,87,195,0.497,0.443,0.357,4166,67.865,149.5,496,0.779874213836478
"6895",186201,"RAMAPO COLLEGE OF NEW JERSEY",1,0,2001,628,382,246,303,99,204,0.534,0.482,0.402,4416,71.504,157,474,0.754777070063694
"6896",186201,"RAMAPO COLLEGE OF NEW JERSEY",1,0,2002,684,420,264,363,109,254,0.605,0.531,0.413,4836,74.112,170,522,0.763157894736842
"6897",186201,"RAMAPO COLLEGE OF NEW JERSEY",1,0,2003,719,423,296,439,165,274,0.648,0.611,0.557,5270,82.517,171,570,0.792767732962448
"6898",186201,"RAMAPO COLLEGE OF NEW JERSEY",1,0,2004,746,451,295,486,165,321,0.712,0.651,0.559,5640,89.619,179,580,0.777479892761394
"6899",186201,"Ramapo College of New Jersey",1,0,2005,746,460,286,445,137,308,0.67,0.597,0.479,6091,95.171,187,564,0.756032171581769
"6900",186201,"Ramapo College of New Jersey",1,0,2006,811,475,336,488,182,306,0.644,0.602,0.542,6579,103.455,192,591,0.728729963008631
"6901",186201,"Ramapo College of New Jersey",1,0,2007,898,519,379,527,181,346,0.667,0.587,0.478,6904,109.139,197,694,0.7728285077951
"6902",186201,"Ramapo College of New Jersey",1,0,2008,877,513,364,511,177,334,0.651,0.583,0.486,7459,120.284,199,662,0.75484606613455
"6903",186201,"Ramapo College of New Jersey",1,0,2009,933,575,358,559,165,394,0.685,0.599,0.461,7683,128.645,213,702,0.752411575562701
"6904",186201,"Ramapo College of New Jersey",1,0,2010,893,522,371,547,188,359,0.688,0.613,0.507,7805,127.432,216,674,0.754759238521836
"6905",186283,"RIDER COLLEGE",1,0,1991,653,351,302,259,98,161,0.459,0.397,0.325,11010,58.24102,207,516,0.790199081163859
"6906",186283,"RIDER COLLEGE",1,0,1992,731,402,329,305,113,192,0.478,0.417,0.343,12010,60.850079,207,577,0.789329685362517
"6907",186283,"RIDER COLLEGE",1,0,1993,663,376,287,267,104,163,0.434,0.403,0.362,12860,70.190666,208,515,0.776772247360483
"6908",186283,"RIDER UNIVERSITY",1,0,1995,612,329,283,242,103,139,0.422,0.395,0.364,13800,76.790175,222,465,0.759803921568627
"6909",186283,"RIDER UNIVERSITY",1,0,1996,678,394,284,311,113,198,0.503,0.459,0.398,14400,78.222596,220,504,0.743362831858407
"6910",186283,"RIDER UNIVERSITY",1,0,1997,751,435,316,340,135,205,0.471,0.453,0.427,15120,64.64602,220,577,0.768308921438083
"6911",186283,"RIDER UNIVERSITY",1,0,1998,869,483,386,419,161,258,0.534,0.482,0.417,15880,67.190919,227,666,0.766398158803222
"6912",186283,"RIDER UNIVERSITY",1,0,1999,735,386,349,310,128,182,0.472,0.422,0.367,16520,71.197279,220,560,0.761904761904762
"6913",186283,"RIDER UNIVERSITY",1,0,2000,884,504,380,399,152,247,0.49,0.451,0.4,17180,75.508509,220,680,0.769230769230769
"6914",186283,"RIDER UNIVERSITY",1,0,2001,839,472,367,361,143,218,0.462,0.43,0.39,17990,79.258535,220,600,0.715137067938021
"6915",186283,"RIDER UNIVERSITY",1,0,2002,958,542,416,439,173,266,0.491,0.458,0.416,19240,82.217194,229,754,0.78705636743215
"6916",186283,"RIDER UNIVERSITY",1,0,2003,944,575,369,443,154,289,0.503,0.469,0.417,20590,90.087516,232,735,0.778601694915254
"6917",186283,"RIDER UNIVERSITY",1,0,2004,890,514,376,456,190,266,0.517,0.512,0.505,21820,94.567689,235,663,0.744943820224719
"6918",186283,"Rider University",1,0,2005,934,526,408,482,183,299,0.568,0.516,0.449,22910,98.411326,231,727,0.778372591006424
"6919",186283,"Rider University",1,0,2006,1016,619,397,576,206,370,0.598,0.567,0.519,24220,107.704031,235,799,0.786417322834646
"6920",186283,"Rider University",1,0,2007,990,569,421,547,201,346,0.608,0.553,0.477,25650,116.077,241,750,0.757575757575758
"6921",186283,"Rider University",1,0,2008,875,516,359,460,167,293,0.568,0.526,0.465,27140,128.262,243,608,0.694857142857143
"6922",186283,"Rider University",1,0,2009,1027,611,416,557,216,341,0.558,0.542,0.519,28470,135.221,242,678,0.660175267770205
"6923",186283,"Rider University",1,0,2010,1007,601,406,585,227,358,0.596,0.581,0.559,29870,145.318,249,744,0.738828202581926
"6924",186584,"SETON HALL UNIVERSITY",1,0,1991,984,474,510,429,184,245,0.517,0.436,0.361,10450,112.822,336,668,0.678861788617886
"6925",186584,"SETON HALL UNIVERSITY",1,0,1992,985,484,501,384,161,223,0.461,0.39,0.321,10960,123.61,348,649,0.658883248730964
"6926",186584,"SETON HALL UNIVERSITY",1,0,1993,996,522,474,376,142,234,0.448,0.378,0.3,11380,132.985,348,650,0.652610441767068
"6927",186584,"SETON HALL UNIVERSITY",1,0,1995,955,527,428,371,145,226,0.429,0.388,0.339,12250,138.778,341,561,0.587434554973822
"6928",186584,"SETON HALL UNIVERSITY",1,0,1996,968,547,421,349,112,237,0.433,0.361,0.266,12850,142.683,340,548,0.566115702479339
"6929",186584,"SETON HALL UNIVERSITY",1,0,1997,1056,547,509,409,157,252,0.461,0.387,0.308,13600,130.819,338,627,0.59375
"6930",186584,"SETON HALL UNIVERSITY",1,0,1998,1221,657,564,486,173,313,0.476,0.398,0.307,15680,133.979,354,694,0.568386568386568
"6931",186584,"SETON HALL UNIVERSITY",1,0,1999,1063,533,530,437,190,247,0.463,0.411,0.358,15480,148.616,376,588,0.553151458137347
"6932",186584,"SETON HALL UNIVERSITY",1,0,2000,1121,581,540,464,186,278,0.479,0.414,0.344,16410,162.143,377.5,537,0.479036574487065
"6933",186584,"SETON HALL UNIVERSITY",1,0,2001,1182,601,581,495,210,285,0.474,0.419,0.361,17400,166.966,379,636,0.538071065989848
"6934",186584,"SETON HALL UNIVERSITY",1,0,2002,1157,607,550,523,232,291,0.479,0.452,0.422,18780,179.347,393,620,0.535868625756266
"6935",186584,"SETON HALL UNIVERSITY",1,0,2003,1241,616,625,620,301,319,0.518,0.5,0.482,19530,184.11,404,716,0.576954069298952
"6936",186584,"SETON HALL UNIVERSITY",1,0,2004,1234,672,562,626,269,357,0.531,0.507,0.479,20490,195.78,426,667,0.540518638573744
"6937",186584,"Seton Hall University",1,0,2005,1115,582,533,576,236,340,0.584,0.517,0.443,21510,202.06,441,626,0.561434977578475
"6938",186584,"Seton Hall University",1,0,2006,1054,602,452,574,231,343,0.57,0.545,0.511,22770,211.406,449,547,0.518975332068311
"6939",186584,"Seton Hall University",1,0,2007,1256,664,592,631,277,354,0.533,0.502,0.468,25900,215.778,432,727,0.578821656050955
"6940",186584,"Seton Hall University",1,0,2008,1216,688,528,687,282,405,0.589,0.565,0.534,27680,239.05,452,705,0.579769736842105
"6941",186584,"Seton Hall University",1,0,2009,1124,659,465,570,232,338,0.513,0.507,0.499,28520,244.242,460,580,0.516014234875445
"6942",186584,"Seton Hall University",1,0,2010,1302,728,574,708,288,420,0.577,0.544,0.502,29940,247.765,446,704,0.540706605222734
"6943",186876,"STOCKTON STATE COLLEGE",1,0,1991,683,364,319,194,64,130,0.357,0.284,0.201,2456,44.071393,175,526,0.7701317715959
"6944",186876,"STOCKTON STATE COLLEGE",1,0,1992,720,401,319,174,70,104,0.259,0.242,0.219,2657,46.473435,174,598,0.830555555555556
"6945",186876,"THE RICHARD STOCKTON COLLEGE OF NEW JERSEY",1,0,1993,709,369,340,193,77,116,0.314,0.272,0.226,2880,48.400486,178,576,0.812411847672779
"6946",186876,"THE RICHARD STOCKTON COLLEGE OF NEW JERSEY",1,0,1995,726,438,288,258,86,172,0.393,0.355,0.299,3152,53.871504,176,605,0.833333333333333
"6947",186876,"THE RICHARD STOCKTON COLLEGE OF NEW JERSEY",1,0,1996,705,404,301,278,110,168,0.416,0.394,0.365,3472,60.26846,186,555,0.787234042553192
"6948",186876,"THE RICHARD STOCKTON COLLEGE OF NEW JERSEY",1,0,1997,700,415,285,283,93,190,0.458,0.404,0.326,3776,63.523319,193,555,0.792857142857143
"6949",186876,"THE RICHARD STOCKTON COLLEGE OF NEW JERSEY",1,0,1998,744,420,324,321,116,205,0.488,0.431,0.358,4144,67.258243,189,593,0.797043010752688
"6950",186876,"THE RICHARD STOCKTON COLLEGE OF NEW JERSEY",1,0,1999,705,409,296,254,86,168,0.411,0.36,0.291,3280,70.543865,199,547,0.775886524822695
"6951",186876,"THE RICHARD STOCKTON COLLEGE OF NEW JERSEY",1,0,2000,728,431,297,296,96,200,0.464,0.407,0.323,3600,79.180184,202,589,0.809065934065934
"6952",186876,"THE RICHARD STOCKTON COLLEGE OF NEW JERSEY",1,0,2001,751,424,327,335,122,213,0.502,0.446,0.373,3952,85.82285,205,612,0.81491344873502
"6953",186876,"THE RICHARD STOCKTON COLLEGE OF NEW JERSEY",1,0,2002,794,436,358,338,131,207,0.475,0.426,0.366,4352,84.642597,216,674,0.848866498740554
"6954",186876,"THE RICHARD STOCKTON COLLEGE OF NEW JERSEY",1,0,2003,816,439,377,319,119,200,0.456,0.391,0.316,4736,97.062955,219,698,0.855392156862745
"6955",186876,"THE RICHARD STOCKTON COLLEGE OF NEW JERSEY",1,0,2004,819,435,384,331,127,204,0.469,0.404,0.331,5091,93.543934,227,686,0.837606837606838
"6956",186876,"The Richard Stockton College of New Jersey",1,0,2005,808,460,348,346,104,242,0.526,0.428,0.299,5498,98.511959,242,653,0.808168316831683
"6957",186876,"The Richard Stockton College of New Jersey",1,0,2006,791,425,366,319,123,196,0.461,0.403,0.336,5938,116.058964,252,631,0.797724399494311
"6958",186876,"The Richard Stockton College of New Jersey",1,0,2007,794,480,314,335,93,242,0.504,0.422,0.296,6353,127.298074,259,613,0.772040302267002
"6959",186876,"The Richard Stockton College of New Jersey",1,0,2008,840,458,382,425,156,269,0.587,0.506,0.408,6861,139.093432,264,641,0.763095238095238
"6960",186876,"The Richard Stockton College of New Jersey",1,0,2009,865,483,382,459,175,284,0.588,0.531,0.458,7067,149.676376,263,646,0.746820809248555
"6961",186876,"The Richard Stockton College of New Jersey",1,0,2010,858,518,340,433,137,296,0.571,0.505,0.403,7349,150.09236,271,651,0.758741258741259
"6962",187134,"TRENTON STATE COLLEGE",1,0,1991,860,560,300,445,108,337,0.602,0.517,0.36,3079,77.097,318,684,0.795348837209302
"6963",187134,"TRENTON STATE COLLEGE",1,0,1992,1068,712,356,628,174,454,0.638,0.588,0.489,3761,82.018,316,847,0.793071161048689
"6964",187134,"TRENTON STATE COLLEGE",1,0,1993,1064,628,436,576,186,390,0.621,0.541,0.427,3857,87.404,313,792,0.744360902255639
"6965",187134,"THE COLLEGE OF NEW JERSEY",1,0,1995,1087,670,417,638,212,426,0.636,0.587,0.508,4241,100.513,316,777,0.714811407543698
"6966",187134,"THE COLLEGE OF NEW JERSEY",1,0,1996,1009,675,334,648,187,461,0.683,0.642,0.56,4522,105.78,311,714,0.707631318136769
"6967",187134,"THE COLLEGE OF NEW JERSEY",1,0,1997,1396,847,549,870,305,565,0.667,0.623,0.556,4843,107.317838,324,1037,0.742836676217765
"6968",187134,"THE COLLEGE OF NEW JERSEY",1,0,1998,1206,714,492,760,278,482,0.675,0.63,0.565,5318,115.151262,325,846,0.701492537313433
"6969",187134,"THE COLLEGE OF NEW JERSEY",1,0,1999,1207,697,510,776,281,495,0.71,0.643,0.551,4445,122.724375,328,901,0.746478873239437
"6970",187134,"THE COLLEGE OF NEW JERSEY",1,0,2000,1205,714,491,799,287,512,0.717,0.663,0.585,4654,126.771,331,927,0.769294605809129
"6971",187134,"THE COLLEGE OF NEW JERSEY",1,0,2001,1258,750,508,852,302,550,0.733,0.677,0.594,5022,138.194,334,988,0.785373608903021
"6972",187134,"THE COLLEGE OF NEW JERSEY",1,0,2002,1231,738,493,834,288,546,0.74,0.677,0.584,5625,121.141,324,914,0.742485783915516
"6973",187134,"THE COLLEGE OF NEW JERSEY",1,0,2003,1176,679,497,855,327,528,0.778,0.727,0.658,6131,129.397,325,898,0.763605442176871
"6974",187134,"THE COLLEGE OF NEW JERSEY",1,0,2004,1230,681,549,876,357,519,0.762,0.712,0.65,6621,129.041,333,941,0.765040650406504
"6975",187134,"The College of New Jersey",1,0,2005,1236,685,551,914,383,531,0.775,0.739,0.695,7051,138.828,341,917,0.741909385113269
"6976",187134,"The College of New Jersey",1,0,2006,1270,756,514,919,339,580,0.767,0.724,0.66,7615,156.239,332,817,0.643307086614173
"6977",187134,"The College of New Jersey",1,0,2007,1297,774,523,940,334,606,0.783,0.725,0.639,8072,156.117,335,852,0.656900539707016
"6978",187134,"The College of New Jersey",1,0,2008,1295,763,532,939,356,583,0.764,0.725,0.669,8718,164.098,343,815,0.629343629343629
"6979",187134,"The College of New Jersey",1,0,2009,1283,718,565,918,366,552,0.769,0.716,0.648,8980,174.066,348,828,0.645362431800468
"6980",187134,"The College of New Jersey",1,0,2010,1421,800,621,1065,443,622,0.777,0.749,0.713,9340,184.098,348,944,0.664320900774103
"6981",187444,"WILLIAM PATERSON COLLEGE OF NEW JERSEY",1,0,1991,967,551,416,100,19,81,0.147,0.103,0.046,2544,65.297407,296,718,0.742502585315408
"6982",187444,"WILLIAM PATERSON COLLEGE OF NEW JERSEY",1,0,1992,962,536,426,94,24,70,0.131,0.098,0.056,2832,72.383143,307,688,0.715176715176715
"6983",187444,"WILLIAM PATERSON COLLEGE OF NEW JERSEY",1,0,1993,1091,608,483,89,14,75,0.123,0.082,0.029,2928,78.436691,311,755,0.692025664527956
"6984",187444,"WILLIAM PATERSON COLLEGE OF NEW JERSEY",1,0,1995,831,476,355,87,23,64,0.134,0.105,0.065,3120,82.996375,314,518,0.623345367027678
"6985",187444,"WILLIAM PATERSON COLLEGE OF NEW JERSEY",1,0,1996,918,523,395,148,41,107,0.205,0.161,0.104,3380,85.528794,306,568,0.618736383442266
"6986",187444,"WILLIAM PATERSON UNIVERSITY OF NEW JERSEY",1,0,1997,1032,563,469,154,51,103,0.183,0.149,0.109,3786,90.695463,323,610,0.59108527131783
"6987",187444,"WILLIAM PATERSON UNIVERSITY OF NEW JERSEY",1,0,1998,1133,663,470,145,39,106,0.16,0.128,0.083,4150,95.866146,340,696,0.614298323036187
"6988",187444,"WILLIAM PATERSON UNIVERSITY OF NEW JERSEY",1,0,1999,1105,614,491,177,56,121,0.197,0.16,0.114,3319,107.707397,352,678,0.613574660633484
"6989",187444,"WILLIAM PATERSON UNIVERSITY OF NEW JERSEY",1,0,2000,1160,610,550,188,73,115,0.189,0.162,0.133,3554,121.851914,357,675,0.581896551724138
"6990",187444,"WILLIAM PATERSON UNIVERSITY OF NEW JERSEY",1,0,2001,1247,697,550,185,59,126,0.181,0.148,0.107,3838,125.241164,362,799,0.640737770649559
"6991",187444,"WILLIAM PATERSON UNIVERSITY OF NEW JERSEY",1,0,2002,1286,715,571,208,59,149,0.208,0.162,0.103,4218,118.251474,359,747,0.580870917573872
"6992",187444,"WILLIAM PATERSON UNIVERSITY OF NEW JERSEY",1,0,2003,1269,711,558,262,86,176,0.248,0.206,0.154,4594,128.22501,354,741,0.583924349881797
"6993",187444,"WILLIAM PATERSON UNIVERSITY OF NEW JERSEY",1,0,2004,1430,801,629,245,85,160,0.2,0.171,0.135,4961,136.271126,371,813,0.568531468531469
"6994",187444,"William Paterson University of New Jersey",1,0,2005,1296,652,644,235,89,146,0.224,0.181,0.138,5358,147.088694,377,685,0.528549382716049
"6995",187444,"William Paterson University of New Jersey",1,0,2006,1218,669,549,170,62,108,0.161,0.14,0.113,5782,153.837574,366,613,0.503284072249589
"6996",187444,"William Paterson University of New Jersey",1,0,2007,1299,642,657,211,89,122,0.19,0.162,0.135,6072,155.335814,373,671,0.516551193225558
"6997",187444,"William Paterson University of New Jersey",1,0,2008,1204,617,587,215,75,140,0.227,0.179,0.128,6375,172.209318,379,589,0.489202657807309
"6998",187444,"William Paterson University of New Jersey",1,0,2009,1435,703,732,284,129,155,0.22,0.198,0.176,6567,177.366046,371,726,0.505923344947735
"6999",187444,"William Paterson University of New Jersey",1,0,2010,1509,774,735,443,160,283,0.366,0.294,0.218,6830,182.390835,380,751,0.497680583167661
"7000",187985,"UNIVERSITY OF NEW MEXICO-MAIN CAMPUS",1,0,1991,1716,915,801,147,61,86,0.094,0.086,0.076,1554,486.597033,818,957,0.557692307692308
"7001",187985,"UNIVERSITY OF NEW MEXICO-MAIN CAMPUS",1,0,1992,1700,946,754,148,53,95,0.1,0.087,0.07,1656,582.242613,817,917,0.539411764705882
"7002",187985,"UNIVERSITY OF NEW MEXICO-MAIN CAMPUS",1,0,1993,1910,1067,843,171,52,119,0.112,0.09,0.062,1788,606.124815,837,1024,0.536125654450262
"7003",187985,"UNIVERSITY OF NEW MEXICO-MAIN CAMPUS",1,0,1995,1712,956,756,221,76,145,0.152,0.129,0.101,1996,740.50541,861,897,0.523948598130841
"7004",187985,"UNIVERSITY OF NEW MEXICO-MAIN CAMPUS",1,0,1996,1600,875,725,217,67,150,0.171,0.136,0.092,2071,741.435636,839,813,0.508125
"7005",187985,"UNIVERSITY OF NEW MEXICO-MAIN CAMPUS",1,0,1997,2047,1132,915,244,71,173,0.153,0.119,0.078,2164,754.348789,854,1119,0.546653639472399
"7006",187985,"UNIVERSITY OF NEW MEXICO-MAIN CAMPUS",1,0,1998,2617,1475,1142,281,96,185,0.125,0.107,0.084,2242,793.630623,862,1290,0.492930836836072
"7007",187985,"UNIVERSITY OF NEW MEXICO-MAIN CAMPUS",1,0,1999,2715,1517,1198,276,85,191,0.126,0.102,0.071,1942,820.468453,862,1397,0.514548802946593
"7008",187985,"UNIVERSITY OF NEW MEXICO-MAIN CAMPUS",1,0,2000,2587,1474,1113,311,106,205,0.139,0.12,0.095,2259,892.510112,869.5,1286,0.497100889060688
"7009",187985,"UNIVERSITY OF NEW MEXICO-MAIN CAMPUS",1,0,2001,2364,1323,1041,280,103,177,0.134,0.118,0.099,2490,926.865168,877,1127,0.47673434856176
"7010",187985,"UNIVERSITY OF NEW MEXICO-MAIN CAMPUS",1,0,2002,2758,1565,1193,314,100,214,0.137,0.114,0.084,2621,1020.612047,870,1344,0.487309644670051
"7011",187985,"UNIVERSITY OF NEW MEXICO-MAIN CAMPUS",1,0,2003,2940,1660,1280,300,76,224,0.135,0.102,0.059,2740,1022.025261,884,1349,0.458843537414966
"7012",187985,"UNIVERSITY OF NEW MEXICO-MAIN CAMPUS",1,0,2004,3018,1720,1298,370,98,272,0.158,0.123,0.076,3112,1103.634085,874,1352,0.447978793903247
"7013",187985,"University of New Mexico-Main Campus",1,0,2005,3010,1717,1293,372,130,242,0.141,0.124,0.101,3360,1149.832937,905,1367,0.454152823920266
"7014",187985,"University of New Mexico-Main Campus",1,0,2006,2955,1619,1336,356,124,232,0.143,0.12,0.093,3475,1234.778012,889,1332,0.450761421319797
"7015",187985,"University of New Mexico-Main Campus",1,0,2007,2850,1637,1213,415,147,268,0.164,0.146,0.121,3640,1307.069816,918,1260,0.442105263157895
"7016",187985,"University of New Mexico-Main Campus",1,0,2008,3148,1737,1411,459,161,298,0.172,0.146,0.114,3817,1473.629341,933,1309,0.41581956797967
"7017",187985,"University of New Mexico-Main Campus",1,0,2009,3344,1762,1582,516,193,323,0.183,0.154,0.122,4007,1626.955425,958,1255,0.375299043062201
"7018",187985,"University of New Mexico-Main Campus",1,0,2010,3488,1951,1537,574,204,370,0.19,0.165,0.133,4348,1699.009449,942,1274,0.365252293577982
"7019",188030,"NEW MEXICO STATE UNIVERSITY MAIN CAMPUS",1,0,1991,1656,846,810,127,45,82,0.097,0.077,0.056,1594,220.321269,575,945,0.570652173913043
"7020",188030,"NEW MEXICO STATE UNIVERSITY MAIN CAMPUS",1,0,1992,1598,830,768,152,58,94,0.113,0.095,0.076,1708,233.614598,586,871,0.545056320400501
"7021",188030,"NEW MEXICO STATE UNIVERSITY-MAIN CAMPUS",1,0,1993,1602,780,822,153,64,89,0.114,0.096,0.078,1824,242.900911,582,867,0.541198501872659
"7022",188030,"NEW MEXICO STATE UNIVERSITY-MAIN CAMPUS",1,0,1995,1419,726,693,146,51,95,0.131,0.103,0.074,2088,256.455238,597,743,0.523608174770965
"7023",188030,"NEW MEXICO STATE UNIVERSITY-MAIN CAMPUS",1,0,1996,1510,807,703,188,51,137,0.17,0.125,0.073,2196,253.68738,595,803,0.531788079470199
"7024",188030,"NEW MEXICO STATE UNIVERSITY-MAIN CAMPUS",1,0,1997,1694,901,793,201,70,131,0.145,0.119,0.088,2196,268.290129,583,843,0.497638724911452
"7025",188030,"NEW MEXICO STATE UNIVERSITY-MAIN CAMPUS",1,0,1998,2077,1070,1007,254,77,177,0.165,0.122,0.076,2346,271.359704,562,1074,0.517091959557053
"7026",188030,"NEW MEXICO STATE UNIVERSITY-MAIN CAMPUS",1,0,1999,2210,1223,987,272,88,184,0.15,0.123,0.089,1740,288.514284,568,1081,0.489140271493213
"7027",188030,"NEW MEXICO STATE UNIVERSITY-MAIN CAMPUS",1,0,2000,1959,1082,877,238,83,155,0.143,0.121,0.095,1956,302.342955,562,160,0.0816743236345074
"7028",188030,"NEW MEXICO STATE UNIVERSITY-MAIN CAMPUS",1,0,2001,2051,1075,976,250,76,174,0.162,0.122,0.078,2148,320.725706,556,769,0.374939054119941
"7029",188030,"NEW MEXICO STATE UNIVERSITY-MAIN CAMPUS",1,0,2002,1977,1111,866,257,78,179,0.161,0.13,0.09,2328,334.441101,575,826,0.417804754678806
"7030",188030,"NEW MEXICO STATE UNIVERSITY-MAIN CAMPUS",1,0,2003,2016,1087,929,257,90,167,0.154,0.127,0.097,2418,349.360456,590,840,0.416666666666667
"7031",188030,"NEW MEXICO STATE UNIVERSITY-MAIN CAMPUS",1,0,2004,2061,1125,936,260,92,168,0.149,0.126,0.098,2828,359.544159,597,831,0.403202328966521
"7032",188030,"New Mexico State University-Main Campus",1,0,2005,1945,1092,853,289,96,193,0.177,0.149,0.113,2868,395.028075,657,785,0.403598971722365
"7033",188030,"New Mexico State University-Main Campus",1,0,2006,2073,1105,968,286,80,206,0.186,0.138,0.083,3124,424.762836,649,854,0.41196333815726
"7034",188030,"New Mexico State University-Main Campus",1,0,2007,2105,1123,982,329,94,235,0.209,0.156,0.096,3274,449.93654,679,802,0.380997624703088
"7035",188030,"New Mexico State University-Main Campus",1,0,2008,2171,1175,996,337,130,207,0.176,0.155,0.131,3540,475.591153,690,794,0.365730078304929
"7036",188030,"New Mexico State University-Main Campus",1,0,2009,2446,1306,1140,328,116,212,0.162,0.134,0.102,3720,496.522211,716,849,0.347097301717089
"7037",188030,"New Mexico State University-Main Campus",1,0,2010,2255,1181,1074,381,151,230,0.195,0.169,0.141,4128,491.012099,699,700,0.310421286031042
"7038",188429,"ADELPHI UNIVERSITY",1,0,1991,658,417,241,259,74,185,0.444,0.394,0.307,10420,75.924,280,352,0.534954407294833
"7039",188429,"ADELPHI UNIVERSITY",1,0,1992,591,356,235,153,40,113,0.317,0.259,0.17,11420,79.381,267,291,0.49238578680203
"7040",188429,"ADELPHI UNIVERSITY",1,0,1993,464,282,182,154,48,106,0.376,0.332,0.264,12250,76.745,267,237,0.510775862068966
"7041",188429,"ADELPHI UNIVERSITY",1,0,1995,370,212,158,140,52,88,0.415,0.378,0.329,13350,83.6,220,207,0.559459459459459
"7042",188429,"ADELPHI UNIVERSITY",1,0,1996,316,204,112,128,40,88,0.431,0.405,0.357,14000,98.226185,176,182,0.575949367088608
"7043",188429,"ADELPHI UNIVERSITY",1,0,1997,289,174,115,130,49,81,0.465,0.45,0.426,14000,70.743613,204,150,0.519031141868512
"7044",188429,"ADELPHI UNIVERSITY",1,0,1998,525,343,182,214,67,147,0.429,0.408,0.368,14250,67.847791,196,251,0.478095238095238
"7045",188429,"ADELPHI UNIVERSITY",1,0,1999,532,366,166,233,64,169,0.462,0.438,0.386,14920,70.61292,196,316,0.593984962406015
"7046",188429,"ADELPHI UNIVERSITY",1,0,2000,616,416,200,314,82,232,0.558,0.51,0.41,15520,75.267607,195.5,349,0.566558441558442
"7047",188429,"ADELPHI UNIVERSITY",1,0,2001,664,469,195,367,89,278,0.593,0.553,0.456,16270,78.765539,195,373,0.561746987951807
"7048",188429,"ADELPHI UNIVERSITY",1,0,2002,666,463,203,373,97,276,0.596,0.56,0.478,16980,84.994862,215,365,0.548048048048048
"7049",188429,"ADELPHI UNIVERSITY",1,0,2003,772,514,258,402,117,285,0.554,0.521,0.453,17800,91.865246,228,395,0.511658031088083
"7050",188429,"ADELPHI UNIVERSITY",1,0,2004,801,549,252,463,119,344,0.627,0.578,0.472,17700,103.633422,242,367,0.458177278401998
"7051",188429,"Adelphi University",1,0,2005,754,505,249,416,121,295,0.584,0.552,0.486,18620,110.310195,257,327,0.43368700265252
"7052",188429,"Adelphi University",1,0,2006,826,587,239,446,108,338,0.576,0.54,0.452,19800,124.781305,280,488,0.590799031476998
"7053",188429,"Adelphi University",1,0,2007,883,603,280,464,134,330,0.547,0.525,0.479,21000,135.054647,283,517,0.585503963759909
"7054",188429,"Adelphi University",1,0,2008,944,614,330,510,146,364,0.593,0.54,0.442,22725,142.491238,295,554,0.586864406779661
"7055",188429,"Adelphi University",1,0,2009,985,690,295,539,131,408,0.591,0.547,0.444,24100,155.968446,308,577,0.585786802030457
"7056",188429,"Adelphi University",1,0,2010,909,634,275,521,133,388,0.612,0.573,0.484,25465,162.805964,311,499,0.548954895489549
"7057",188641,"ALFRED UNIVERSITY",1,0,1991,256,110,146,132,67,65,0.591,0.516,0.459,14110,39.197,119,231,0.90234375
"7058",188641,"ALFRED UNIVERSITY",1,0,1992,300,136,164,151,73,78,0.574,0.503,0.445,14998,43.178,111,269,0.896666666666667
"7059",188641,"ALFRED UNIVERSITY",1,0,1993,314,148,166,165,74,91,0.615,0.525,0.446,15648,48.08,113,273,0.869426751592357
"7060",188641,"ALFRED UNIVERSITY",1,0,1995,326,158,168,153,56,97,0.614,0.469,0.333,17948,53.187,114,287,0.880368098159509
"7061",188641,"ALFRED UNIVERSITY",1,0,1996,330,166,164,178,76,102,0.615,0.539,0.463,18972,56.328512,117,295,0.893939393939394
"7062",188641,"ALFRED UNIVERSITY",1,0,1997,467,205,262,204,99,105,0.512,0.437,0.378,19916,45.089644,114,424,0.907922912205567
"7063",188641,"ALFRED UNIVERSITY",1,0,1998,554,275,279,272,118,154,0.56,0.491,0.423,20212,50.122371,111,492,0.888086642599278
"7064",188641,"ALFRED UNIVERSITY",1,0,1999,549,277,272,242,98,144,0.52,0.441,0.36,18498,54.485007,115,478,0.870673952641166
"7065",188641,"ALFRED UNIVERSITY",1,0,2000,504,280,224,246,81,165,0.589,0.488,0.362,18498,57.310586,115,386,0.765873015873016
"7066",188641,"ALFRED UNIVERSITY",1,0,2001,500,243,257,232,97,135,0.556,0.464,0.377,18498,62.753887,115,369,0.738
"7067",188641,"ALFRED UNIVERSITY",1,0,2002,474,223,251,247,111,136,0.61,0.521,0.442,19918,69.221443,125,348,0.734177215189873
"7068",188641,"ALFRED UNIVERSITY",1,0,2003,472,250,222,237,89,148,0.592,0.502,0.401,19918,70.054818,188,364,0.771186440677966
"7069",188641,"ALFRED UNIVERSITY",1,0,2004,505,226,279,218,99,119,0.526,0.432,0.355,20106,68.906595,172,367,0.726732673267327
"7070",188641,"Alfred University",1,0,2005,429,188,241,186,85,101,0.537,0.434,0.353,20515,72.253138,213,306,0.713286713286713
"7071",188641,"Alfred University",1,0,2006,490,257,233,229,86,143,0.556,0.467,0.369,21284,66.328151,177,332,0.677551020408163
"7072",188641,"Alfred University",1,0,2007,518,239,279,231,107,124,0.519,0.446,0.384,22312,65.761283,167,345,0.666023166023166
"7073",188641,"Alfred University",1,0,2008,502,219,283,193,99,94,0.429,0.384,0.35,23428,68.898126,158,344,0.685258964143426
"7074",188641,"Alfred University",1,0,2009,465,234,231,204,85,119,0.509,0.439,0.368,24366,68.538198,160,313,0.673118279569892
"7075",188641,"Alfred University",1,0,2010,526,240,286,225,91,134,0.558,0.428,0.318,25096,65.48167,156,372,0.707224334600761
"7076",190044,"CLARKSON UNIVERSITY",1,0,1991,634,134,500,338,266,72,0.537,0.533,0.532,13675,67.037,182,554,0.873817034700315
"7077",190044,"CLARKSON UNIVERSITY",1,0,1992,549,138,411,294,210,84,0.609,0.536,0.511,14510,69.274,179,479,0.872495446265938
"7078",190044,"CLARKSON UNIVERSITY",1,0,1993,557,120,437,285,221,64,0.533,0.512,0.506,15060,65.486,161,502,0.901256732495512
"7079",190044,"CLARKSON UNIVERSITY",1,0,1995,645,170,475,305,221,84,0.494,0.473,0.465,17113,65.702,148,573,0.888372093023256
"7080",190044,"CLARKSON UNIVERSITY",1,0,1996,664,176,488,349,253,96,0.545,0.526,0.518,17500,68.701,144,577,0.868975903614458
"7081",190044,"CLARKSON UNIVERSITY",1,0,1997,612,136,476,378,297,81,0.596,0.618,0.624,18593,56.026987,154,546,0.892156862745098
"7082",190044,"CLARKSON UNIVERSITY",1,0,1998,616,138,478,292,216,76,0.551,0.474,0.452,19418,58.545298,156,553,0.897727272727273
"7083",190044,"CLARKSON UNIVERSITY",1,0,1999,706,225,481,407,264,143,0.636,0.576,0.549,19825,60.133041,149,645,0.913597733711048
"7084",190044,"CLARKSON UNIVERSITY",1,0,2000,638,149,489,325,242,83,0.557,0.509,0.495,20600,63.850587,156.5,568,0.890282131661442
"7085",190044,"CLARKSON UNIVERSITY",1,0,2001,722,164,558,382,290,92,0.561,0.529,0.52,21400,70.544364,164,631,0.873961218836565
"7086",190044,"CLARKSON UNIVERSITY",1,0,2002,723,164,559,391,296,95,0.579,0.541,0.53,22235,70.399912,154,673,0.930843706777317
"7087",190044,"CLARKSON UNIVERSITY",1,0,2003,720,193,527,372,257,115,0.596,0.517,0.488,23100,76.509276,169,641,0.890277777777778
"7088",190044,"CLARKSON UNIVERSITY",1,0,2004,658,142,516,364,275,89,0.627,0.553,0.533,24100,83.615616,169,610,0.927051671732523
"7089",190044,"Clarkson University",1,0,2005,630,173,457,380,274,106,0.613,0.603,0.6,25185,83.095692,175,579,0.919047619047619
"7090",190044,"Clarkson University",1,0,2006,646,176,470,354,246,108,0.614,0.548,0.523,26650,84.30388,174,556,0.860681114551084
"7091",190044,"Clarkson University",1,0,2007,682,189,493,418,289,129,0.682,0.613,0.586,28470,87.29039,183,582,0.853372434017595
"7092",190044,"Clarkson University",1,0,2008,734,204,530,407,274,133,0.652,0.554,0.517,30320,87.827012,186,615,0.837874659400545
"7093",190044,"Clarkson University",1,0,2009,774,220,554,405,262,143,0.65,0.523,0.473,32220,93.645098,194,645,0.833333333333333
"7094",190044,"Clarkson University",1,0,2010,712,182,530,399,279,120,0.659,0.56,0.526,34070,98.421572,201,612,0.859550561797753
"7095",190099,"COLGATE UNIVERSITY",1,0,1991,694,330,364,554,265,289,0.876,0.798,0.728,16150,65.024,194,587,0.845821325648415
"7096",190099,"COLGATE UNIVERSITY",1,0,1992,690,368,322,589,257,332,0.902,0.854,0.798,17415,67.819,200,586,0.849275362318841
"7097",190099,"COLGATE UNIVERSITY",1,0,1993,726,378,348,603,269,334,0.884,0.831,0.773,18620,74.803,198,625,0.860881542699725
"7098",190099,"COLGATE UNIVERSITY",1,0,1995,722,361,361,604,290,314,0.87,0.837,0.803,20650,85.618,192,632,0.875346260387812
"7099",190099,"COLGATE UNIVERSITY",1,0,1996,718,351,367,592,282,310,0.883,0.825,0.768,21675,92.364,190,600,0.835654596100279
"7100",190099,"COLGATE UNIVERSITY",1,0,1997,711,364,347,599,276,323,0.887,0.842,0.795,22765,78.859,188,593,0.834036568213783
"7101",190099,"COLGATE UNIVERSITY",1,0,1998,751,407,344,641,283,358,0.88,0.854,0.823,23880,80.956,193,620,0.825565912117177
"7102",190099,"COLGATE UNIVERSITY",1,0,1999,750,397,353,662,306,356,0.897,0.883,0.867,24575,84.735,230,619,0.825333333333333
"7103",190099,"COLGATE UNIVERSITY",1,0,2000,711,339,372,600,308,292,0.861,0.844,0.828,25565,92.565,241.5,601,0.845288326300984
"7104",190099,"COLGATE UNIVERSITY",1,0,2001,740,392,348,631,282,349,0.89,0.853,0.81,26845,97.437213,253,597,0.806756756756757
"7105",190099,"COLGATE UNIVERSITY",1,0,2002,728,386,342,629,292,337,0.873,0.864,0.854,28165,104.48299,247,565,0.776098901098901
"7106",190099,"COLGATE UNIVERSITY",1,0,2003,725,355,370,615,301,314,0.885,0.848,0.814,29740,111.672,246,562,0.775172413793103
"7107",190099,"COLGATE UNIVERSITY",1,0,2004,738,396,342,616,277,339,0.856,0.835,0.81,31230,119.044,246,544,0.737127371273713
"7108",190099,"Colgate University",1,0,2005,729,368,361,640,311,329,0.894,0.878,0.861,32885,123.247068,250,571,0.783264746227709
"7109",190099,"Colgate University",1,0,2006,743,417,326,630,278,352,0.844,0.848,0.853,34795,130.352,264,552,0.742934051144011
"7110",190099,"Colgate University",1,0,2007,744,382,362,644,297,347,0.908,0.866,0.82,37405,139.308,257,552,0.741935483870968
"7111",190099,"Colgate University",1,0,2008,737,386,351,661,307,354,0.917,0.897,0.875,39275,146.206,267,553,0.75033921302578
"7112",190099,"Colgate University",1,0,2009,750,400,350,644,299,345,0.863,0.859,0.854,40690,150.045095,269,556,0.741333333333333
"7113",190099,"Colgate University",1,0,2010,849,466,383,721,312,409,0.878,0.849,0.815,41585,155.231541,280,568,0.669022379269729
"7114",190150,"COLUMBIA UNIVERSITY IN THE CITY OF NEW YORK",1,0,1991,1085,464,621,851,481,370,0.797,0.784,0.775,16318,891.381,888,572,0.527188940092166
"7115",190150,"COLUMBIA UNIVERSITY IN THE CITY OF NEW YORK",1,0,1992,1113,458,655,880,511,369,0.806,0.791,0.78,16918,984.855,2240,478,0.429469901168014
"7116",190150,"COLUMBIA UNIVERSITY IN THE CITY OF NEW YORK",1,0,1993,1626,997,629,1243,482,761,0.763,0.764,0.766,17948,1019.384,2240,848,0.521525215252153
"7117",190150,"COLUMBIA UNIVERSITY IN THE CITY OF NEW YORK",1,0,1995,1157,505,652,918,501,417,0.826,0.793,0.768,20292,1152.441,2438,561,0.484874675885912
"7118",190150,"COLUMBIA UNIVERSITY IN THE CITY OF NEW YORK",1,0,1996,1260,576,684,1041,542,499,0.866,0.826,0.792,21444,1207.329,2461,595,0.472222222222222
"7119",190150,"COLUMBIA UNIVERSITY IN THE CITY OF NEW YORK",1,0,1997,1271,583,688,1036,547,489,0.839,0.815,0.795,22652,1216.485,1130,583,0.458693941778127
"7120",190150,"COLUMBIA UNIVERSITY IN THE CITY OF NEW YORK",1,0,1998,1283,619,664,1061,545,516,0.834,0.827,0.821,23244,1281.94,1163,589,0.459080280592362
"7121",190150,"COLUMBIA UNIVERSITY IN THE CITY OF NEW YORK",1,0,1999,1298,573,725,1068,586,482,0.841,0.823,0.808,24150,1418.056,1217,625,0.481510015408321
"7122",190150,"COLUMBIA UNIVERSITY IN THE CITY OF NEW YORK",1,0,2000,1339,610,729,1136,602,534,0.875,0.848,0.826,25044,1573.457,1290.5,630,0.470500373412995
"7123",190150,"COLUMBIA UNIVERSITY IN THE CITY OF NEW YORK",1,0,2001,1330,607,723,1108,612,496,0.817,0.833,0.846,25790,1722.173,1364,661,0.496992481203008
"7124",190150,"COLUMBIA UNIVERSITY IN THE CITY OF NEW YORK",1,0,2002,1386,636,750,1168,630,538,0.846,0.843,0.84,27190,1895.116,1466,678,0.489177489177489
"7125",190150,"COLUMBIA UNIVERSITY IN THE CITY OF NEW YORK",1,0,2003,1355,626,729,1131,606,525,0.839,0.835,0.831,28686,2037.8,1508,611,0.450922509225092
"7126",190150,"COLUMBIA UNIVERSITY IN THE CITY OF NEW YORK",1,0,2004,1366,632,734,1133,604,529,0.837,0.829,0.823,30260,2190.773,1521,604,0.442166910688141
"7127",190150,"Columbia University in the City of New York",1,0,2005,1403,660,743,1189,621,568,0.861,0.847,0.836,31924,2409.267,1289,644,0.459016393442623
"7128",190150,"Columbia University in the City of New York",1,0,2006,1353,646,707,1191,604,587,0.909,0.88,0.854,33664,2540.033,1317,564,0.416851441241685
"7129",190150,"Columbia University in the City of New York",1,0,2007,1371,671,700,1173,586,587,0.875,0.856,0.837,35516,2688.355,1388,567,0.413566739606127
"7130",190150,"Columbia University in the City of New York",1,0,2008,1374,653,721,1208,613,595,0.911,0.879,0.85,37470,2894.809,1425,549,0.399563318777293
"7131",190150,"Columbia University in the City of New York",1,0,2009,1432,701,731,1260,629,631,0.9,0.88,0.86,39296,3061.281,1422,491,0.342877094972067
"7132",190150,"Columbia University in the City of New York",1,0,2010,1392,676,716,1188,595,593,0.877,0.853,0.831,41160,3158.488,1439,495,0.355603448275862
"7133",190248,"CONCORDIA COLLEGE",1,0,1991,85,43,42,29,10,19,0.442,0.341,0.238,8370,7.844,38,73,0.858823529411765
"7134",190248,"CONCORDIA COLLEGE",1,0,1992,106,62,44,28,8,20,0.323,0.264,0.182,9370,8.67,33,79,0.745283018867924
"7135",190248,"CONCORDIA COLLEGE",1,0,1993,81,40,41,27,12,15,0.375,0.333,0.293,9990,9.877,32,61,0.753086419753086
"7136",190248,"CONCORDIA COLLEGE",1,0,1995,118,63,55,29,13,16,0.254,0.246,0.236,10696,10.069,32,81,0.686440677966102
"7137",190248,"CONCORDIA COLLEGE",1,0,1996,94,43,51,19,7,12,0.279,0.202,0.137,11400,10.742769,32,69,0.734042553191489
"7138",190248,"CONCORDIA COLLEGE",1,0,1997,113,71,42,41,13,28,0.394,0.363,0.31,11990,9.255695,30,90,0.79646017699115
"7139",190248,"CONCORDIA COLLEGE",1,0,1998,114,68,46,40,17,23,0.338,0.351,0.37,12650,9.881446,29,75,0.657894736842105
"7140",190248,"CONCORDIA COLLEGE",1,0,1999,111,72,39,33,6,27,0.375,0.297,0.154,13350,10.026951,28,66,0.594594594594595
"7141",190248,"CONCORDIA COLLEGE",1,0,2000,122,68,54,55,23,32,0.471,0.451,0.426,14350,10.623364,26,82,0.672131147540984
"7142",190248,"CONCORDIA COLLEGE",1,0,2001,132,88,44,50,9,41,0.466,0.379,0.205,15550,11.505552,24,97,0.734848484848485
"7143",190248,"CONCORDIA COLLEGE",1,0,2002,135,75,60,43,16,27,0.36,0.319,0.267,16800,11.793391,26,86,0.637037037037037
"7144",190248,"CONCORDIA COLLEGE",1,0,2003,137,85,52,37,12,25,0.294,0.27,0.231,17640,12.120198,25,80,0.583941605839416
"7145",190248,"CONCORDIA COLLEGE",1,0,2004,143,61,82,38,13,25,0.41,0.266,0.159,18700,12.630133,24,84,0.587412587412587
"7146",190248,"Concordia College",1,0,2005,140,83,57,49,12,37,0.446,0.35,0.211,19800,13.054063,26,92,0.657142857142857
"7147",190248,"Concordia College",1,0,2006,171,90,81,57,26,31,0.344,0.333,0.321,20700,13.917298,26,109,0.637426900584795
"7148",190248,"Concordia College",1,0,2007,127,76,51,35,9,26,0.342,0.276,0.176,21950,15.151711,28,68,0.535433070866142
"7149",190248,"Concordia College",1,0,2008,104,58,46,40,12,28,0.483,0.385,0.261,22930,16.818875,34,51,0.490384615384615
"7150",190248,"Concordia College-New York",1,0,2009,101,54,47,27,7,20,0.37,0.267,0.149,23950,17.049572,33,45,0.445544554455446
"7151",190248,"Concordia College-New York",1,0,2010,138,76,62,62,22,40,0.526,0.449,0.355,24670,17.11909,35,67,0.485507246376812
"7152",190415,"CORNELL UNIVERSITY-ENDOWED COLLEGES",1,0,1991,2949,1345,1604,2336,1218,1118,0.831,0.792,0.759,16214,510.106,923,1705,0.578162088843676
"7153",190415,"CORNELL UNIVERSITY-ENDOWED COLLEGES",1,0,1992,2893,1382,1511,2354,1179,1175,0.85,0.814,0.78,17276,523.596,940,1597,0.552022122364328
"7154",190415,"CORNELL UNIVERSITY-ENDOWED COLLEGES",1,0,1993,3172,1423,1749,2612,1400,1212,0.852,0.823,0.8,18226,547.401,914,1802,0.568095838587642
"7155",190415,"CORNELL UNIVERSITY-ENDOWED COLLEGES",1,0,1995,2070,842,1228,1625,931,694,0.824,0.785,0.758,20066,634.6262,911,1196,0.577777777777778
"7156",190415,"CORNELL UNIVERSITY-ENDOWED COLLEGES",1,0,1996,2001,870,1131,1570,872,698,0.802,0.785,0.771,20974,664.084684,891,1108,0.553723138430785
"7157",190415,"CORNELL UNIVERSITY-ENDOWED COLLEGES",1,0,1997,2998,1405,1593,2551,1307,1244,0.885,0.851,0.82,21914,582.713993,906,1750,0.583722481654436
"7158",190415,"CORNELL UNIVERSITY-ENDOWED COLLEGES",1,0,1998,3084,1452,1632,2633,1358,1275,0.878,0.854,0.832,22868,619.783529,911,1920,0.622568093385214
"7159",190415,"CORNELL UNIVERSITY-ENDOWED COLLEGES",1,0,1999,3158,1497,1661,2660,1341,1319,0.881,0.842,0.807,23760,653.253359,897,1939,0.613996200126662
"7160",190415,"CORNELL UNIVERSITY-ENDOWED COLLEGES",1,0,2000,3047,1438,1609,2569,1308,1261,0.877,0.843,0.813,24760,705.050594,911,1814,0.595339678372169
"7161",190415,"CORNELL UNIVERSITY-ENDOWED COLLEGES",1,0,2001,2984,1471,1513,2524,1246,1278,0.869,0.846,0.824,25970,705.925173,925,1815,0.608243967828418
"7162",190415,"CORNELL UNIVERSITY-ENDOWED COLLEGES",1,0,2002,2999,1530,1469,2605,1253,1352,0.884,0.869,0.853,27270,763.619653,933,1878,0.626208736245415
"7163",190415,"CORNELL UNIVERSITY-ENDOWED COLLEGES",1,0,2003,3131,1533,1598,2672,1322,1350,0.881,0.853,0.827,28630,1263.190041,1692,1782,0.569147237304376
"7164",190415,"CORNELL UNIVERSITY-ENDOWED COLLEGES",1,0,2004,3051,1494,1557,2621,1289,1332,0.892,0.859,0.828,30000,1333.276293,1748,1724,0.565060635857096
"7165",190415,"Cornell University",1,0,2005,3071,1541,1530,2664,1286,1378,0.894,0.867,0.841,31300,1409.323705,1742,1838,0.598502116574406
"7166",190415,"Cornell University",1,0,2006,3186,1538,1648,2779,1375,1404,0.913,0.872,0.834,32800,1520.874737,1787,1576,0.494664155681105
"7167",190415,"Cornell University",1,0,2007,3005,1454,1551,2601,1285,1316,0.905,0.866,0.828,34600,1547.174284,1799,1363,0.453577371048253
"7168",190415,"Cornell University",1,0,2008,3132,1573,1559,2718,1307,1411,0.897,0.868,0.838,36300,1680.283612,1819,1514,0.483397190293742
"7169",190415,"Cornell University",1,0,2009,3174,1597,1577,2742,1327,1415,0.886,0.864,0.841,37750,1689.355056,1775,1471,0.463453056080655
"7170",190415,"Cornell University",1,0,2010,3172,1579,1593,2763,1325,1438,0.911,0.871,0.832,39450,1616.047278,1737,1467,0.462484237074401
"7171",190512,"CUNY BERNARD BARUCH COLLEGE",1,0,1991,1170,746,424,56,19,37,0.05,0.048,0.045,1950,97.225,433,194,0.165811965811966
"7172",190512,"CUNY BERNARD BARUCH COLLEGE",1,0,1992,1359,830,529,52,20,32,0.039,0.038,0.038,2552,104.246,398,260,0.191317144959529
"7173",190512,"CUNY BERNARD M BARUCH COLLEGE",1,0,1993,1300,798,502,63,25,38,0.048,0.048,0.05,2562,111.04,438,284,0.218461538461538
"7174",190512,"CUNY BERNARD M BARUCH COLLEGE",1,0,1995,1445,839,606,149,55,94,0.112,0.103,0.091,3320,123.213,413,323,0.223529411764706
"7175",190512,"CUNY BERNARD M BARUCH COLLEGE",1,0,1996,1365,797,568,196,82,114,0.143,0.144,0.144,3320,119.799,404,349,0.255677655677656
"7176",190512,"CUNY BERNARD M BARUCH COLLEGE",1,0,1997,1109,608,501,202,75,127,0.209,0.182,0.15,3330,126.145,396,261,0.235347159603246
"7177",190512,"CUNY BERNARD M BARUCH COLLEGE",1,0,1998,946,493,453,231,83,148,0.3,0.244,0.183,3330,127.914,409,276,0.291754756871036
"7178",190512,"CUNY BERNARD M BARUCH COLLEGE",1,0,1999,1133,593,540,312,124,188,0.317,0.275,0.23,3200,107.984,405,358,0.315975286849073
"7179",190512,"CUNY BERNARD M BARUCH COLLEGE",1,0,2000,1295,701,594,351,137,214,0.305,0.271,0.231,3200,144.349,441,417,0.322007722007722
"7180",190512,"CUNY BERNARD M BARUCH COLLEGE",1,0,2001,1688,921,767,554,231,323,0.351,0.328,0.301,3200,143.226666,477,571,0.338270142180095
"7181",190512,"CUNY BERNARD M BARUCH COLLEGE",1,0,2002,1654,830,824,554,217,337,0.406,0.335,0.263,3200,126.450823,424,615,0.371825876662636
"7182",190512,"CUNY BERNARD M BARUCH COLLEGE",1,0,2003,1659,819,840,544,214,330,0.403,0.328,0.255,4000,138.961812,473,564,0.33996383363472
"7183",190512,"CUNY BERNARD M BARUCH COLLEGE",1,0,2004,1693,865,828,569,233,336,0.388,0.336,0.281,4000,143.882276,486,575,0.339633786178382
"7184",190512,"CUNY Bernard M Baruch College",1,0,2005,1625,784,841,577,266,311,0.397,0.355,0.316,4000,150.775661,473,513,0.315692307692308
"7185",190512,"CUNY Bernard M Baruch College",1,0,2006,1493,650,843,497,248,249,0.383,0.333,0.294,4000,163.871933,486,448,0.300066979236437
"7186",190512,"CUNY Bernard M Baruch College",1,0,2007,1470,695,775,578,259,319,0.459,0.393,0.334,4000,180.941993,501,492,0.33469387755102
"7187",190512,"CUNY Bernard M Baruch College",1,0,2008,1497,693,804,530,250,280,0.404,0.354,0.311,4000,195.106835,509,469,0.313293253173013
"7188",190512,"CUNY Bernard M Baruch College",1,0,2009,1430,619,811,598,294,304,0.491,0.418,0.363,4600,238.762269,498,444,0.310489510489511
"7189",190512,"CUNY Bernard M Baruch College",1,0,2010,1255,527,728,483,242,241,0.457,0.385,0.332,4600,249.853079,522,378,0.301195219123506
"7190",190549,"CUNY BROOKLYN COLLEGE",1,0,1991,1475,843,632,135,42,93,0.11,0.092,0.066,2005,100.495,551,828,0.56135593220339
"7191",190549,"CUNY BROOKLYN COLLEGE",1,0,1992,1341,765,576,122,40,82,0.107,0.091,0.069,2607,108.249,534,728,0.542878448918717
"7192",190549,"CUNY BROOKLYN COLLEGE",1,0,1993,1269,748,521,143,40,103,0.138,0.113,0.077,2629,113.471,557,646,0.509062253743105
"7193",190549,"CUNY BROOKLYN COLLEGE",1,0,1995,1167,685,482,182,60,122,0.178,0.156,0.124,3387,125.761,490,549,0.470437017994859
"7194",190549,"CUNY BROOKLYN COLLEGE",1,0,1996,1211,739,472,183,49,134,0.181,0.151,0.104,3387,121.964,479,591,0.488026424442609
"7195",190549,"CUNY BROOKLYN COLLEGE",1,0,1997,1344,774,570,194,75,119,0.154,0.144,0.132,3393,120.625,473,636,0.473214285714286
"7196",190549,"CUNY BROOKLYN COLLEGE",1,0,1998,1029,615,414,184,56,128,0.208,0.179,0.135,3393,126.403,461,521,0.506316812439261
"7197",190549,"CUNY BROOKLYN COLLEGE",1,0,1999,982,591,391,166,55,111,0.188,0.169,0.141,3200,131.319,465,504,0.513238289205703
"7198",190549,"CUNY BROOKLYN COLLEGE",1,0,2000,1238,717,521,218,79,139,0.194,0.176,0.152,3200,130.273,491,589,0.475767366720517
"7199",190549,"CUNY BROOKLYN COLLEGE",1,0,2001,1017,591,426,209,64,145,0.245,0.206,0.15,3200,141.961431,517,528,0.519174041297935
"7200",190549,"CUNY BROOKLYN COLLEGE",1,0,2002,1194,679,515,235,78,157,0.231,0.197,0.151,3200,141.589859,466,579,0.484924623115578
"7201",190549,"CUNY BROOKLYN COLLEGE",1,0,2003,1296,679,617,220,73,147,0.216,0.17,0.118,4000,146.890475,509,653,0.503858024691358
"7202",190549,"CUNY BROOKLYN COLLEGE",1,0,2004,1170,653,517,268,90,178,0.273,0.229,0.174,4000,150.3747,514,545,0.465811965811966
"7203",190549,"CUNY Brooklyn College",1,0,2005,1372,757,615,294,109,185,0.244,0.214,0.177,4000,153.125648,510,588,0.428571428571429
"7204",190549,"CUNY Brooklyn College",1,0,2006,1354,766,588,355,120,235,0.307,0.262,0.204,4000,171.503478,515,579,0.427621861152142
"7205",190549,"CUNY Brooklyn College",1,0,2007,1300,743,557,305,103,202,0.272,0.235,0.185,4000,196.047484,530,531,0.408461538461538
"7206",190549,"CUNY Brooklyn College",1,0,2008,1330,792,538,319,107,212,0.268,0.24,0.199,4000,201.310228,533,522,0.392481203007519
"7207",190549,"CUNY Brooklyn College",1,0,2009,952,541,411,223,94,129,0.238,0.234,0.229,4600,228.891655,557,388,0.407563025210084
"7208",190549,"CUNY Brooklyn College",1,0,2010,1143,661,482,284,95,189,0.286,0.248,0.197,4600,250.795151,519,505,0.441819772528434
"7209",190558,"CUNY COLLEGE OF STATEN ISLAND",1,0,1991,1153,599,554,16,4,12,0.02,0.014,0.007,1949,59.232,257,843,0.731136166522116
"7210",190558,"CUNY COLLEGE OF STATEN ISLAND",1,0,1992,1126,593,533,17,3,14,0.024,0.015,0.006,2558,64.091,237,811,0.720248667850799
"7211",190558,"CUNY COLLEGE OF STATEN ISLAND",1,0,1993,1100,579,521,23,9,14,0.024,0.021,0.017,2558,70.753,293,784,0.712727272727273
"7212",190558,"CUNY COLLEGE OF STATEN ISLAND",1,0,1995,1426,728,698,33,17,16,0.022,0.023,0.024,3316,80.571,264,1007,0.70617110799439
"7213",190558,"CUNY COLLEGE OF STATEN ISLAND",1,0,1996,1434,727,707,32,9,23,0.032,0.022,0.013,3316,77.472,265,956,0.666666666666667
"7214",190558,"CUNY COLLEGE OF STATEN ISLAND",1,0,1997,1418,729,689,32,7,25,0.034,0.023,0.01,3316,81.077,274,944,0.665726375176305
"7215",190558,"CUNY COLLEGE OF STATEN ISLAND",1,0,1998,1510,786,724,36,14,22,0.028,0.024,0.019,3316,86.405,273,956,0.633112582781457
"7216",190558,"CUNY COLLEGE OF STATEN ISLAND",1,0,1999,1532,782,750,63,21,42,0.054,0.041,0.028,3200,90.482,288,942,0.614882506527415
"7217",190558,"CUNY COLLEGE OF STATEN ISLAND",1,0,2000,1488,796,692,44,10,34,0.043,0.03,0.014,3200,91.068,309.5,982,0.65994623655914
"7218",190558,"CUNY COLLEGE OF STATEN ISLAND",1,0,2001,1600,817,783,57,22,35,0.043,0.036,0.028,3200,96.955847,331,1045,0.653125
"7219",190558,"CUNY COLLEGE OF STATEN ISLAND",1,0,2002,1743,905,838,66,25,41,0.045,0.038,0.03,3200,97.125572,290,1131,0.648881239242685
"7220",190558,"CUNY COLLEGE OF STATEN ISLAND",1,0,2003,1885,1013,872,67,17,50,0.049,0.036,0.019,4000,103.647861,334,1210,0.641909814323607
"7221",190558,"CUNY COLLEGE OF STATEN ISLAND",1,0,2004,2020,1147,873,67,12,55,0.048,0.033,0.014,4000,107.511209,343,1243,0.615346534653465
"7222",190558,"CUNY College of Staten Island",1,0,2005,1888,1048,840,62,31,31,0.03,0.033,0.037,4000,113.418185,333,1120,0.593220338983051
"7223",190558,"CUNY College of Staten Island",1,0,2006,2072,1124,948,108,41,67,0.06,0.052,0.043,4000,123.595096,328,1265,0.610521235521235
"7224",190558,"CUNY College of Staten Island",1,0,2007,2273,1272,1001,122,48,74,0.058,0.054,0.048,4000,133.177113,345,1342,0.590409150901892
"7225",190558,"CUNY College of Staten Island",1,0,2008,2282,1209,1073,112,47,65,0.054,0.049,0.044,4000,144.727339,347,1340,0.587204206836109
"7226",190558,"CUNY College of Staten Island",1,0,2009,2407,1245,1162,127,52,75,0.06,0.053,0.045,4600,172.030388,350,1430,0.5941005400914
"7227",190558,"CUNY College of Staten Island",1,0,2010,2237,1184,1053,146,52,94,0.079,0.065,0.049,4600,192.637032,366,1299,0.580688421993742
"7228",190567,"CUNY CITY COLLEGE",1,0,1991,1126,505,621,19,11,8,0.016,0.017,0.018,1945,123.231,623,68,0.0603907637655417
"7229",190567,"CUNY CITY COLLEGE",1,0,1992,1071,454,617,18,12,6,0.013,0.017,0.019,2547,131.323,541,53,0.0494864612511671
"7230",190567,"CUNY CITY COLLEGE",1,0,1993,1167,507,660,25,13,12,0.024,0.021,0.02,2547,136.487,587,94,0.0805484147386461
"7231",190567,"CUNY CITY COLLEGE",1,0,1995,865,449,416,31,18,13,0.029,0.036,0.043,3304,139.833,530,55,0.0635838150289017
"7232",190567,"CUNY CITY COLLEGE",1,0,1996,768,352,416,28,14,14,0.04,0.036,0.034,3309,126.892,501,39,0.05078125
"7233",190567,"CUNY CITY COLLEGE",1,0,1997,947,464,483,44,17,27,0.058,0.046,0.035,3309,123.996,474,49,0.0517423442449842
"7234",190567,"CUNY CITY COLLEGE",1,0,1998,901,462,439,31,11,20,0.043,0.034,0.025,3309,129.472,453,51,0.0566037735849057
"7235",190567,"CUNY CITY COLLEGE",1,0,1999,773,341,432,45,16,29,0.085,0.058,0.037,3200,133.348,456,64,0.0827943078913325
"7236",190567,"CUNY CITY COLLEGE",1,0,2000,852,399,453,27,8,19,0.048,0.032,0.018,3200,88.684,474,69,0.0809859154929577
"7237",190567,"CUNY CITY COLLEGE",1,0,2001,705,310,395,54,17,37,0.119,0.077,0.043,3200,168.117701,492,72,0.102127659574468
"7238",190567,"CUNY CITY COLLEGE",1,0,2002,961,435,526,65,28,37,0.085,0.068,0.053,3200,172.28601,478,134,0.139438085327784
"7239",190567,"CUNY CITY COLLEGE",1,0,2003,1124,547,577,62,20,42,0.077,0.055,0.035,4000,185.546397,512,138,0.122775800711744
"7240",190567,"CUNY CITY COLLEGE",1,0,2004,1168,531,637,106,45,61,0.115,0.091,0.071,4000,189.397559,532,137,0.117294520547945
"7241",190567,"CUNY City College",1,0,2005,1278,592,686,78,39,39,0.066,0.061,0.057,4000,202.021948,530,164,0.128325508607199
"7242",190567,"CUNY City College",1,0,2006,1529,760,769,114,43,71,0.093,0.075,0.056,4000,209.580386,521,224,0.146500981033355
"7243",190567,"CUNY City College",1,0,2007,1771,916,855,166,65,101,0.11,0.094,0.076,4000,225.734945,530,270,0.152456239412761
"7244",190567,"CUNY City College",1,0,2008,1744,919,825,182,67,115,0.125,0.104,0.081,4000,257.804128,567,271,0.155389908256881
"7245",190567,"CUNY City College",1,0,2009,1753,909,844,195,75,120,0.132,0.111,0.089,4600,324.855615,574,323,0.184255561893896
"7246",190567,"CUNY City College",1,0,2010,1368,685,683,171,58,113,0.165,0.125,0.085,4600,343.398478,588,241,0.176169590643275
"7247",190594,"CUNY HUNTER COLLEGE",1,0,1991,808,617,191,30,3,27,0.044,0.037,0.016,1953,126.457,548,163,0.201732673267327
"7248",190594,"CUNY HUNTER COLLEGE",1,0,1992,936,710,226,35,10,25,0.035,0.037,0.044,2555,127.911,529,200,0.213675213675214
"7249",190594,"CUNY HUNTER COLLEGE",1,0,1993,1308,1011,297,62,7,55,0.054,0.047,0.024,2555,140.589,572,284,0.217125382262997
"7250",190594,"CUNY HUNTER COLLEGE",1,0,1995,1091,807,284,82,13,69,0.086,0.075,0.046,3313,149.692,544,356,0.326306141154904
"7251",190594,"CUNY HUNTER COLLEGE",1,0,1996,1456,1008,448,127,28,99,0.098,0.087,0.062,3323,130.246,525,456,0.313186813186813
"7252",190594,"CUNY HUNTER COLLEGE",1,0,1997,1630,1137,493,136,26,110,0.097,0.083,0.053,3329,130.188,512,551,0.338036809815951
"7253",190594,"CUNY HUNTER COLLEGE",1,0,1998,1468,1026,442,134,29,105,0.102,0.091,0.066,3329,142.264,526,486,0.331062670299728
"7254",190594,"CUNY HUNTER COLLEGE",1,0,1999,1806,1281,525,176,36,140,0.109,0.097,0.069,3200,146.032,522,585,0.323920265780731
"7255",190594,"CUNY HUNTER COLLEGE",1,0,2000,1741,1227,514,188,43,145,0.118,0.108,0.084,3200,149.154,556.5,619,0.355542791499138
"7256",190594,"CUNY HUNTER COLLEGE",1,0,2001,1877,1284,593,234,41,193,0.15,0.125,0.069,3200,172.66616,591,670,0.356952583910495
"7257",190594,"CUNY HUNTER COLLEGE",1,0,2002,1445,1010,435,256,50,206,0.204,0.177,0.115,3200,173.932373,632,573,0.396539792387543
"7258",190594,"CUNY HUNTER COLLEGE",1,0,2003,1661,1113,548,280,63,217,0.195,0.169,0.115,4000,191.641448,612,641,0.385912101143889
"7259",190594,"CUNY HUNTER COLLEGE",1,0,2004,1824,1235,589,312,81,231,0.187,0.171,0.138,4000,192.571801,641,683,0.374451754385965
"7260",190594,"CUNY Hunter College",1,0,2005,1776,1199,577,356,97,259,0.216,0.2,0.168,4000,205.200317,633,692,0.38963963963964
"7261",190594,"CUNY Hunter College",1,0,2006,1813,1202,611,349,86,263,0.219,0.192,0.141,4000,239.299961,632,658,0.362934362934363
"7262",190594,"CUNY Hunter College",1,0,2007,1854,1226,628,402,89,313,0.255,0.217,0.142,4000,244.094353,668,699,0.377022653721683
"7263",190594,"CUNY Hunter College",1,0,2008,1988,1273,715,445,108,337,0.265,0.224,0.151,4000,268.289341,686,698,0.351106639839034
"7264",190594,"CUNY Hunter College",1,0,2009,1983,1241,742,487,115,372,0.3,0.246,0.155,4600,307.532835,694,708,0.357034795763994
"7265",190594,"CUNY Hunter College",1,0,2010,1740,1141,599,413,100,313,0.274,0.237,0.167,4600,337.285306,705,661,0.379885057471264
"7266",190637,"CUNY LEHMAN COLLEGE",1,0,1991,711,470,241,15,8,7,0.015,0.021,0.033,1960,61.092,330,74,0.10407876230661
"7267",190637,"CUNY LEHMAN COLLEGE",1,0,1992,692,468,224,21,6,15,0.032,0.03,0.027,2562,65.997,305,60,0.0867052023121387
"7268",190637,"CUNY LEHMAN COLLEGE",1,0,1993,663,455,208,15,1,14,0.031,0.023,0.005,2562,72.599,324,56,0.0844645550527904
"7269",190637,"CUNY LEHMAN COLLEGE",1,0,1995,506,345,161,32,7,25,0.072,0.063,0.043,3320,79.9,286,43,0.0849802371541502
"7270",190637,"CUNY LEHMAN COLLEGE",1,0,1996,605,422,183,45,8,37,0.088,0.074,0.044,3320,74.376,272,47,0.0776859504132231
"7271",190637,"CUNY LEHMAN COLLEGE",1,0,1997,736,519,217,45,11,34,0.066,0.061,0.051,3320,78.651,276,56,0.0760869565217391
"7272",190637,"CUNY LEHMAN COLLEGE",1,0,1998,581,398,183,28,8,20,0.05,0.048,0.044,3320,81.258,280,48,0.0826161790017212
"7273",190637,"CUNY LEHMAN COLLEGE",1,0,1999,604,416,188,44,19,25,0.06,0.073,0.101,3200,82.003,281,51,0.0844370860927152
"7274",190637,"CUNY LEHMAN COLLEGE",1,0,2000,542,367,175,45,11,34,0.093,0.083,0.063,3200,86.904,287.5,41,0.0756457564575646
"7275",190637,"CUNY LEHMAN COLLEGE",1,0,2001,642,441,201,77,18,59,0.134,0.12,0.09,3200,94.805891,294,39,0.0607476635514019
"7276",190637,"CUNY LEHMAN COLLEGE",1,0,2002,729,485,244,73,21,52,0.107,0.1,0.086,3200,98.91151,287,49,0.0672153635116598
"7277",190637,"CUNY LEHMAN COLLEGE",1,0,2003,790,529,261,85,20,65,0.123,0.108,0.077,4000,104.747517,308,59,0.0746835443037975
"7278",190637,"CUNY LEHMAN COLLEGE",1,0,2004,852,571,281,100,27,73,0.128,0.117,0.096,4000,108.776887,337,64,0.0751173708920188
"7279",190637,"CUNY Lehman College",1,0,2005,788,551,237,110,33,77,0.14,0.14,0.139,4000,117.662015,330,52,0.065989847715736
"7280",190637,"CUNY Lehman College",1,0,2006,911,674,237,131,24,107,0.159,0.144,0.101,4000,125.418775,344,64,0.0702524698133919
"7281",190637,"CUNY Lehman College",1,0,2007,874,610,264,129,35,94,0.154,0.148,0.133,4000,137.153411,363,59,0.0675057208237986
"7282",190637,"CUNY Lehman College",1,0,2008,987,654,333,139,40,99,0.151,0.141,0.12,4000,148.529721,373,63,0.0638297872340425
"7283",190637,"CUNY Lehman College",1,0,2009,754,461,293,111,34,77,0.167,0.147,0.116,4600,172.500984,374,55,0.0729442970822281
"7284",190637,"CUNY Lehman College",1,0,2010,619,386,233,116,33,83,0.215,0.187,0.142,4600,186.047708,384,45,0.0726978998384491
"7285",190664,"CUNY QUEENS COLLEGE",1,0,1991,1603,889,714,165,49,116,0.13,0.103,0.069,2033,111.748,579,848,0.529008109794136
"7286",190664,"QUEENS COLLEGE",1,0,1992,1448,819,629,146,35,111,0.136,0.101,0.056,2635,117.168,551,808,0.558011049723757
"7287",190664,"QUEENS COLLEGE",1,0,1993,1526,831,695,180,55,125,0.15,0.118,0.079,2635,130.371,631,809,0.530144167758847
"7288",190664,"QUEENS COLLEGE",1,0,1995,1444,805,639,228,81,147,0.183,0.158,0.127,3392,143.312,541,777,0.53808864265928
"7289",190664,"QUEENS COLLEGE",1,0,1996,1040,621,419,225,56,169,0.272,0.216,0.134,3393,123.337,516,547,0.525961538461538
"7290",190664,"CUNY QUEENS COLLEGE",1,0,1997,1153,675,478,227,65,162,0.24,0.197,0.136,3393,125.431,521,578,0.501300954032957
"7291",190664,"CUNY QUEENS COLLEGE",1,0,1998,1133,711,422,235,59,176,0.248,0.207,0.14,3393,133.744,514,558,0.492497793468667
"7292",190664,"CUNY QUEENS COLLEGE",1,0,1999,876,528,348,200,50,150,0.284,0.228,0.144,3200,138.109,516,448,0.511415525114155
"7293",190664,"CUNY QUEENS COLLEGE",1,0,2000,1085,639,446,254,65,189,0.296,0.234,0.146,3200,139.729,551.5,496,0.457142857142857
"7294",190664,"CUNY QUEENS COLLEGE",1,0,2001,1204,704,500,325,100,225,0.32,0.27,0.2,3200,139.187206,587,557,0.462624584717608
"7295",190664,"CUNY QUEENS COLLEGE",1,0,2002,1178,693,485,325,90,235,0.339,0.276,0.186,3200,151.502552,545,596,0.505942275042445
"7296",190664,"CUNY QUEENS COLLEGE",1,0,2003,1290,790,500,327,88,239,0.302,0.253,0.176,4000,161.385056,566,626,0.485271317829457
"7297",190664,"CUNY QUEENS COLLEGE",1,0,2004,1352,815,537,352,102,250,0.307,0.26,0.19,4000,165.085754,593,629,0.465236686390533
"7298",190664,"CUNY Queens College",1,0,2005,1470,884,586,381,101,280,0.317,0.259,0.172,4000,178.501824,577,708,0.481632653061224
"7299",190664,"CUNY Queens College",1,0,2006,1627,991,636,418,113,305,0.308,0.257,0.178,4000,188.581177,582,762,0.468346650276583
"7300",190664,"CUNY Queens College",1,0,2007,1755,1064,691,440,112,328,0.308,0.251,0.162,4000,207.070248,628,776,0.442165242165242
"7301",190664,"CUNY Queens College",1,0,2008,1642,961,681,445,125,320,0.333,0.271,0.184,4000,227.056377,630,667,0.406211936662607
"7302",190664,"CUNY Queens College",1,0,2009,1684,944,740,473,153,320,0.339,0.281,0.207,4600,270.206915,636,781,0.463776722090261
"7303",190664,"CUNY Queens College",1,0,2010,1471,821,650,452,133,319,0.389,0.307,0.205,4600,296.991061,641,679,0.461590754588715
"7304",190691,"CUNY YORK COLLEGE",1,0,1991,431,276,155,22,10,12,0.044,0.051,0.065,1932,33.556,131,17,0.0394431554524362
"7305",190691,"CUNY YORK COLLEGE",1,0,1992,640,392,248,22,12,10,0.025,0.034,0.048,2534,36.897,117,27,0.0421875
"7306",190691,"CUNY YORK COLLEGE",1,0,1993,607,359,248,29,13,16,0.045,0.048,0.052,2534,41.324,147,28,0.0461285008237232
"7307",190691,"CUNY YORK COLLEGE",1,0,1995,486,294,192,22,7,15,0.051,0.045,0.036,3291,48.485,141,27,0.0555555555555556
"7308",190691,"CUNY YORK COLLEGE",1,0,1996,543,368,175,47,16,31,0.084,0.087,0.091,3292,45.548,130,29,0.0534069981583794
"7309",190691,"CUNY YORK COLLEGE",1,0,1997,500,323,177,38,12,26,0.08,0.076,0.068,3292,46.42,139,26,0.052
"7310",190691,"CUNY YORK COLLEGE",1,0,1998,383,235,148,22,8,14,0.06,0.057,0.054,3292,48.096,142,27,0.0704960835509138
"7311",190691,"CUNY YORK COLLEGE",1,0,1999,425,261,164,31,11,20,0.077,0.073,0.067,3200,49.413,147,23,0.0541176470588235
"7312",190691,"CUNY YORK COLLEGE",1,0,2000,458,314,144,29,6,23,0.073,0.063,0.042,3200,51.049,157.5,30,0.0655021834061135
"7313",190691,"CUNY YORK COLLEGE",1,0,2001,464,320,144,35,11,24,0.075,0.075,0.076,3200,56.38398,168,28,0.0603448275862069
"7314",190691,"CUNY YORK COLLEGE",1,0,2002,563,385,178,34,8,26,0.068,0.06,0.045,3200,58.908985,154,27,0.0479573712255773
"7315",190691,"CUNY YORK COLLEGE",1,0,2003,565,366,199,30,8,22,0.06,0.053,0.04,4000,62.347352,164,37,0.0654867256637168
"7316",190691,"CUNY YORK COLLEGE",1,0,2004,727,453,274,27,8,19,0.042,0.037,0.029,4000,59.851695,172,45,0.061898211829436
"7317",190691,"CUNY York College",1,0,2005,746,481,265,27,5,22,0.046,0.036,0.019,4000,63.254305,180,40,0.0536193029490617
"7318",190691,"CUNY York College",1,0,2006,668,428,240,27,10,17,0.04,0.04,0.042,4000,70.946666,174,46,0.0688622754491018
"7319",190691,"CUNY York College",1,0,2007,983,636,347,50,11,39,0.061,0.051,0.032,4000,78.454277,183,53,0.0539165818921668
"7320",190691,"CUNY York College",1,0,2008,1024,673,351,80,26,54,0.08,0.078,0.074,4000,82.118355,205,77,0.0751953125
"7321",190691,"CUNY York College",1,0,2009,1028,627,401,50,12,38,0.061,0.049,0.03,4600,102.53853,220,88,0.0856031128404669
"7322",190691,"CUNY York College",1,0,2010,1085,652,433,71,16,55,0.084,0.065,0.037,4600,115.641365,233,82,0.0755760368663594
"7323",190725,"DAEMEN COLLEGE",1,0,1991,244,164,80,40,14,26,0.158,0.164,0.175,7980,17.49,65,207,0.848360655737705
"7324",190725,"DAEMEN COLLEGE",1,0,1992,302,205,97,45,9,36,0.176,0.149,0.093,8330,20.202,66,244,0.80794701986755
"7325",190725,"DAEMEN COLLEGE",1,0,1993,405,271,134,58,19,39,0.144,0.143,0.142,8730,18.698,69,358,0.883950617283951
"7326",190725,"DAEMEN COLLEGE",1,0,1995,398,269,129,77,20,57,0.212,0.193,0.155,9780,18.765,75,362,0.909547738693467
"7327",190725,"DAEMEN COLLEGE",1,0,1996,372,259,113,69,11,58,0.224,0.185,0.097,10330,21.981728,74,336,0.903225806451613
"7328",190725,"DAEMEN COLLEGE",1,0,1997,416,313,103,87,22,65,0.208,0.209,0.214,10980,17.996555,77,360,0.865384615384615
"7329",190725,"DAEMEN COLLEGE",1,0,1998,345,262,83,80,20,60,0.229,0.232,0.241,11100,18.437453,72,293,0.849275362318841
"7330",190725,"DAEMEN COLLEGE",1,0,1999,293,230,63,70,17,53,0.23,0.239,0.27,11800,19.023785,72,222,0.757679180887372
"7331",190725,"DAEMEN COLLEGE",1,0,2000,317,254,63,77,13,64,0.252,0.243,0.206,12500,18.789563,72.5,247,0.779179810725552
"7332",190725,"DAEMEN COLLEGE",1,0,2001,340,278,62,88,12,76,0.273,0.259,0.194,13200,19.61283,73,243,0.714705882352941
"7333",190725,"DAEMEN COLLEGE",1,0,2002,316,246,70,84,16,68,0.276,0.266,0.229,13850,21.139124,77,254,0.80379746835443
"7334",190725,"DAEMEN COLLEGE",1,0,2003,356,252,104,108,23,85,0.337,0.303,0.221,14700,23.486605,77,269,0.75561797752809
"7335",190725,"DAEMEN COLLEGE",1,0,2004,264,198,66,62,11,51,0.258,0.235,0.167,15570,26.080671,80,191,0.723484848484849
"7336",190725,"Daemen College",1,0,2005,366,288,78,91,12,79,0.274,0.249,0.154,16350,27.964942,83,300,0.819672131147541
"7337",190725,"Daemen College",1,0,2006,368,284,84,100,22,78,0.275,0.272,0.262,17240,29.298153,85,315,0.855978260869565
"7338",190725,"Daemen College",1,0,2007,361,268,93,99,19,80,0.299,0.274,0.204,18300,30.823761,89,299,0.828254847645429
"7339",190725,"Daemen College",1,0,2008,405,309,96,110,24,86,0.278,0.272,0.25,19400,32.242711,99,324,0.8
"7340",190725,"Daemen College",1,0,2009,400,306,94,103,29,74,0.242,0.258,0.309,20250,34.123141,105,320,0.8
"7341",190725,"Daemen College",1,0,2010,441,325,116,148,36,112,0.345,0.336,0.31,20950,36.637022,110,314,0.712018140589569
"7342",191241,"FORDHAM UNIVERSITY",1,0,1991,952,507,445,641,292,349,0.688,0.673,0.656,11100,149.933,521,677,0.711134453781513
"7343",191241,"FORDHAM UNIVERSITY",1,0,1992,1039,546,493,623,294,329,0.603,0.6,0.596,12170,160.253,513,693,0.666987487969201
"7344",191241,"FORDHAM UNIVERSITY",1,0,1993,989,532,457,587,271,316,0.594,0.594,0.593,13375,164.827,498,629,0.635995955510617
"7345",191241,"FORDHAM UNIVERSITY",1,0,1995,1120,620,500,794,323,471,0.76,0.709,0.646,14900,186.481,508,777,0.69375
"7346",191241,"FORDHAM UNIVERSITY",1,0,1996,1206,694,512,822,338,484,0.697,0.682,0.66,15800,201.893879,525,789,0.654228855721393
"7347",191241,"FORDHAM UNIVERSITY",1,0,1997,1459,849,610,1075,445,630,0.742,0.737,0.73,16800,171.144146,569,971,0.665524331734064
"7348",191241,"FORDHAM UNIVERSITY",1,0,1998,1532,912,620,1111,422,689,0.755,0.725,0.681,18435,185.874422,603,992,0.647519582245431
"7349",191241,"FORDHAM UNIVERSITY",1,0,1999,1538,891,647,1105,443,662,0.743,0.718,0.685,19200,205.199136,594,1008,0.655396618985696
"7350",191241,"FORDHAM UNIVERSITY",1,0,2000,1632,975,657,1183,468,715,0.733,0.725,0.712,20200,215.63861,597.5,1008,0.617647058823529
"7351",191241,"FORDHAM UNIVERSITY",1,0,2001,1610,950,660,1218,470,748,0.787,0.757,0.712,21210,235.567518,601,1022,0.634782608695652
"7352",191241,"FORDHAM UNIVERSITY",1,0,2002,1694,1020,674,1263,478,785,0.77,0.746,0.709,22913,248.190323,595,1042,0.615112160566706
"7353",191241,"FORDHAM UNIVERSITY",1,0,2003,1687,961,726,1265,547,718,0.747,0.75,0.753,24001,288.352132,625,1045,0.619442797866034
"7354",191241,"FORDHAM UNIVERSITY",1,0,2004,1674,997,677,1269,486,783,0.785,0.758,0.718,26085,302.635389,645,986,0.589008363201912
"7355",191241,"Fordham University",1,0,2005,1734,983,751,1282,548,734,0.747,0.739,0.73,27769,324.647303,654,1069,0.616493656286044
"7356",191241,"Fordham University",1,0,2006,1697,929,768,1300,578,722,0.777,0.766,0.753,29715,347.774862,667,1083,0.638185032410136
"7357",191241,"Fordham University",1,0,2007,1760,910,850,1338,645,693,0.762,0.76,0.759,31375,369.164541,686,1056,0.6
"7358",191241,"Fordham University",1,0,2008,1852,991,861,1385,629,756,0.763,0.748,0.731,34099,396.050047,723,1078,0.58207343412527
"7359",191241,"Fordham University",1,0,2009,1811,926,885,1358,647,711,0.768,0.75,0.731,35717,421.538132,699,1169,0.645499723909442
"7360",191241,"Fordham University",1,0,2010,1865,1021,844,1388,607,781,0.765,0.744,0.719,37050,433.047012,703,1223,0.655764075067024
"7361",191515,"HAMILTON COLLEGE",1,0,1991,462,207,255,384,204,180,0.87,0.831,0.8,16650,45.428,135,391,0.846320346320346
"7362",191515,"HAMILTON COLLEGE",1,0,1992,461,223,238,373,178,195,0.874,0.809,0.748,17650,48.432,148,385,0.835140997830803
"7363",191515,"HAMILTON COLLEGE",1,0,1993,452,195,257,361,192,169,0.867,0.799,0.747,18650,50.536,149,378,0.836283185840708
"7364",191515,"HAMILTON COLLEGE",1,0,1995,488,237,251,392,194,198,0.835,0.803,0.773,20700,57.538,152,435,0.891393442622951
"7365",191515,"HAMILTON COLLEGE",1,0,1996,497,239,258,392,196,196,0.82,0.789,0.76,21700,62.291,147,446,0.89738430583501
"7366",191515,"HAMILTON COLLEGE",1,0,1997,457,239,218,381,172,209,0.875,0.834,0.789,22700,53.96,138,400,0.87527352297593
"7367",191515,"HAMILTON COLLEGE",1,0,1998,464,238,226,372,170,202,0.849,0.802,0.752,23600,56.649139,148,396,0.853448275862069
"7368",191515,"HAMILTON COLLEGE",1,0,1999,500,254,246,408,190,218,0.858,0.816,0.772,25000,61.135493,151,418,0.836
"7369",191515,"HAMILTON COLLEGE",1,0,2000,467,251,216,386,172,214,0.853,0.827,0.796,26000,64.8984,159.5,383,0.820128479657388
"7370",191515,"HAMILTON COLLEGE",1,0,2001,465,233,232,386,185,201,0.863,0.83,0.797,27250,70.236,168,389,0.836559139784946
"7371",191515,"HAMILTON COLLEGE",1,0,2002,492,252,240,418,195,223,0.885,0.85,0.812,28610,70.794,196,403,0.819105691056911
"7372",191515,"HAMILTON COLLEGE",1,0,2003,464,234,230,383,185,198,0.846,0.825,0.804,30000,85.742,202,370,0.797413793103448
"7373",191515,"HAMILTON COLLEGE",1,0,2004,457,236,221,385,180,205,0.869,0.842,0.814,31500,86.709,202,281,0.614879649890591
"7374",191515,"Hamilton College",1,0,2005,496,248,248,417,198,219,0.883,0.841,0.798,33150,93.993,191,342,0.689516129032258
"7375",191515,"Hamilton College",1,0,2006,501,267,234,424,195,229,0.858,0.846,0.833,34780,96.447,200,360,0.718562874251497
"7376",191515,"Hamilton College",1,0,2007,468,247,221,419,193,226,0.915,0.895,0.873,36500,102.362,194,338,0.722222222222222
"7377",191515,"Hamilton College",1,0,2008,461,257,204,396,164,232,0.903,0.859,0.804,38220,107.606,200,309,0.670281995661605
"7378",191515,"Hamilton College",1,0,2009,466,241,225,407,180,227,0.942,0.873,0.8,39370,111.681,191,291,0.624463519313305
"7379",191515,"Hamilton College",1,0,2010,467,252,215,414,185,229,0.909,0.887,0.86,40870,114.247,194,279,0.597430406852248
"7380",191533,"HARTWICK COLLEGE",1,0,1991,370,217,153,201,74,127,0.585,0.543,0.484,13350,31.397,122,341,0.921621621621622
"7381",191533,"HARTWICK COLLEGE",1,0,1992,446,228,218,248,108,140,0.614,0.556,0.495,14350,31.8,117,410,0.919282511210762
"7382",191533,"HARTWICK COLLEGE",1,0,1993,429,217,212,201,80,121,0.558,0.469,0.377,16400,33.578,123,383,0.892773892773893
"7383",191533,"HARTWICK COLLEGE",1,0,1995,453,229,224,227,88,139,0.607,0.501,0.393,19300,37.595,103,396,0.874172185430464
"7384",191533,"HARTWICK COLLEGE",1,0,1996,482,257,225,228,93,135,0.525,0.473,0.413,20805,42.219,112,411,0.852697095435685
"7385",191533,"HARTWICK COLLEGE",1,0,1997,388,197,191,209,94,115,0.584,0.539,0.492,21065,50.188511,109,283,0.729381443298969
"7386",191533,"HARTWICK COLLEGE",1,0,1998,440,227,213,204,82,122,0.537,0.464,0.385,23090,39.081887,104,305,0.693181818181818
"7387",191533,"HARTWICK COLLEGE",1,0,1999,407,210,197,192,75,117,0.557,0.472,0.381,23745,40.572223,108,287,0.705159705159705
"7388",191533,"HARTWICK COLLEGE",1,0,2000,425,245,180,188,61,127,0.518,0.442,0.339,24760,43.272251,106.5,290,0.682352941176471
"7389",191533,"HARTWICK COLLEGE",1,0,2001,433,232,201,200,73,127,0.547,0.462,0.363,25715,43.175222,105,272,0.628175519630485
"7390",191533,"HARTWICK COLLEGE",1,0,2002,375,224,151,165,56,109,0.487,0.44,0.371,26615,42.47382,104,255,0.68
"7391",191533,"HARTWICK COLLEGE",1,0,2003,447,236,211,210,77,133,0.564,0.47,0.365,27400,41.100072,101,279,0.624161073825503
"7392",191533,"HARTWICK COLLEGE",1,0,2004,409,219,190,189,80,109,0.498,0.462,0.421,25830,40.610119,105,254,0.621026894865526
"7393",191533,"Hartwick College",1,0,2005,405,212,193,182,77,105,0.495,0.449,0.399,26480,41.668361,108,256,0.632098765432099
"7394",191533,"Hartwick College",1,0,2006,464,270,194,235,88,147,0.544,0.506,0.454,27450,43.216964,112,302,0.650862068965517
"7395",191533,"Hartwick College",1,0,2007,452,256,196,243,92,151,0.59,0.538,0.469,30125,43.961101,107,290,0.641592920353982
"7396",191533,"Hartwick College",1,0,2008,444,250,194,224,91,133,0.532,0.505,0.469,31330,46.149136,108,292,0.657657657657658
"7397",191533,"Hartwick College",1,0,2009,402,239,163,202,66,136,0.569,0.502,0.405,32550,46.250176,103,253,0.629353233830846
"7398",191533,"Hartwick College",1,0,2010,487,270,217,241,104,137,0.507,0.495,0.479,33850,42.979694,104,344,0.706365503080082
"7399",191630,"HOBART WILLIAM SMITH COLLEGES",0,1,1991,503,211,292,334,174,160,0.758,0.664,0.596,16396,42.752,130,419,0.833001988071571
"7400",191630,"HOBART WILLIAM SMITH COLLEGES",0,1,1992,564,261,303,349,167,182,0.697,0.619,0.551,17291,46.524,141,481,0.852836879432624
"7401",191630,"HOBART WILLIAM SMITH COLLEGES",0,1,1993,493,236,257,325,146,179,0.758,0.659,0.568,18309,49.645,134,435,0.882352941176471
"7402",191630,"HOBART WILLIAM SMITH COLLEGES",0,1,1995,458,244,214,318,137,181,0.742,0.694,0.64,20393,52.237,132,399,0.87117903930131
"7403",191630,"HOBART WILLIAM SMITH COLLEGES",0,1,1996,530,267,263,356,161,195,0.73,0.672,0.612,21381,54.865397,131,445,0.839622641509434
"7404",191630,"HOBART WILLIAM SMITH COLLEGES",0,1,1997,549,284,265,354,174,180,0.634,0.645,0.657,22380,40.770377,132,448,0.816029143897996
"7405",191630,"HOBART WILLIAM SMITH COLLEGES",0,1,1998,488,280,208,347,129,218,0.779,0.711,0.62,23448,43.578882,132,416,0.852459016393443
"7406",191630,"HOBART WILLIAM SMITH COLLEGES",0,1,1999,502,255,247,307,133,174,0.682,0.612,0.538,23865,44.232505,135,440,0.876494023904382
"7407",191630,"HOBART WILLIAM SMITH COLLEGES",1,0,2000,521,282,239,353,144,209,0.741,0.678,0.603,24700,46.125384,142,445,0.854126679462572
"7408",191630,"HOBART WILLIAM SMITH COLLEGES",1,0,2001,548,313,235,368,137,231,0.738,0.672,0.583,25664,49.084972,149,473,0.863138686131387
"7409",191630,"HOBART WILLIAM SMITH COLLEGES",1,0,2002,532,283,249,367,151,216,0.763,0.69,0.606,26818,52.982146,152,457,0.859022556390977
"7410",191630,"HOBART WILLIAM SMITH COLLEGES",1,0,2003,516,267,249,383,176,207,0.775,0.742,0.707,28400,55.51774,169,448,0.868217054263566
"7411",191630,"HOBART WILLIAM SMITH COLLEGES",1,0,2004,482,255,227,337,142,195,0.765,0.699,0.626,30076,59.529332,172,428,0.887966804979253
"7412",191630,"Hobart William Smith Colleges",1,0,2005,545,283,262,377,159,218,0.77,0.692,0.607,31850,62.876776,174,475,0.871559633027523
"7413",191630,"Hobart William Smith Colleges",1,0,2006,597,319,278,428,182,246,0.771,0.717,0.655,33730,67.130881,183,534,0.894472361809045
"7414",191630,"Hobart William Smith Colleges",1,0,2007,600,338,262,444,172,272,0.805,0.74,0.656,35720,72.855663,173,419,0.698333333333333
"7415",191630,"Hobart William Smith Colleges",1,0,2008,544,288,256,404,179,225,0.781,0.743,0.699,37820,78.032865,176,262,0.481617647058824
"7416",191630,"Hobart William Smith Colleges",1,0,2009,545,315,230,416,161,255,0.809,0.763,0.7,39144,88.645249,181,311,0.570642201834862
"7417",191630,"Hobart William Smith Colleges",1,0,2010,618,339,279,448,182,266,0.785,0.725,0.652,40592,85.629075,179,442,0.715210355987055
"7418",191649,"HOFSTRA UNIVERSITY",1,0,1991,1338,747,591,567,190,377,0.505,0.424,0.321,9790,157.144,420,628,0.469357249626308
"7419",191649,"HOFSTRA UNIVERSITY",1,0,1992,1403,769,634,571,196,375,0.488,0.407,0.309,10490,162.586,418,656,0.467569493941554
"7420",191649,"HOFSTRA UNIVERSITY",1,0,1993,1349,705,644,524,191,333,0.472,0.388,0.297,11080,168.822,418,902,0.668643439584878
"7421",191649,"HOFSTRA UNIVERSITY",1,0,1995,1518,830,688,559,201,358,0.431,0.368,0.292,12360,181.681,429,970,0.638998682476943
"7422",191649,"HOFSTRA UNIVERSITY",1,0,1996,1735,996,739,653,217,436,0.438,0.376,0.294,12966,191.933915,432,664,0.382708933717579
"7423",191649,"HOFSTRA UNIVERSITY",1,0,1997,1743,928,815,648,221,427,0.46,0.372,0.271,13544,186.545437,448,924,0.530120481927711
"7424",191649,"HOFSTRA UNIVERSITY",1,0,1998,1749,907,842,593,217,376,0.415,0.339,0.258,14000,200.213107,462,972,0.555746140651801
"7425",191649,"HOFSTRA UNIVERSITY",1,0,1999,1876,1015,861,675,242,433,0.427,0.36,0.281,13750,204.309908,473,1105,0.589019189765458
"7426",191649,"HOFSTRA UNIVERSITY",1,0,2000,1937,1036,901,703,266,437,0.422,0.363,0.295,14280,218.860155,468.5,1101,0.568404749612803
"7427",191649,"HOFSTRA UNIVERSITY",1,0,2001,1974,1037,937,685,248,437,0.421,0.347,0.265,14920,236.50102,464,1232,0.624113475177305
"7428",191649,"HOFSTRA UNIVERSITY",1,0,2002,1764,912,852,693,254,439,0.481,0.393,0.298,15740,230.876493,489,1181,0.669501133786848
"7429",191649,"HOFSTRA UNIVERSITY",1,0,2003,1855,979,876,768,290,478,0.488,0.414,0.331,17410,248.545077,508,1181,0.636657681940701
"7430",191649,"HOFSTRA UNIVERSITY",1,0,2004,1713,885,828,750,303,447,0.505,0.438,0.366,19010,251.334791,518,1102,0.643315820198482
"7431",191649,"Hofstra University",1,0,2005,1759,961,798,763,281,482,0.502,0.434,0.352,20500,262.914991,527,1065,0.605457646389994
"7432",191649,"Hofstra University",1,0,2006,1706,865,841,768,335,433,0.501,0.45,0.398,22200,286.913354,532,1067,0.625439624853458
"7433",191649,"Hofstra University",1,0,2007,1716,907,809,850,344,506,0.558,0.495,0.425,25700,297.783242,544,1131,0.659090909090909
"7434",191649,"Hofstra University",1,0,2008,1637,864,773,816,344,472,0.546,0.498,0.445,27600,314.16511,551,1137,0.69456322541234
"7435",191649,"Hofstra University",1,0,2009,1554,834,720,755,297,458,0.549,0.486,0.412,29080,333.226886,544,1045,0.672458172458172
"7436",191649,"Hofstra University",1,0,2010,1435,819,616,764,289,475,0.58,0.532,0.469,30750,333.079206,533,884,0.61602787456446
"7437",191676,"HOUGHTON COLLEGE",1,0,1991,244,152,92,119,46,73,0.48,0.488,0.5,8676,16.477,75,219,0.897540983606557
"7438",191676,"HOUGHTON COLLEGE",1,0,1992,296,195,101,141,44,97,0.497,0.476,0.436,9230,18.434,74,264,0.891891891891892
"7439",191676,"HOUGHTON COLLEGE",1,0,1993,287,182,105,147,50,97,0.533,0.512,0.476,9720,19.575,77,254,0.885017421602787
"7440",191676,"HOUGHTON COLLEGE",1,0,1995,293,213,80,171,52,119,0.559,0.584,0.65,10890,23.892,77,263,0.897610921501707
"7441",191676,"HOUGHTON COLLEGE",1,0,1996,288,194,94,164,47,117,0.603,0.569,0.5,12060,24.940536,77,252,0.875
"7442",191676,"HOUGHTON COLLEGE",1,0,1997,310,198,112,179,65,114,0.576,0.577,0.58,12764,19.900034,78,277,0.893548387096774
"7443",191676,"HOUGHTON COLLEGE",1,0,1998,309,204,105,180,50,130,0.637,0.583,0.476,12776,20.931244,78,272,0.880258899676375
"7444",191676,"HOUGHTON COLLEGE",1,0,1999,294,186,108,166,56,110,0.591,0.565,0.519,14590,20.791241,78,273,0.928571428571429
"7445",191676,"HOUGHTON COLLEGE",1,0,2000,358,226,132,217,75,142,0.628,0.606,0.568,15180,23.913301,83,330,0.921787709497207
"7446",191676,"HOUGHTON COLLEGE",1,0,2001,355,229,126,222,77,145,0.633,0.625,0.611,16290,26.544476,88,328,0.923943661971831
"7447",191676,"HOUGHTON COLLEGE",1,0,2002,289,201,88,187,54,133,0.662,0.647,0.614,17160,27.942515,86,262,0.906574394463668
"7448",191676,"HOUGHTON COLLEGE",1,0,2003,299,203,96,179,53,126,0.621,0.599,0.552,17984,29.836957,85,272,0.909698996655518
"7449",191676,"HOUGHTON COLLEGE",1,0,2004,320,212,108,186,56,130,0.613,0.581,0.519,18660,31.043225,89,290,0.90625
"7450",191676,"Houghton College",1,0,2005,321,211,110,180,57,123,0.583,0.561,0.518,19420,32.245849,89,299,0.931464174454829
"7451",191676,"Houghton College",1,0,2006,306,195,111,177,58,119,0.61,0.578,0.523,20400,32.974439,92,276,0.901960784313726
"7452",191676,"Houghton College",1,0,2007,264,174,90,171,54,117,0.672,0.648,0.6,21620,33.794008,92,239,0.90530303030303
"7453",191676,"Houghton College",1,0,2008,327,211,116,193,56,137,0.649,0.59,0.483,22990,35.536672,94,284,0.868501529051988
"7454",191676,"Houghton College",1,0,2009,282,199,83,186,53,133,0.668,0.66,0.639,24440,35.474724,88,245,0.868794326241135
"7455",191676,"Houghton College",1,0,2010,253,178,75,154,46,108,0.607,0.609,0.613,25360,34.29269,91,221,0.873517786561265
"7456",191931,"IONA COLLEGE",1,0,1991,1046,526,520,290,122,168,0.319,0.277,0.235,9000,59.491,207,646,0.617590822179732
"7457",191931,"IONA COLLEGE",1,0,1992,1012,522,490,322,136,186,0.356,0.318,0.278,9500,70.058,204,663,0.655138339920949
"7458",191931,"IONA COLLEGE",1,0,1993,951,455,496,260,117,143,0.314,0.273,0.236,10210,65.425,192,641,0.674027339642482
"7459",191931,"IONA COLLEGE",1,0,1995,609,288,321,203,73,130,0.451,0.333,0.227,11330,61.201,175,369,0.605911330049261
"7460",191931,"IONA COLLEGE",1,0,1996,662,320,342,260,100,160,0.5,0.393,0.292,12200,56.151,167,422,0.637462235649547
"7461",191931,"IONA COLLEGE",1,0,1997,695,312,383,263,98,165,0.529,0.378,0.256,13420,48.733759,170,439,0.631654676258993
"7462",191931,"IONA COLLEGE",1,0,1998,696,302,394,279,117,162,0.536,0.401,0.297,14000,48.28087,170,501,0.719827586206897
"7463",191931,"IONA COLLEGE",1,0,1999,790,349,441,335,147,188,0.539,0.424,0.333,14700,52.640739,169,540,0.683544303797468
"7464",191931,"IONA COLLEGE",1,0,2000,723,351,372,337,132,205,0.584,0.466,0.355,15500,58.611235,164.5,518,0.716459197786999
"7465",191931,"IONA COLLEGE",1,0,2001,768,376,392,360,144,216,0.575,0.469,0.367,16500,55.015895,160,503,0.654947916666667
"7466",191931,"IONA COLLEGE",1,0,2002,731,379,352,337,123,214,0.565,0.461,0.349,17326,55.584304,168,492,0.673050615595075
"7467",191931,"IONA COLLEGE",1,0,2003,811,434,377,409,152,257,0.592,0.504,0.403,17750,60.083051,171,553,0.681874229346486
"7468",191931,"IONA COLLEGE",1,0,2004,854,458,396,448,175,273,0.596,0.525,0.442,18990,64.086805,178,617,0.72248243559719
"7469",191931,"Iona College",1,0,2005,776,419,357,375,150,225,0.537,0.483,0.42,20110,67.743728,173,537,0.69201030927835
"7470",191931,"Iona College",1,0,2006,903,504,399,506,181,325,0.645,0.56,0.454,21518,73.160339,175,622,0.688815060908084
"7471",191931,"Iona College",1,0,2007,906,486,420,476,195,281,0.578,0.525,0.464,23024,79.60026,174,623,0.687637969094923
"7472",191931,"Iona College",1,0,2008,921,498,423,469,167,302,0.606,0.509,0.395,24406,79.788089,176,620,0.673181324647123
"7473",191931,"Iona College",1,0,2009,792,480,312,448,150,298,0.621,0.566,0.481,25600,82.901529,181,518,0.654040404040404
"7474",191931,"Iona College",1,0,2010,871,504,367,525,202,323,0.641,0.603,0.55,26850,86.413807,185,556,0.638346727898967
"7475",191968,"ITHACA COLLEGE",1,0,1991,1638,831,807,1036,477,559,0.673,0.632,0.591,11946,108.044,399,1519,0.927350427350427
"7476",191968,"ITHACA COLLEGE",1,0,1992,1566,832,734,978,425,553,0.665,0.625,0.579,12870,117.098,414,1455,0.92911877394636
"7477",191968,"ITHACA COLLEGE",1,0,1993,1365,721,644,813,345,468,0.649,0.596,0.536,13642,120.785,414,1266,0.927472527472528
"7478",191968,"ITHACA COLLEGE",1,0,1995,1625,878,747,1052,440,612,0.697,0.647,0.589,15250,124.189,391,1472,0.905846153846154
"7479",191968,"ITHACA COLLEGE",1,0,1996,1426,820,606,908,355,553,0.674,0.637,0.586,16130,130.634,371,1302,0.91304347826087
"7480",191968,"ITHACA COLLEGE",1,0,1997,1417,801,616,909,362,547,0.683,0.641,0.588,16900,101.374,374,1286,0.907551164431898
"7481",191968,"ITHACA COLLEGE",1,0,1998,1337,759,578,909,379,530,0.698,0.68,0.656,17662,109.034,385,1232,0.921465968586387
"7482",191968,"ITHACA COLLEGE",1,0,1999,1586,885,701,1022,418,604,0.682,0.644,0.596,18410,111.395,393,1411,0.889659520807062
"7483",191968,"ITHACA COLLEGE",1,0,2000,1675,940,735,1149,474,675,0.718,0.686,0.645,19192,118.918,406,1468,0.876417910447761
"7484",191968,"ITHACA COLLEGE",1,0,2001,1755,1002,753,1230,501,729,0.728,0.701,0.665,20104,125.060394,419,1569,0.894017094017094
"7485",191968,"ITHACA COLLEGE",1,0,2002,1515,896,619,1083,441,642,0.717,0.715,0.712,21102,133.64435,446,1354,0.893729372937294
"7486",191968,"ITHACA COLLEGE",1,0,2003,1581,912,669,1118,456,662,0.726,0.707,0.682,22264,142.199117,467,1332,0.842504743833017
"7487",191968,"ITHACA COLLEGE",1,0,2004,1458,831,627,1013,411,602,0.724,0.695,0.656,23690,149.698904,451,1242,0.851851851851852
"7488",191968,"Ithaca College",1,0,2005,1679,885,794,1117,521,596,0.673,0.665,0.656,25194,156.079639,454,1436,0.855270994639666
"7489",191968,"Ithaca College",1,0,2006,1519,819,700,1059,466,593,0.724,0.697,0.666,26832,163.861973,474,1180,0.776826859776168
"7490",191968,"Ithaca College",1,0,2007,1794,1055,739,1241,488,753,0.714,0.692,0.66,28670,174.51284,468,1422,0.792642140468227
"7491",191968,"Ithaca College",1,0,2008,1441,862,579,1017,397,620,0.719,0.706,0.686,30606,187.737637,472,972,0.674531575294934
"7492",191968,"Ithaca College",1,0,2009,2024,1144,880,1390,571,819,0.716,0.687,0.649,32060,188.197281,465,1452,0.717391304347826
"7493",191968,"Ithaca College",1,0,2010,1614,869,745,1071,442,629,0.724,0.664,0.593,33630,192.668966,481,1132,0.701363073110285
"7494",192192,"KEUKA COLLEGE",1,0,1991,139,112,27,65,15,50,0.446,0.468,0.556,7900,9.594,41,128,0.920863309352518
"7495",192192,"KEUKA COLLEGE",1,0,1992,160,121,39,53,12,41,0.339,0.331,0.308,8770,11.286,40,154,0.9625
"7496",192192,"KEUKA COLLEGE",1,0,1993,172,124,48,47,13,34,0.274,0.273,0.271,9100,11.707,44,155,0.901162790697674
"7497",192192,"KEUKA COLLEGE",1,0,1995,200,154,46,69,10,59,0.383,0.345,0.217,9960,14.988,52,189,0.945
"7498",192192,"KEUKA COLLEGE",1,0,1996,234,168,66,61,17,44,0.262,0.261,0.258,10490,15.968518,46,217,0.927350427350427
"7499",192192,"KEUKA COLLEGE",1,0,1997,141,112,29,69,12,57,0.509,0.489,0.414,11040,13.142134,48,139,0.985815602836879
"7500",192192,"KEUKA COLLEGE",1,0,1998,226,180,46,75,15,60,0.333,0.332,0.326,12185,15.37009,46,214,0.946902654867257
"7501",192192,"KEUKA COLLEGE",1,0,1999,268,192,76,90,23,67,0.349,0.336,0.303,12730,14.132694,48,236,0.880597014925373
"7502",192192,"KEUKA COLLEGE",1,0,2000,281,183,98,83,28,55,0.3,0.295,0.286,13490,15.016096,49.5,218,0.775800711743772
"7503",192192,"KEUKA COLLEGE",1,0,2001,253,188,65,88,14,74,0.394,0.348,0.215,14050,15.5977,51,225,0.889328063241107
"7504",192192,"KEUKA COLLEGE",1,0,2002,195,138,57,81,21,60,0.435,0.415,0.368,14890,17.774984,52,167,0.856410256410256
"7505",192192,"KEUKA COLLEGE",1,0,2003,239,168,71,107,29,78,0.464,0.448,0.408,15790,18.537419,48,209,0.874476987447699
"7506",192192,"KEUKA COLLEGE",1,0,2004,245,170,75,120,29,91,0.535,0.49,0.387,16820,19.154844,50,208,0.848979591836735
"7507",192192,"Keuka College",1,0,2005,268,179,89,111,31,80,0.447,0.414,0.348,17800,20.598143,52,229,0.854477611940298
"7508",192192,"Keuka College",1,0,2006,232,147,85,106,44,62,0.422,0.457,0.518,18850,23.902375,51,195,0.84051724137931
"7509",192192,"Keuka College",1,0,2007,274,192,82,98,28,70,0.365,0.358,0.341,19960,26.334013,53,217,0.791970802919708
"7510",192192,"Keuka College",1,0,2008,270,200,70,98,21,77,0.385,0.363,0.3,21140,29.077387,55,220,0.814814814814815
"7511",192192,"Keuka College",1,0,2009,254,175,79,57,24,33,0.189,0.224,0.304,22040,30.249063,62,210,0.826771653543307
"7512",192192,"Keuka College",1,0,2010,270,196,74,141,32,109,0.556,0.522,0.432,23130,31.732877,75,210,0.777777777777778
"7513",192323,"LE MOYNE COLLEGE",1,0,1991,404,212,192,261,118,143,0.674,0.646,0.615,9290,27.841,122,354,0.876237623762376
"7514",192323,"LE MOYNE COLLEGE",1,0,1992,371,215,156,254,105,149,0.693,0.685,0.673,9620,31.056,117,328,0.884097035040431
"7515",192323,"LE MOYNE COLLEGE",1,0,1993,415,213,202,254,107,147,0.69,0.612,0.53,10640,31.943,119,362,0.872289156626506
"7516",192323,"LE MOYNE COLLEGE",1,0,1995,397,236,161,258,98,160,0.678,0.65,0.609,12015,36.43,126,329,0.828715365239295
"7517",192323,"LE MOYNE COLLEGE",1,0,1996,434,255,179,305,115,190,0.745,0.703,0.642,12750,37.338555,122,395,0.910138248847926
"7518",192323,"LE MOYNE COLLEGE",1,0,1997,453,292,161,299,101,198,0.678,0.66,0.627,13520,31.349413,125,389,0.858719646799117
"7519",192323,"LE MOYNE COLLEGE",1,0,1998,471,279,192,309,114,195,0.699,0.656,0.594,14230,33.303955,121,406,0.861995753715499
"7520",192323,"LE MOYNE COLLEGE",1,0,1999,471,264,207,304,121,183,0.693,0.645,0.585,14580,34.783365,126,389,0.825902335456476
"7521",192323,"LE MOYNE COLLEGE",1,0,2000,510,291,219,298,119,179,0.615,0.584,0.543,15370,37.398463,129,413,0.809803921568627
"7522",192323,"LE MOYNE COLLEGE",1,0,2001,502,292,210,311,122,189,0.647,0.62,0.581,16350,40.313605,132,428,0.852589641434263
"7523",192323,"LE MOYNE COLLEGE",1,0,2002,561,333,228,388,144,244,0.733,0.692,0.632,17410,42.375425,142,458,0.816399286987522
"7524",192323,"LE MOYNE COLLEGE",1,0,2003,503,310,193,323,115,208,0.671,0.642,0.596,18440,46.235556,153,422,0.8389662027833
"7525",192323,"LE MOYNE COLLEGE",1,0,2004,473,277,196,305,115,190,0.686,0.645,0.587,19640,48.094798,152,384,0.81183932346723
"7526",192323,"Le Moyne College",1,0,2005,519,308,211,320,123,197,0.64,0.617,0.583,20770,49.726785,154,425,0.81888246628131
"7527",192323,"Le Moyne College",1,0,2006,544,330,214,329,120,209,0.633,0.605,0.561,21860,53.958393,161,451,0.829044117647059
"7528",192323,"Le Moyne College",1,0,2007,577,348,229,362,125,237,0.681,0.627,0.546,23040,56.977765,157,483,0.837088388214905
"7529",192323,"Le Moyne College",1,0,2008,541,335,206,331,114,217,0.648,0.612,0.553,24280,59.019709,157,456,0.842883548983364
"7530",192323,"Le Moyne College",1,0,2009,605,394,211,344,102,242,0.614,0.569,0.483,25110,60.639931,156,495,0.818181818181818
"7531",192323,"Le Moyne College",1,0,2010,615,372,243,355,130,225,0.605,0.577,0.535,26350,61.146475,155,511,0.830894308943089
"7532",192439,"LONG ISLAND UNIVERSITY BROOKLYN CAMPUS",1,0,1991,665,436,229,30,12,18,0.041,0.045,0.052,9280,57.632,554,91,0.136842105263158
"7533",192439,"LONG ISLAND UNIVERSITY BROOKLYN CAMPUS",1,0,1992,837,552,285,34,15,19,0.034,0.041,0.053,10670,71.595,547,156,0.186379928315412
"7534",192439,"LONG ISLAND UNIVERSITY-BROOKLYN CAMPUS",1,0,1993,918,633,285,36,13,23,0.036,0.039,0.046,10670,84.877,561,158,0.172113289760349
"7535",192439,"LONG ISLAND UNIVERSITY-BROOKLYN CAMPUS",1,0,1995,1043,700,343,55,17,38,0.054,0.053,0.05,12215,100.563,568,185,0.177372962607862
"7536",192439,"LONG ISLAND UNIVERSITY-BROOKLYN CAMPUS",1,0,1996,956,654,302,51,17,34,0.052,0.053,0.056,12840,96.215266,574,165,0.172594142259414
"7537",192439,"LONG ISLAND UNIVERSITY-BROOKLYN CAMPUS",1,0,1997,915,595,320,33,13,20,0.034,0.036,0.041,13570,78.848847,261,147,0.160655737704918
"7538",192439,"LONG ISLAND UNIVERSITY-BROOKLYN CAMPUS",1,0,1998,1061,689,372,44,8,36,0.052,0.041,0.022,14310,85.650341,292,130,0.122525918944392
"7539",192439,"LONG ISLAND UNIVERSITY-BROOKLYN CAMPUS",1,0,1999,1010,719,291,38,12,26,0.036,0.038,0.041,14340,88.468827,290,152,0.15049504950495
"7540",192439,"LONG ISLAND UNIVERSITY-BROOKLYN CAMPUS",1,0,2000,863,578,285,36,9,27,0.047,0.042,0.032,16100,93.802629,283,112,0.129779837775203
"7541",192439,"LONG ISLAND UNIVERSITY-BROOKLYN CAMPUS",1,0,2001,825,574,251,55,20,35,0.061,0.067,0.08,17220,103.464869,276,97,0.117575757575758
"7542",192439,"LONG ISLAND UNIVERSITY-BROOKLYN CAMPUS",1,0,2002,776,561,215,48,9,39,0.07,0.062,0.042,18250,113.725688,295,85,0.109536082474227
"7543",192439,"LONG ISLAND UNIVERSITY-BROOKLYN CAMPUS",1,0,2003,680,480,200,45,10,35,0.073,0.066,0.05,19510,121.224408,304,89,0.130882352941176
"7544",192439,"LONG ISLAND UNIVERSITY-BROOKLYN CAMPUS",1,0,2004,912,629,283,39,12,27,0.043,0.043,0.042,21150,127.288959,305,152,0.166666666666667
"7545",192439,"Long Island University-Brooklyn Campus",1,0,2005,959,643,316,51,10,41,0.064,0.053,0.032,22048,135.756132,308,175,0.182481751824818
"7546",192439,"Long Island University-Brooklyn Campus",1,0,2006,1079,730,349,56,14,42,0.058,0.052,0.04,23328,146.157662,311,200,0.185356811862836
"7547",192439,"Long Island University-Brooklyn Campus",1,0,2007,1021,721,300,61,16,45,0.062,0.06,0.053,24672,165.624586,314,166,0.16258570029383
"7548",192439,"Long Island University-Brooklyn Campus",1,0,2008,992,706,286,73,18,55,0.078,0.074,0.063,26048,174.755757,304,187,0.188508064516129
"7549",192439,"Long Island University-Brooklyn Campus",1,0,2009,1005,692,313,81,19,62,0.09,0.081,0.061,27328,167.827957,307,179,0.178109452736318
"7550",192439,"Long Island University-Brooklyn Campus",1,0,2010,883,618,265,58,13,45,0.073,0.066,0.049,25088,174.184627,310,154,0.17440543601359
"7551",192703,"MANHATTAN COLLEGE",1,0,1991,548,258,290,298,137,161,0.624,0.544,0.472,11100,48.717,174,406,0.740875912408759
"7552",192703,"MANHATTAN COLLEGE",1,0,1992,577,250,327,244,120,124,0.496,0.423,0.367,11900,56.152,170,429,0.743500866551127
"7553",192703,"MANHATTAN COLLEGE",1,0,1993,546,254,292,307,152,155,0.61,0.562,0.521,12700,57.412,172,385,0.705128205128205
"7554",192703,"MANHATTAN COLLEGE",1,0,1995,572,256,316,321,160,161,0.629,0.561,0.506,14220,54.686,163,396,0.692307692307692
"7555",192703,"MANHATTAN COLLEGE",1,0,1996,557,258,299,313,143,170,0.659,0.562,0.478,14900,54.239,156,372,0.66786355475763
"7556",192703,"MANHATTAN COLLEGE",1,0,1997,527,235,292,269,134,135,0.575,0.51,0.459,15500,57.461049,158,363,0.688804554079696
"7557",192703,"MANHATTAN COLLEGE",1,0,1998,547,274,273,328,159,169,0.617,0.6,0.582,16100,46.606636,160,358,0.654478976234004
"7558",192703,"MANHATTAN COLLEGE",1,0,1999,645,289,356,386,195,191,0.661,0.598,0.548,15500,49.403836,161,473,0.733333333333333
"7559",192703,"MANHATTAN COLLEGE",1,0,2000,623,315,308,361,153,208,0.66,0.579,0.497,16000,51.780693,164.5,442,0.709470304975923
"7560",192703,"MANHATTAN COLLEGE",1,0,2001,597,276,321,344,162,182,0.659,0.576,0.505,16500,55.276847,168,441,0.738693467336683
"7561",192703,"MANHATTAN COLLEGE",1,0,2002,769,401,368,501,228,273,0.681,0.651,0.62,17100,58.18096,162,549,0.713914174252276
"7562",192703,"MANHATTAN COLLEGE",1,0,2003,638,342,296,400,173,227,0.664,0.627,0.584,17800,63.591048,167,502,0.786833855799373
"7563",192703,"MANHATTAN COLLEGE",1,0,2004,657,343,314,420,182,238,0.694,0.639,0.58,18600,65.945202,169,521,0.792998477929985
"7564",192703,"Manhattan College",1,0,2005,700,368,332,456,198,258,0.701,0.651,0.596,19400,67.462622,172,555,0.792857142857143
"7565",192703,"Manhattan College",1,0,2006,710,353,357,466,234,232,0.657,0.656,0.655,20350,72.187651,171,562,0.791549295774648
"7566",192703,"Manhattan College",1,0,2007,708,356,352,427,201,226,0.635,0.603,0.571,21640,75.006168,170,571,0.806497175141243
"7567",192703,"Manhattan College",1,0,2008,726,351,375,475,226,249,0.709,0.654,0.603,22940,79.183843,180,524,0.721763085399449
"7568",192703,"Manhattan College",1,0,2009,693,343,350,412,183,229,0.668,0.595,0.523,25100,86.860726,176,493,0.711399711399711
"7569",192703,"Manhattan College",1,0,2010,658,300,358,375,190,185,0.617,0.57,0.531,25335,89.683677,201,465,0.706686930091185
"7570",192749,"MANHATTANVILLE COLLEGE",1,0,1991,192,143,49,96,22,74,0.517,0.5,0.449,12760,24.769,81,123,0.640625
"7571",192749,"MANHATTANVILLE COLLEGE",1,0,1992,183,139,44,106,23,83,0.597,0.579,0.523,13605,28.72,77,103,0.562841530054645
"7572",192749,"MANHATTANVILLE COLLEGE",1,0,1993,214,133,81,86,30,56,0.421,0.402,0.37,14450,29.087,65,132,0.616822429906542
"7573",192749,"MANHATTANVILLE COLLEGE",1,0,1995,161,115,46,87,18,69,0.6,0.54,0.391,15500,25.829,58,89,0.552795031055901
"7574",192749,"MANHATTANVILLE COLLEGE",1,0,1996,271,181,90,117,33,84,0.464,0.432,0.367,16120,26.189,56,148,0.546125461254613
"7575",192749,"MANHATTANVILLE COLLEGE",1,0,1997,294,202,92,148,40,108,0.535,0.503,0.435,17300,22.412,56,146,0.496598639455782
"7576",192749,"MANHATTANVILLE COLLEGE",1,0,1998,338,225,113,126,35,91,0.404,0.373,0.31,18130,24.32,58,184,0.544378698224852
"7577",192749,"MANHATTANVILLE COLLEGE",1,0,1999,387,266,121,195,57,138,0.519,0.504,0.471,18130,27.735111,63,230,0.594315245478036
"7578",192749,"MANHATTANVILLE COLLEGE",1,0,2000,403,277,126,213,58,155,0.56,0.529,0.46,18860,32.269382,67,241,0.598014888337469
"7579",192749,"MANHATTANVILLE COLLEGE",1,0,2001,404,277,127,226,65,161,0.581,0.559,0.512,19620,36.678786,71,243,0.601485148514851
"7580",192749,"MANHATTANVILLE COLLEGE",1,0,2002,420,287,133,212,50,162,0.565,0.505,0.376,20600,37.288091,82,249,0.592857142857143
"7581",192749,"MANHATTANVILLE COLLEGE",1,0,2003,422,295,127,223,68,155,0.525,0.528,0.535,22150,38.805211,88,240,0.568720379146919
"7582",192749,"MANHATTANVILLE COLLEGE",1,0,2004,450,312,138,261,78,183,0.587,0.58,0.565,23620,41.224663,88,259,0.575555555555556
"7583",192749,"Manhattanville College",1,0,2005,506,327,179,264,73,191,0.584,0.522,0.408,24920,46.060476,88,316,0.624505928853755
"7584",192749,"Manhattanville College",1,0,2006,507,329,178,274,91,183,0.556,0.54,0.511,26920,48.861292,92,289,0.570019723865878
"7585",192749,"Manhattanville College",1,0,2007,463,315,148,249,59,190,0.603,0.538,0.399,28540,56.273116,99,229,0.494600431965443
"7586",192749,"Manhattanville College",1,0,2008,476,326,150,270,82,188,0.577,0.567,0.547,30400,62.490591,100,223,0.468487394957983
"7587",192749,"Manhattanville College",1,0,2009,490,298,192,250,86,164,0.55,0.51,0.448,31490,62.972888,101,202,0.412244897959184
"7588",192749,"Manhattanville College",1,0,2010,428,274,154,181,57,124,0.453,0.423,0.37,33030,62.936093,103,199,0.464953271028037
"7589",192819,"MARIST COLLEGE",1,0,1991,881,489,392,441,166,275,0.562,0.501,0.423,9205,53.275,142,806,0.914869466515324
"7590",192819,"MARIST COLLEGE",1,0,1992,820,451,369,514,201,313,0.694,0.627,0.545,9826,61.193,143,697,0.85
"7591",192819,"MARIST COLLEGE",1,0,1993,806,460,346,371,134,237,0.515,0.46,0.387,10397,65.864,151,692,0.858560794044665
"7592",192819,"MARIST COLLEGE",1,0,1995,926,527,399,472,181,291,0.552,0.51,0.454,11590,73.01,157,513,0.553995680345572
"7593",192819,"MARIST COLLEGE",1,0,1996,839,482,357,510,187,323,0.67,0.608,0.524,12450,65.71838,159,706,0.841477949940405
"7594",192819,"MARIST COLLEGE",1,0,1997,973,532,441,570,232,338,0.635,0.586,0.526,13098,55.385408,162,755,0.775950668036999
"7595",192819,"MARIST COLLEGE",1,0,1998,834,430,404,547,240,307,0.714,0.656,0.594,13818,58.817363,157,691,0.828537170263789
"7596",192819,"MARIST COLLEGE",1,0,1999,975,548,427,665,260,405,0.739,0.682,0.609,14374,63.622317,162,803,0.823589743589744
"7597",192819,"MARIST COLLEGE",1,0,2000,993,589,404,690,272,418,0.71,0.695,0.673,15366,69.478802,170,860,0.866062437059416
"7598",192819,"MARIST COLLEGE",1,0,2001,908,484,424,632,281,351,0.725,0.696,0.663,16364,77.135771,178,764,0.841409691629956
"7599",192819,"MARIST COLLEGE",1,0,2002,956,576,380,693,252,441,0.766,0.725,0.663,17444,83.309358,182,781,0.816945606694561
"7600",192819,"MARIST COLLEGE",1,0,2003,961,528,433,732,310,422,0.799,0.762,0.716,18432,89.959651,197,807,0.839750260145682
"7601",192819,"MARIST COLLEGE",1,0,2004,955,536,419,699,282,417,0.778,0.732,0.673,19540,91.8623,199,728,0.762303664921466
"7602",192819,"Marist College",1,0,2005,1017,585,432,697,258,439,0.75,0.685,0.597,20712,93.114065,201,810,0.79646017699115
"7603",192819,"Marist College",1,0,2006,1038,573,465,737,309,428,0.747,0.71,0.665,22066,101.564196,204,852,0.820809248554913
"7604",192819,"Marist College",1,0,2007,1019,561,458,713,295,418,0.745,0.7,0.644,23560,108.622176,218,754,0.739941118743867
"7605",192819,"Marist College",1,0,2008,1018,611,407,697,249,448,0.733,0.685,0.612,25100,121.962613,222,781,0.767190569744597
"7606",192819,"Marist College",1,0,2009,1041,577,464,708,279,429,0.743,0.68,0.601,26105,127.498898,219,836,0.803073967339097
"7607",192819,"Marist College",1,0,2010,1088,612,476,814,331,483,0.789,0.748,0.695,27150,130.092857,228,886,0.814338235294118
"7608",192925,"MEDAILLE COLLEGE",1,0,1991,143,79,64,23,6,17,0.215,0.161,0.094,7180,9.285,41,82,0.573426573426573
"7609",192925,"MEDAILLE COLLEGE",1,0,1992,185,86,99,21,4,17,0.198,0.114,0.04,7750,12.182,40,110,0.594594594594595
"7610",192925,"MEDAILLE COLLEGE",1,0,1993,202,94,108,38,16,22,0.234,0.188,0.148,8350,13.393,43,124,0.613861386138614
"7611",192925,"MEDAILLE COLLEGE",1,0,1995,78,50,28,15,5,10,0.2,0.192,0.179,9560,12.112,41,60,0.769230769230769
"7612",192925,"MEDAILLE COLLEGE",1,0,1996,81,58,23,6,2,4,0.069,0.074,0.087,9990,11.054402,41,55,0.679012345679012
"7613",192925,"MEDAILLE COLLEGE",1,0,1997,164,102,62,19,6,13,0.128,0.116,0.097,10470,9.289133,38,121,0.73780487804878
"7614",192925,"MEDAILLE COLLEGE",1,0,1998,153,113,40,45,15,30,0.266,0.294,0.375,10950,10.248888,43,101,0.660130718954248
"7615",192925,"MEDAILLE COLLEGE",1,0,1999,143,104,39,31,6,25,0.24,0.217,0.154,11190,11.320326,43,115,0.804195804195804
"7616",192925,"MEDAILLE COLLEGE",1,0,2000,208,153,55,36,10,26,0.17,0.173,0.182,11700,12.479738,52,148,0.711538461538462
"7617",192925,"MEDAILLE COLLEGE",1,0,2001,208,166,42,53,12,41,0.247,0.255,0.286,12240,14.65307,61,161,0.774038461538462
"7618",192925,"MEDAILLE COLLEGE",1,0,2002,308,204,104,69,25,44,0.216,0.224,0.24,12720,17.100197,63,199,0.646103896103896
"7619",192925,"MEDAILLE COLLEGE",1,0,2003,241,146,95,100,42,58,0.397,0.415,0.442,13350,20.056923,70,184,0.763485477178423
"7620",192925,"MEDAILLE COLLEGE",1,0,2004,296,179,117,85,36,49,0.274,0.287,0.308,14010,24.346179,76,233,0.787162162162162
"7621",192925,"Medaille College",1,0,2005,203,126,77,62,27,35,0.278,0.305,0.351,15030,30.717105,90,165,0.812807881773399
"7622",192925,"Medaille College",1,0,2006,320,198,122,87,38,49,0.248,0.272,0.311,15780,38.242052,97,239,0.746875
"7623",192925,"Medaille College",1,0,2007,409,255,154,131,56,75,0.294,0.32,0.364,16590,40.385677,91,308,0.753056234718826
"7624",192925,"Medaille College",1,0,2008,408,253,155,105,49,56,0.221,0.257,0.316,17420,40.479884,90,283,0.693627450980392
"7625",192925,"Medaille College",1,0,2009,402,257,145,104,35,69,0.268,0.259,0.241,19590,39.892666,81,272,0.676616915422886
"7626",192925,"Medaille College",1,0,2010,377,234,143,112,46,66,0.282,0.297,0.322,20570,38.179561,73,259,0.687002652519894
"7627",193016,"MERCY COLLEGE - MAIN CAMPUS",1,0,1991,619,329,290,19,5,14,0.043,0.031,0.017,6990,31.39,150,153,0.247172859450727
"7628",193016,"MERCY COLLEGE-MAIN CAMPUS",1,0,1992,867,534,333,19,7,12,0.022,0.022,0.021,7200,41.948,147,230,0.265282583621684
"7629",193016,"MERCY COLLEGE-MAIN CAMPUS",1,0,1993,733,403,330,16,6,10,0.025,0.022,0.018,7380,40.599,149,124,0.169167803547067
"7630",193016,"MERCY COLLEGE-MAIN CAMPUS",1,0,1995,1002,623,379,4,2,2,0.003,0.004,0.005,6600,49.375,146,429,0.42814371257485
"7631",193016,"MERCY COLLEGE-MAIN CAMPUS",1,0,1996,551,336,215,62,12,50,0.149,0.113,0.056,7200,50.974959,150,143,0.259528130671506
"7632",193016,"MERCY COLLEGE-MAIN CAMPUS",1,0,1997,1052,692,360,46,16,30,0.043,0.044,0.044,7600,53.696881,153,271,0.257604562737643
"7633",193016,"MERCY COLLEGE-MAIN CAMPUS",1,0,1998,907,582,325,53,14,39,0.067,0.058,0.043,7800,59.408453,178,161,0.177508269018743
"7634",193016,"MERCY COLLEGE-MAIN CAMPUS",1,0,1999,953,630,323,68,18,50,0.079,0.071,0.056,7950,58.838862,181,115,0.120671563483736
"7635",193016,"MERCY COLLEGE-MAIN CAMPUS",1,0,2000,637,421,216,69,10,59,0.14,0.108,0.046,8500,62.7,195,94,0.14756671899529
"7636",193016,"MERCY COLLEGE-MAIN CAMPUS",1,0,2001,618,412,206,61,10,51,0.124,0.099,0.049,8950,70.290636,209,95,0.153721682847896
"7637",193016,"MERCY COLLEGE-MAIN CAMPUS",1,0,2002,680,425,255,69,14,55,0.129,0.101,0.055,10000,76.711202,230,140,0.205882352941176
"7638",193016,"MERCY COLLEGE-MAIN CAMPUS",1,0,2003,611,379,232,58,10,48,0.127,0.095,0.043,10700,83.590978,228,132,0.216039279869067
"7639",193016,"MERCY COLLEGE-MAIN CAMPUS",1,0,2004,649,421,228,79,18,61,0.145,0.122,0.079,11230,91.202841,223,165,0.254237288135593
"7640",193016,"Mercy College-Main Campus",1,0,2005,485,324,161,53,11,42,0.13,0.109,0.068,11792,89.769018,175,102,0.210309278350515
"7641",193016,"Mercy College-Main Campus",1,0,2006,614,390,224,79,22,57,0.146,0.129,0.098,12370,94.313313,183,152,0.247557003257329
"7642",193016,"Mercy College-Main Campus",1,0,2007,532,343,189,111,21,90,0.262,0.209,0.111,13730,94.614235,180,185,0.347744360902256
"7643",193016,"Mercy College",1,0,2008,677,441,236,92,14,78,0.177,0.136,0.059,14990,95.906723,169,178,0.262924667651403
"7644",193016,"Mercy College",1,0,2009,880,552,328,157,39,118,0.214,0.178,0.119,15990,94.553369,193,248,0.281818181818182
"7645",193016,"Mercy College",1,0,2010,1086,708,378,212,45,167,0.236,0.195,0.119,16490,103.788228,199,247,0.22744014732965
"7646",193292,"MOLLOY COLLEGE",1,0,1991,123,100,23,55,6,49,0.49,0.447,0.261,7800,13.299,89,102,0.829268292682927
"7647",193292,"MOLLOY COLLEGE",1,0,1992,1417,1055,362,65,7,58,0.055,0.046,0.019,8390,23.149,102,929,0.65561044460127
"7648",193292,"MOLLOY COLLEGE",1,0,1993,175,139,36,74,8,66,0.475,0.423,0.222,8700,24.389,116,138,0.788571428571429
"7649",193292,"MOLLOY COLLEGE",1,0,1995,135,108,27,30,5,25,0.231,0.222,0.185,9700,21.12,136,109,0.807407407407407
"7650",193292,"MOLLOY COLLEGE",1,0,1996,183,125,58,21,5,16,0.128,0.115,0.086,10000,22.63878,147,139,0.759562841530055
"7651",193292,"MOLLOY COLLEGE",1,0,1997,156,112,44,46,6,40,0.357,0.295,0.136,10400,24.238847,70,127,0.814102564102564
"7652",193292,"MOLLOY COLLEGE",1,0,1998,180,117,63,72,21,51,0.436,0.4,0.333,11270,25.709963,148,146,0.811111111111111
"7653",193292,"MOLLOY COLLEGE",1,0,1999,209,156,53,84,11,73,0.468,0.402,0.208,11900,26.864678,137,159,0.760765550239234
"7654",193292,"MOLLOY COLLEGE",1,0,2000,195,133,62,56,13,43,0.323,0.287,0.21,12500,22.085094,132.5,140,0.717948717948718
"7655",193292,"MOLLOY COLLEGE",1,0,2001,210,145,65,66,16,50,0.345,0.314,0.246,13190,22.36509,128,153,0.728571428571429
"7656",193292,"MOLLOY COLLEGE",1,0,2002,229,168,61,77,19,58,0.345,0.336,0.311,13940,24.001739,134,151,0.65938864628821
"7657",193292,"MOLLOY COLLEGE",1,0,2003,262,185,77,89,29,60,0.324,0.34,0.377,14430,27.925925,137,181,0.690839694656489
"7658",193292,"MOLLOY COLLEGE",1,0,2004,311,231,80,105,17,88,0.381,0.338,0.212,15150,30.684869,142,206,0.662379421221865
"7659",193292,"Molloy College",1,0,2005,274,190,84,109,31,78,0.41,0.398,0.369,15760,39.798715,147,194,0.708029197080292
"7660",193292,"Molloy College",1,0,2006,269,196,73,90,22,68,0.347,0.335,0.301,16560,44.378879,158,172,0.639405204460966
"7661",193292,"Molloy College",1,0,2007,370,282,88,140,31,109,0.386,0.378,0.352,17640,50.146444,162,246,0.664864864864865
"7662",193292,"Molloy College",1,0,2008,393,288,105,156,32,124,0.431,0.397,0.305,18700,53.858655,163,271,0.689567430025445
"7663",193292,"Molloy College",1,0,2009,414,307,107,189,42,147,0.479,0.457,0.393,19970,58.480258,169,269,0.64975845410628
"7664",193292,"Molloy College",1,0,2010,387,257,130,180,59,121,0.471,0.465,0.454,21170,63.9427,173,271,0.700258397932817
"7665",193353,"MOUNT SAINT MARY COLLEGE",1,0,1991,248,188,60,96,16,80,0.426,0.387,0.267,7020,13.007,48,208,0.838709677419355
"7666",193353,"MOUNT SAINT MARY COLLEGE",1,0,1992,254,180,74,97,25,72,0.4,0.382,0.338,7810,15.835,48,218,0.858267716535433
"7667",193353,"MOUNT SAINT MARY COLLEGE",1,0,1993,239,164,75,90,29,61,0.372,0.377,0.387,8110,18.287,51,195,0.815899581589958
"7668",193353,"MOUNT SAINT MARY COLLEGE",1,0,1995,258,196,62,114,24,90,0.459,0.442,0.387,8955,19.488,53,207,0.802325581395349
"7669",193353,"MOUNT SAINT MARY COLLEGE",1,0,1996,266,199,67,105,20,85,0.427,0.395,0.299,9495,20.158,54,226,0.849624060150376
"7670",193353,"MOUNT SAINT MARY COLLEGE",1,0,1997,260,177,83,121,43,78,0.441,0.465,0.518,10215,17.820253,53,202,0.776923076923077
"7671",193353,"MOUNT SAINT MARY COLLEGE",1,0,1998,304,230,74,122,27,95,0.413,0.401,0.365,10855,18.628183,52,239,0.786184210526316
"7672",193353,"MOUNT SAINT MARY COLLEGE",1,0,1999,323,247,76,156,25,131,0.53,0.483,0.329,11100,19.875577,53,253,0.78328173374613
"7673",193353,"MOUNT SAINT MARY COLLEGE",1,0,2000,328,251,77,124,15,109,0.434,0.378,0.195,11580,21.661178,56,266,0.810975609756098
"7674",193353,"MOUNT SAINT MARY COLLEGE",1,0,2001,343,239,104,143,33,110,0.46,0.417,0.317,12270,23.925125,59,282,0.822157434402332
"7675",193353,"MOUNT SAINT MARY COLLEGE",1,0,2002,361,261,100,151,33,118,0.452,0.418,0.33,12930,26.53162,62,291,0.806094182825485
"7676",193353,"MOUNT SAINT MARY COLLEGE",1,0,2003,347,246,101,137,31,106,0.431,0.395,0.307,13830,29.25515,67,285,0.821325648414986
"7677",193353,"MOUNT SAINT MARY COLLEGE",1,0,2004,419,314,105,180,45,135,0.43,0.43,0.429,15180,31.410683,67,345,0.823389021479714
"7678",193353,"Mount Saint Mary College",1,0,2005,356,247,109,154,45,109,0.441,0.433,0.413,16410,35.011941,71,285,0.800561797752809
"7679",193353,"Mount Saint Mary College",1,0,2006,400,295,105,162,41,121,0.41,0.405,0.39,17730,36.938639,73,308,0.77
"7680",193353,"Mount Saint Mary College",1,0,2007,364,252,112,150,31,119,0.472,0.412,0.277,18900,38.533854,74,307,0.843406593406593
"7681",193353,"Mount Saint Mary College",1,0,2008,432,318,114,191,50,141,0.443,0.442,0.439,20040,43.034314,76,334,0.773148148148148
"7682",193353,"Mount Saint Mary College",1,0,2009,474,362,112,217,42,175,0.483,0.458,0.375,21210,45.630418,81,383,0.808016877637131
"7683",193353,"Mount Saint Mary College",1,0,2010,443,301,142,187,60,127,0.422,0.422,0.423,22350,48.62418,85,340,0.767494356659142
"7684",193399,"COLLEGE OF MOUNT SAINT VINCENT",1,0,1991,188,147,41,91,20,71,0.483,0.484,0.488,9810,12.7,50,107,0.569148936170213
"7685",193399,"COLLEGE OF MOUNT SAINT VINCENT",1,0,1992,185,153,32,88,12,76,0.497,0.476,0.375,10460,14.776,51,100,0.540540540540541
"7686",193399,"COLLEGE OF MOUNT SAINT VINCENT",1,0,1993,174,136,38,71,9,62,0.456,0.408,0.237,11190,14.313,49,104,0.597701149425287
"7687",193399,"COLLEGE OF MOUNT SAINT VINCENT",1,0,1995,217,164,53,107,27,80,0.488,0.493,0.509,12450,19.242,71,115,0.529953917050691
"7688",193399,"COLLEGE OF MOUNT SAINT VINCENT",1,0,1996,208,162,46,111,26,85,0.525,0.534,0.565,13060,19.012035,56,95,0.456730769230769
"7689",193399,"COLLEGE OF MOUNT SAINT VINCENT",1,0,1997,225,168,57,95,18,77,0.458,0.422,0.316,13580,21.133765,61,97,0.431111111111111
"7690",193399,"COLLEGE OF MOUNT SAINT VINCENT",1,0,1998,266,200,66,124,26,98,0.49,0.466,0.394,14360,21.853637,61,92,0.345864661654135
"7691",193399,"COLLEGE OF MOUNT SAINT VINCENT",1,0,1999,240,167,73,76,18,58,0.347,0.317,0.247,14910,19.041988,65,82,0.341666666666667
"7692",193399,"COLLEGE OF MOUNT SAINT VINCENT",1,0,2000,236,174,62,83,16,67,0.385,0.352,0.258,16030,19.986282,68.5,77,0.326271186440678
"7693",193399,"COLLEGE OF MOUNT SAINT VINCENT",1,0,2001,286,214,72,111,21,90,0.421,0.388,0.292,17030,21.387771,72,101,0.353146853146853
"7694",193399,"COLLEGE OF MOUNT SAINT VINCENT",1,0,2002,326,239,87,128,21,107,0.448,0.393,0.241,17880,21.046471,69,140,0.429447852760736
"7695",193399,"COLLEGE OF MOUNT SAINT VINCENT",1,0,2003,336,272,64,136,13,123,0.452,0.405,0.203,18600,22.191859,70,155,0.461309523809524
"7696",193399,"COLLEGE OF MOUNT SAINT VINCENT",1,0,2004,355,229,126,166,53,113,0.493,0.468,0.421,19100,25.139795,73,177,0.498591549295775
"7697",193399,"College of Mount Saint Vincent",1,0,2005,343,247,96,136,32,104,0.421,0.397,0.333,19950,26.562034,74,168,0.489795918367347
"7698",193399,"College of Mount Saint Vincent",1,0,2006,390,294,96,159,37,122,0.415,0.408,0.385,21000,27.107423,72,153,0.392307692307692
"7699",193399,"College of Mount Saint Vincent",1,0,2007,394,272,122,144,39,105,0.386,0.365,0.32,22150,29.326666,73,152,0.385786802030457
"7700",193399,"College of Mount Saint Vincent",1,0,2008,374,267,107,146,34,112,0.42,0.39,0.318,23270,33.309221,74,151,0.403743315508021
"7701",193399,"College of Mount Saint Vincent",1,0,2009,390,275,115,131,30,101,0.367,0.336,0.261,24400,34.317228,73,132,0.338461538461538
"7702",193399,"College of Mount Saint Vincent",1,0,2010,377,249,128,147,41,106,0.426,0.39,0.32,25600,35.882114,73,115,0.305039787798409
"7703",193584,"NAZARETH COLLEGE OF ROCHESTER",1,0,1991,246,177,69,124,27,97,0.548,0.504,0.391,8940,23.455,102,228,0.926829268292683
"7704",193584,"NAZARETH COLLEGE OF ROCHESTER",1,0,1992,211,159,52,129,24,105,0.66,0.611,0.462,9790,27.769,105,195,0.924170616113744
"7705",193584,"NAZARETH COLLEGE OF ROCHESTER",1,0,1993,266,192,74,142,29,113,0.589,0.534,0.392,10390,27.309,105,252,0.947368421052632
"7706",193584,"NAZARETH COLLEGE OF ROCHESTER",1,0,1995,302,227,75,182,36,146,0.643,0.603,0.48,11380,31.494,104,284,0.940397350993378
"7707",193584,"NAZARETH COLLEGE OF ROCHESTER",1,0,1996,337,242,95,208,55,153,0.632,0.617,0.579,12130,33.066,106,310,0.919881305637982
"7708",193584,"NAZARETH COLLEGE OF ROCHESTER",1,0,1997,351,257,94,214,59,155,0.603,0.61,0.628,12966,28.188299,111,327,0.931623931623932
"7709",193584,"NAZARETH COLLEGE OF ROCHESTER",1,0,1998,321,246,75,199,38,161,0.655,0.62,0.507,13526,30.581874,111,296,0.922118380062305
"7710",193584,"NAZARETH COLLEGE OF ROCHESTER",1,0,1999,334,244,90,205,51,154,0.631,0.614,0.567,13620,32.032458,120,304,0.910179640718563
"7711",193584,"NAZARETH COLLEGE OF ROCHESTER",1,0,2000,402,304,98,244,56,188,0.618,0.607,0.571,14230,34.334188,126,368,0.915422885572139
"7712",193584,"NAZARETH COLLEGE OF ROCHESTER",1,0,2001,358,274,84,239,50,189,0.69,0.668,0.595,14940,37.057916,132,329,0.918994413407821
"7713",193584,"NAZARETH COLLEGE OF ROCHESTER",1,0,2002,385,292,93,230,49,181,0.62,0.597,0.527,15910,40.613223,134,335,0.87012987012987
"7714",193584,"NAZARETH COLLEGE OF ROCHESTER",1,0,2003,383,284,99,236,54,182,0.641,0.616,0.545,17020,44.051923,137,325,0.848563968668407
"7715",193584,"NAZARETH COLLEGE OF ROCHESTER",1,0,2004,449,335,114,285,60,225,0.672,0.635,0.526,18040,46.301921,136,377,0.839643652561247
"7716",193584,"Nazareth College of Rochester",1,0,2005,451,342,109,303,56,247,0.722,0.672,0.514,19214,49.524956,135,392,0.869179600886918
"7717",193584,"Nazareth College of Rochester",1,0,2006,481,364,117,293,62,231,0.635,0.609,0.53,20656,52.763669,144,419,0.871101871101871
"7718",193584,"Nazareth College of Rochester",1,0,2007,456,335,121,268,60,208,0.621,0.588,0.496,21844,56.115746,152,374,0.820175438596491
"7719",193584,"Nazareth College",1,0,2008,471,361,110,306,62,244,0.676,0.65,0.564,23046,60.935177,156,381,0.808917197452229
"7720",193584,"Nazareth College",1,0,2009,491,387,104,315,68,247,0.638,0.642,0.654,24082,64.521709,156,386,0.786150712830957
"7721",193584,"Nazareth College",1,0,2010,467,353,114,273,60,213,0.603,0.585,0.526,25046,68.457857,160,331,0.708779443254818
"7722",193645,"COLLEGE OF NEW ROCHELLE",1,0,1991,645,563,82,93,2,91,0.162,0.144,0.024,10050,34.034,75,86,0.133333333333333
"7723",193645,"COLLEGE OF NEW ROCHELLE",1,0,1992,935,777,158,85,7,78,0.1,0.091,0.044,10200,41.83,71,72,0.0770053475935829
"7724",193645,"COLLEGE OF NEW ROCHELLE",1,0,1993,821,677,144,89,14,75,0.111,0.108,0.097,10600,37.947,67,88,0.107186358099878
"7725",193645,"COLLEGE OF NEW ROCHELLE",1,0,1995,718,595,123,120,13,107,0.18,0.167,0.106,12200,45.93,67,65,0.0905292479108635
"7726",193645,"COLLEGE OF NEW ROCHELLE",1,0,1996,931,787,144,129,13,116,0.147,0.139,0.09,11000,48.833216,68,41,0.0440386680988185
"7727",193645,"COLLEGE OF NEW ROCHELLE",1,0,1997,758,643,115,165,18,147,0.229,0.218,0.157,11000,38.370499,72,53,0.0699208443271768
"7728",193645,"COLLEGE OF NEW ROCHELLE",1,0,1998,852,738,114,161,11,150,0.203,0.189,0.096,11300,42.188015,79,58,0.068075117370892
"7729",193645,"COLLEGE OF NEW ROCHELLE",1,0,1999,814,670,144,152,16,136,0.203,0.187,0.111,11600,41.262313,74,58,0.0712530712530713
"7730",193645,"THE COLLEGE OF NEW ROCHELLE",1,0,2000,755,662,93,159,13,146,0.22,0.211,0.14,11900,44.521908,90.5,48,0.0635761589403974
"7731",193645,"THE COLLEGE OF NEW ROCHELLE",1,0,2001,774,650,124,169,13,156,0.24,0.218,0.105,12320,45.469372,107,39,0.0503875968992248
"7732",193645,"THE COLLEGE OF NEW ROCHELLE",1,0,2002,850,733,117,151,12,139,0.19,0.178,0.103,13000,47.77261,112,16,0.0188235294117647
"7733",193645,"THE COLLEGE OF NEW ROCHELLE",1,0,2003,769,668,101,121,5,116,0.174,0.157,0.05,14400,48.428271,117,39,0.0507152145643693
"7734",193645,"THE COLLEGE OF NEW ROCHELLE",1,0,2004,952,815,137,152,11,141,0.173,0.16,0.08,16500,53.251598,122,32,0.0336134453781513
"7735",193645,"The College of New Rochelle",1,0,2005,943,883,60,168,1,167,0.189,0.178,0.017,17950,54.67618,107,32,0.0339342523860021
"7736",193645,"The College of New Rochelle",1,0,2006,821,757,64,133,6,127,0.168,0.162,0.094,20800,56.16467,106,33,0.0401948842874543
"7737",193645,"The College of New Rochelle",1,0,2007,805,733,72,126,2,124,0.169,0.157,0.028,23200,57.09635,110,25,0.031055900621118
"7738",193645,"The College of New Rochelle",1,0,2008,504,461,43,86,2,84,0.182,0.171,0.047,24592,59.088616,108,26,0.0515873015873016
"7739",193645,"The College of New Rochelle",1,0,2009,530,465,65,86,8,78,0.168,0.162,0.123,25576,60.011204,102,15,0.0283018867924528
"7740",193645,"The College of New Rochelle",1,0,2010,635,566,69,140,10,130,0.23,0.22,0.145,27110,56.409378,108,19,0.0299212598425197
"7741",193654,"NEW SCHOOL FOR SOCIAL RESEARCH",1,0,1991,265,182,83,81,25,56,0.308,0.306,0.301,12200,74.897,117,105,0.39622641509434
"7742",193654,"NEW SCHOOL FOR SOCIAL RESEARCH",1,0,1992,423,275,148,155,41,114,0.415,0.366,0.277,12600,80.607,114,171,0.404255319148936
"7743",193654,"NEW SCHOOL FOR SOCIAL RESEARCH",1,0,1993,441,282,159,142,50,92,0.326,0.322,0.314,14210,86.412,123,174,0.394557823129252
"7744",193654,"NEW SCHOOL FOR SOCIAL RESEARCH",1,0,1995,445,275,170,178,54,124,0.451,0.4,0.318,16070,104.188,148,161,0.361797752808989
"7745",193654,"NEW SCHOOL FOR SOCIAL RESEARCH",1,0,1996,401,272,129,132,27,105,0.386,0.329,0.209,17660,109.598,140,159,0.396508728179551
"7746",193654,"NEW SCHOOL FOR SOCIAL RESEARCH",1,0,1997,465,308,157,205,56,149,0.484,0.441,0.357,18200,105.187534,131,182,0.391397849462366
"7747",193654,"NEW SCHOOL FOR SOCIAL RESEARCH",1,0,1998,581,394,187,240,51,189,0.48,0.413,0.273,19370,112.709817,133,213,0.366609294320138
"7748",193654,"NEW SCHOOL UNIVERSITY",1,0,1999,573,399,174,234,55,179,0.449,0.408,0.316,20410,122.945044,144,219,0.382198952879581
"7749",193654,"NEW SCHOOL UNIVERSITY",1,0,2000,595,402,193,245,69,176,0.438,0.412,0.358,20600,128.858177,150,245,0.411764705882353
"7750",193654,"NEW SCHOOL UNIVERSITY",1,0,2001,617,422,195,269,74,195,0.462,0.436,0.379,22630,140.730149,156,263,0.426256077795786
"7751",193654,"NEW SCHOOL UNIVERSITY",1,0,2002,605,415,190,328,89,239,0.576,0.542,0.468,23900,152.792198,145,255,0.421487603305785
"7752",193654,"NEW SCHOOL UNIVERSITY",1,0,2003,581,409,172,288,81,207,0.506,0.496,0.471,25330,167.868731,159,248,0.426850258175559
"7753",193654,"NEW SCHOOL UNIVERSITY",1,0,2004,815,612,203,371,86,285,0.466,0.455,0.424,26820,182.399275,196,339,0.415950920245399
"7754",193654,"The New School",1,0,2005,789,558,231,355,86,269,0.482,0.45,0.372,28560,196.78965,226,336,0.425855513307985
"7755",193654,"The New School",1,0,2006,883,622,261,409,110,299,0.481,0.463,0.421,28853,219.488144,269,375,0.424688561721404
"7756",193654,"The New School",1,0,2007,999,740,259,482,118,364,0.492,0.482,0.456,30550,232.646423,306,416,0.416416416416416
"7757",193654,"The New School",1,0,2008,1058,746,312,482,113,369,0.495,0.456,0.362,32695,256.779411,334,400,0.378071833648393
"7758",193654,"The New School",1,0,2009,1136,836,300,533,113,420,0.502,0.469,0.377,34081,265.704,370,422,0.371478873239437
"7759",193654,"The New School",1,0,2010,1166,859,307,603,139,464,0.54,0.517,0.453,35607,281.458,415,441,0.378216123499142
"7760",193900,"NEW YORK UNIVERSITY",1,0,1991,2338,1279,1059,1173,508,665,0.52,0.502,0.48,15620,1175.857,1225,1303,0.557313943541488
"7761",193900,"NEW YORK UNIVERSITY",1,0,1992,2669,1511,1158,1355,571,784,0.519,0.508,0.493,16650,1277.671,1222,1278,0.478831022855002
"7762",193900,"NEW YORK UNIVERSITY",1,0,1993,2752,1592,1160,1395,546,849,0.533,0.507,0.471,17640,1339.25,1231,1423,0.517078488372093
"7763",193900,"NEW YORK UNIVERSITY",1,0,1995,3156,1851,1305,1652,681,971,0.525,0.523,0.522,19748,1539.077,2346,1569,0.497148288973384
"7764",193900,"NEW YORK UNIVERSITY",1,0,1996,3393,2002,1391,1838,770,1068,0.533,0.542,0.554,20756,1637.866787,2238,1489,0.438844680223991
"7765",193900,"NEW YORK UNIVERSITY",1,0,1997,3557,2054,1503,1963,775,1188,0.578,0.552,0.516,21730,1599.177,2353,1409,0.396120326117515
"7766",193900,"NEW YORK UNIVERSITY",1,0,1998,3722,2224,1498,2028,805,1223,0.55,0.545,0.537,22586,1297.066,2808,1432,0.384739387426115
"7767",193900,"NEW YORK UNIVERSITY",1,0,1999,3845,2323,1522,2245,868,1377,0.593,0.584,0.57,22256,1402.433,2414,1535,0.399219765929779
"7768",193900,"NEW YORK UNIVERSITY",1,0,2000,3966,2424,1542,2416,966,1450,0.598,0.609,0.626,23090,1498.255,2596,1571,0.396116994452849
"7769",193900,"NEW YORK UNIVERSITY",1,0,2001,4136,2525,1611,2574,1016,1558,0.617,0.622,0.631,23986,1687.731,2778,1844,0.445841392649903
"7770",193900,"NEW YORK UNIVERSITY",1,0,2002,4126,2577,1549,2564,963,1601,0.621,0.621,0.622,24950,1849.378,1790,2160,0.523509452253999
"7771",193900,"NEW YORK UNIVERSITY",1,0,2003,4203,2563,1640,2664,1069,1595,0.622,0.634,0.652,26766,2021.253,1906,1867,0.444206519152986
"7772",193900,"NEW YORK UNIVERSITY",1,0,2004,4568,2792,1776,2860,1121,1739,0.623,0.626,0.631,28328,2049.478,2010,2331,0.510288966725044
"7773",193900,"New York University",1,0,2005,4639,2853,1786,2941,1168,1773,0.622,0.634,0.654,29890,2236.615,2043,2439,0.525759862039233
"7774",193900,"New York University",1,0,2006,4704,2895,1809,2879,1141,1738,0.6,0.612,0.631,31534,2402.387,2152,2445,0.519770408163265
"7775",193900,"New York University",1,0,2007,4884,3064,1820,2973,1082,1891,0.617,0.609,0.595,33268,2603.313,2231,2462,0.504095004095004
"7776",193900,"New York University",1,0,2008,4786,2738,2048,2740,1134,1606,0.587,0.573,0.554,35230,2841.168,2311,2182,0.45591307981613
"7777",193900,"New York University",1,0,2009,5367,3037,2330,3359,1449,1910,0.629,0.626,0.622,36586,3050.744,2377,2245,0.418297000186324
"7778",193900,"New York University",1,0,2010,5434,3100,2334,3417,1477,1940,0.626,0.629,0.633,37866,3196.919,2462,2301,0.423444976076555
"7779",193973,"NIAGARA UNIVERSITY",1,0,1991,447,272,175,176,53,123,0.452,0.394,0.303,9030,31.019,116,367,0.821029082774049
"7780",193973,"NIAGARA UNIVERSITY",1,0,1992,517,334,183,184,60,124,0.371,0.356,0.328,9523,34.745,110,445,0.86073500967118
"7781",193973,"NIAGARA UNIVERSITY",1,0,1993,432,259,173,202,68,134,0.517,0.468,0.393,10070,34.285,108,359,0.831018518518518
"7782",193973,"NIAGARA UNIVERSITY",1,0,1995,424,264,160,204,67,137,0.519,0.481,0.419,11560,37.19,116,327,0.77122641509434
"7783",193973,"NIAGARA UNIVERSITY",1,0,1996,552,314,238,253,107,146,0.465,0.458,0.45,12256,41.919696,118,458,0.829710144927536
"7784",193973,"NIAGARA UNIVERSITY",1,0,1997,705,417,288,299,102,197,0.472,0.424,0.354,12890,34.127167,118,576,0.817021276595745
"7785",193973,"NIAGARA UNIVERSITY",1,0,1998,543,332,211,271,93,178,0.536,0.499,0.441,13406,35.322797,119,449,0.826887661141805
"7786",193973,"NIAGARA UNIVERSITY",1,0,1999,575,345,230,315,127,188,0.545,0.548,0.552,13400,37.334147,120,500,0.869565217391304
"7787",193973,"NIAGARA UNIVERSITY",1,0,2000,628,371,257,350,122,228,0.615,0.557,0.475,14000,38.18303,124,527,0.839171974522293
"7788",193973,"NIAGARA UNIVERSITY",1,0,2001,598,362,236,322,117,205,0.566,0.538,0.496,14700,40.690229,128,497,0.831103678929766
"7789",193973,"NIAGARA UNIVERSITY",1,0,2002,735,440,295,409,148,261,0.593,0.556,0.502,15900,45.343666,134,604,0.821768707482993
"7790",193973,"NIAGARA UNIVERSITY",1,0,2003,686,417,269,403,152,251,0.602,0.587,0.565,16700,51.113073,131,568,0.82798833819242
"7791",193973,"NIAGARA UNIVERSITY",1,0,2004,725,467,258,443,141,302,0.647,0.611,0.547,17700,53.323746,131,604,0.833103448275862
"7792",193973,"Niagara University",1,0,2005,730,444,286,435,160,275,0.619,0.596,0.559,19000,57.625504,136,626,0.857534246575342
"7793",193973,"Niagara University",1,0,2006,705,421,284,437,169,268,0.637,0.62,0.595,20400,61.264266,142,606,0.859574468085106
"7794",193973,"Niagara University",1,0,2007,737,435,302,440,164,276,0.635,0.597,0.543,21400,63.955173,149,476,0.645861601085482
"7795",193973,"Niagara University",1,0,2008,738,454,284,435,146,289,0.637,0.589,0.514,22500,69.118418,153,582,0.788617886178862
"7796",193973,"Niagara University",1,0,2009,671,404,267,378,141,237,0.587,0.563,0.528,23700,72.596608,148,547,0.815201192250373
"7797",193973,"Niagara University",1,0,2010,668,377,291,397,163,234,0.621,0.594,0.56,24600,71.468929,156,521,0.779940119760479
"7798",194161,"NYACK COLLEGE",1,0,1991,108,77,31,26,4,22,0.286,0.241,0.129,7100,9.611,48,61,0.564814814814815
"7799",194161,"NYACK COLLEGE",1,0,1992,104,60,44,37,14,23,0.383,0.356,0.318,7910,11.69,47,60,0.576923076923077
"7800",194161,"NYACK COLLEGE",1,0,1993,109,69,40,30,8,22,0.319,0.275,0.2,8400,13.156,44,72,0.660550458715596
"7801",194161,"NYACK COLLEGE",1,0,1995,160,92,68,56,21,35,0.38,0.35,0.309,9450,15.114,43,72,0.45
"7802",194161,"NYACK COLLEGE",1,0,1996,208,129,79,69,23,46,0.357,0.332,0.291,10360,15.572045,43,143,0.6875
"7803",194161,"NYACK COLLEGE",1,0,1997,208,114,94,46,17,29,0.254,0.221,0.181,11100,15.712213,50,126,0.605769230769231
"7804",194161,"NYACK COLLEGE",1,0,1998,258,159,99,73,20,53,0.333,0.283,0.202,11650,17.094823,56,133,0.515503875968992
"7805",194161,"NYACK COLLEGE",1,0,1999,322,182,140,107,39,68,0.374,0.332,0.279,11440,18.133831,61,149,0.462732919254658
"7806",194161,"NYACK COLLEGE",1,0,2000,373,233,140,105,35,70,0.3,0.282,0.25,11990,21.793498,69.5,141,0.378016085790885
"7807",194161,"NYACK COLLEGE",1,0,2001,320,206,114,103,35,68,0.33,0.322,0.307,12480,26.088142,78,131,0.409375
"7808",194161,"NYACK COLLEGE",1,0,2002,295,183,112,109,40,69,0.377,0.369,0.357,12990,29.607759,84,133,0.450847457627119
"7809",194161,"NYACK COLLEGE",1,0,2003,267,166,101,79,26,53,0.319,0.296,0.257,13500,31.541033,86,122,0.456928838951311
"7810",194161,"NYACK COLLEGE",1,0,2004,260,162,98,78,29,49,0.302,0.3,0.296,13990,33.54503,91,96,0.369230769230769
"7811",194161,"Nyack College",1,0,2005,256,137,119,60,21,39,0.285,0.234,0.176,14750,37.585237,102,105,0.41015625
"7812",194161,"Nyack College",1,0,2006,308,178,130,85,30,55,0.309,0.276,0.231,15400,39.172925,102,113,0.366883116883117
"7813",194161,"Nyack College",1,0,2007,304,172,132,74,22,52,0.302,0.243,0.167,15800,41.190549,97,99,0.325657894736842
"7814",194161,"Nyack College",1,0,2008,253,140,113,61,22,39,0.279,0.241,0.195,17500,43.289706,90,83,0.328063241106719
"7815",194161,"Nyack College",1,0,2009,260,151,109,68,26,42,0.278,0.262,0.239,18500,42.39777,100,69,0.265384615384615
"7816",194161,"Nyack College",1,0,2010,314,181,133,67,28,39,0.216,0.213,0.211,19500,43.826242,110,82,0.261146496815287
"7817",194310,"PACE UNIVERSITY-NEW YORK",1,0,1991,510,290,220,178,56,122,0.421,0.349,0.255,9494,140.605,449,366,0.717647058823529
"7818",194310,"PACE UNIVERSITY-NEW YORK",1,0,1992,543,357,186,151,42,109,0.305,0.278,0.226,10100,152.454,431,192,0.353591160220994
"7819",194310,"PACE UNIVERSITY-NEW YORK",1,0,1993,659,430,229,228,64,164,0.381,0.346,0.279,10780,155.715,437,256,0.388467374810319
"7820",194310,"PACE UNIVERSITY-NEW YORK",1,0,1995,1139,681,458,420,139,281,0.413,0.369,0.303,12120,180.515729,451,498,0.437225636523266
"7821",194310,"PACE UNIVERSITY-NEW YORK",1,0,1996,1388,788,600,487,180,307,0.39,0.351,0.3,13080,192.752917,210,670,0.482708933717579
"7822",194310,"PACE UNIVERSITY-NEW YORK",1,0,1997,1476,859,617,588,203,385,0.448,0.398,0.329,13820,70.743613,200,723,0.489837398373984
"7823",194310,"PACE UNIVERSITY-NEW YORK",1,0,1998,1536,911,625,602,220,382,0.419,0.392,0.352,14690,168.813403,200,697,0.453776041666667
"7824",194310,"PACE UNIVERSITY-NEW YORK",1,0,1999,1500,895,605,604,205,399,0.446,0.403,0.339,15130,179.30546,209,646,0.430666666666667
"7825",194310,"PACE UNIVERSITY-NEW YORK",1,0,2000,1602,976,626,612,204,408,0.418,0.382,0.326,15870,175.948979,319,713,0.445068664169788
"7826",194310,"PACE UNIVERSITY-NEW YORK",1,0,2001,1573,948,625,567,192,375,0.396,0.36,0.307,16650,204.308279,429,607,0.385886840432295
"7827",194310,"PACE UNIVERSITY-NEW YORK",1,0,2002,1508,916,592,592,190,402,0.439,0.393,0.321,17800,211.649686,432,686,0.454907161803714
"7828",194310,"PACE UNIVERSITY-NEW YORK",1,0,2003,1553,997,556,653,214,439,0.44,0.42,0.385,20540,225.870373,426,783,0.504185447520927
"7829",194310,"PACE UNIVERSITY-NEW YORK",1,0,2004,1437,900,537,577,194,383,0.426,0.402,0.361,22100,239.227855,448,663,0.461377870563674
"7830",194310,"Pace University-New York",1,0,2005,1474,954,520,584,186,398,0.417,0.396,0.358,24752,258.300075,474,741,0.502713704206242
"7831",194310,"Pace University-New York",1,0,2006,1131,738,393,441,126,315,0.427,0.39,0.321,29454,274.182103,460,589,0.52077807250221
"7832",194310,"Pace University-New York",1,0,2007,1537,937,600,528,183,345,0.368,0.344,0.305,29454,280.345295,416,696,0.452830188679245
"7833",194310,"Pace University-New York",1,0,2008,1616,1002,614,589,208,381,0.38,0.364,0.339,30632,266.823445,415,717,0.443688118811881
"7834",194310,"Pace University-New York",1,0,2009,1637,1036,601,603,194,409,0.395,0.368,0.323,31860,280.257716,416,768,0.469150885766646
"7835",194310,"Pace University-New York",1,0,2010,1766,1089,677,696,240,456,0.419,0.394,0.355,32656,277.047402,414,491,0.278029445073613
"7836",194824,"RENSSELAER POLYTECHNIC INSTITUTE",1,0,1991,971,193,778,428,334,94,0.487,0.441,0.429,15633,174.196,374,669,0.688980432543769
"7837",194824,"RENSSELAER POLYTECHNIC INSTITUTE",1,0,1992,1083,216,867,483,368,115,0.532,0.446,0.424,16402,186.741,369,762,0.703601108033241
"7838",194824,"RENSSELAER POLYTECHNIC INSTITUTE",1,0,1993,936,168,768,408,303,105,0.625,0.436,0.395,17335,186.785,369,638,0.681623931623932
"7839",194824,"RENSSELAER POLYTECHNIC INSTITUTE",1,0,1995,962,243,719,425,296,129,0.531,0.442,0.412,18656,184.644,333,725,0.753638253638254
"7840",194824,"RENSSELAER POLYTECHNIC INSTITUTE",1,0,1996,898,225,673,454,318,136,0.604,0.506,0.473,19685,185.548,336,654,0.728285077951002
"7841",194824,"RENSSELAER POLYTECHNIC INSTITUTE",1,0,1997,1069,267,802,584,414,170,0.637,0.546,0.516,20960,178.164,326,719,0.672591206735267
"7842",194824,"RENSSELAER POLYTECHNIC INSTITUTE",1,0,1998,1138,258,880,654,483,171,0.663,0.575,0.549,21655,179.431,340,765,0.672231985940246
"7843",194824,"RENSSELAER POLYTECHNIC INSTITUTE",1,0,1999,1323,295,1028,812,611,201,0.681,0.614,0.594,22300,194.992,343,928,0.701436130007559
"7844",194824,"RENSSELAER POLYTECHNIC INSTITUTE",1,0,2000,1303,334,969,833,603,230,0.689,0.639,0.622,23525,217.559,386,871,0.668457405986186
"7845",194824,"RENSSELAER POLYTECHNIC INSTITUTE",1,0,2001,1109,283,826,730,532,198,0.7,0.658,0.644,24820,233.383,429,770,0.694319206492335
"7846",194824,"RENSSELAER POLYTECHNIC INSTITUTE",1,0,2002,1047,263,784,672,490,182,0.692,0.642,0.625,26400,248.933,399,751,0.717287488061127
"7847",194824,"RENSSELAER POLYTECHNIC INSTITUTE",1,0,2003,1341,320,1021,856,626,230,0.719,0.638,0.613,27700,279.611,407,973,0.725577926920209
"7848",194824,"RENSSELAER POLYTECHNIC INSTITUTE",1,0,2004,1079,259,820,696,521,175,0.676,0.645,0.635,28950,296.327,405,792,0.73401297497683
"7849",194824,"Rensselaer Polytechnic Institute",1,0,2005,1236,283,953,745,550,195,0.689,0.603,0.577,31000,309.978,400,937,0.758090614886731
"7850",194824,"Rensselaer Polytechnic Institute",1,0,2006,1269,362,907,766,544,222,0.613,0.604,0.6,32600,335.036,393,966,0.761229314420804
"7851",194824,"Rensselaer Polytechnic Institute",1,0,2007,1288,389,899,836,576,260,0.668,0.649,0.641,34900,346.933,400,985,0.764751552795031
"7852",194824,"Rensselaer Polytechnic Institute",1,0,2008,1355,380,975,833,599,234,0.616,0.615,0.614,36950,374.068,394,980,0.723247232472325
"7853",194824,"Rensselaer Polytechnic Institute",1,0,2009,1337,360,977,840,599,241,0.669,0.628,0.613,38100,382.445,383,967,0.723261032161556
"7854",194824,"Rensselaer Polytechnic Institute",1,0,2010,1152,322,830,703,494,209,0.649,0.61,0.595,39600,384.823,378,834,0.723958333333333
"7855",195003,"ROCHESTER INSTITUTE OF TECHNOLOGY",0,1,1991,1265,370,895,287,162,125,0.338,0.227,0.181,12058,205.841,637,1034,0.817391304347826
"7856",195003,"ROCHESTER INSTITUTE OF TECHNOLOGY",0,1,1992,1482,432,1050,323,172,151,0.35,0.218,0.164,12760,219.294,640,1144,0.771929824561403
"7857",195003,"ROCHESTER INSTITUTE OF TECHNOLOGY",0,1,1993,1343,425,918,310,146,164,0.386,0.231,0.159,13555,224.833,664,1062,0.790766939687267
"7858",195003,"ROCHESTER INSTITUTE OF TECHNOLOGY",0,1,1995,1634,502,1132,621,379,242,0.482,0.38,0.335,14977,238.708,629,1218,0.745410036719706
"7859",195003,"ROCHESTER INSTITUTE OF TECHNOLOGY",0,1,1996,1725,571,1154,690,419,271,0.475,0.4,0.363,15691,237.505,537,1400,0.811594202898551
"7860",195003,"ROCHESTER INSTITUTE OF TECHNOLOGY",0,1,1997,1836,617,1219,727,446,281,0.455,0.396,0.366,16399,211.823,622,1457,0.793572984749455
"7861",195003,"ROCHESTER INSTITUTE OF TECHNOLOGY",0,1,1998,1980,609,1371,816,526,290,0.476,0.412,0.384,17067,226.268,634,1369,0.691414141414141
"7862",195003,"ROCHESTER INSTITUTE OF TECHNOLOGY",0,1,1999,2107,602,1505,366,187,179,0.297,0.174,0.124,17328,247.1,605,1614,0.766018035121025
"7863",195003,"ROCHESTER INSTITUTE OF TECHNOLOGY",0,1,2000,2278,636,1642,453,244,209,0.329,0.199,0.149,17934,283.63,616,1758,0.771729587357331
"7864",195003,"ROCHESTER INSTITUTE OF TECHNOLOGY",0,1,2001,2227,574,1653,451,249,202,0.352,0.203,0.151,18633,291.011,627,1630,0.731926358329591
"7865",195003,"ROCHESTER INSTITUTE OF TECHNOLOGY",0,1,2002,2327,614,1713,563,299,264,0.43,0.242,0.175,19470,321.408,684,1685,0.724108293940696
"7866",195003,"ROCHESTER INSTITUTE OF TECHNOLOGY",0,1,2003,2121,567,1554,538,286,252,0.444,0.254,0.184,21027,340.208,799,1522,0.717586044318718
"7867",195003,"ROCHESTER INSTITUTE OF TECHNOLOGY",0,1,2004,2233,562,1671,577,316,261,0.464,0.258,0.189,22056,363.329,731,1659,0.74294670846395
"7868",195003,"Rochester Institute of Technology",0,1,2005,2184,656,1528,587,289,298,0.454,0.269,0.189,23247,356.592,794,1582,0.724358974358974
"7869",195003,"Rochester Institute of Technology",0,1,2006,2355,675,1680,589,315,274,0.406,0.25,0.188,24627,384.507,766,1787,0.758811040339703
"7870",195003,"Rochester Institute of Technology",0,1,2007,2497,788,1709,648,306,342,0.434,0.26,0.179,26085,388.459,797,1881,0.753303964757709
"7871",195003,"Rochester Institute of Technology",0,1,2008,2594,848,1746,706,357,349,0.412,0.272,0.204,27624,393.29,924,1945,0.749807247494217
"7872",195003,"Rochester Institute of Technology",0,1,2009,2582,798,1784,796,413,383,0.48,0.308,0.232,28866,428.38,945,1858,0.719597211463981
"7873",195003,"Rochester Institute of Technology",0,1,2010,2583,820,1763,699,346,353,0.43,0.271,0.196,30282,467.52,961,1395,0.54006968641115
"7874",195030,"UNIVERSITY OF ROCHESTER",1,0,1991,1215,537,678,805,440,365,0.68,0.663,0.649,15513,656.319,526,856,0.704526748971193
"7875",195030,"UNIVERSITY OF ROCHESTER",1,0,1992,1266,585,681,824,425,399,0.682,0.651,0.624,16444,708.766,521,910,0.718799368088468
"7876",195030,"UNIVERSITY OF ROCHESTER",1,0,1993,1229,599,630,754,365,389,0.649,0.614,0.579,17345,790.713,508,867,0.705451586655818
"7877",195030,"UNIVERSITY OF ROCHESTER",1,0,1995,1205,583,622,751,354,397,0.681,0.623,0.569,19165,878.668,501,837,0.694605809128631
"7878",195030,"UNIVERSITY OF ROCHESTER",1,0,1996,1011,501,510,719,336,383,0.765,0.711,0.659,20080,887.459,498,677,0.669634025717112
"7879",195030,"UNIVERSITY OF ROCHESTER",1,0,1997,892,404,488,592,301,291,0.72,0.664,0.617,21020,867.324,486,639,0.716367713004484
"7880",195030,"UNIVERSITY OF ROCHESTER",1,0,1998,1062,481,581,730,372,358,0.744,0.687,0.64,21981,1042.609,476,696,0.655367231638418
"7881",195030,"UNIVERSITY OF ROCHESTER",1,0,1999,1211,525,686,828,429,399,0.76,0.684,0.625,22300,1168.407,475,739,0.610239471511148
"7882",195030,"UNIVERSITY OF ROCHESTER",1,0,2000,1044,460,584,741,395,346,0.752,0.71,0.676,23130,1309.506,487,640,0.613026819923372
"7883",195030,"UNIVERSITY OF ROCHESTER",1,0,2001,1095,481,614,767,390,377,0.784,0.7,0.635,24150,1383.682,499,699,0.638356164383562
"7884",195030,"UNIVERSITY OF ROCHESTER",1,0,2002,1055,492,563,776,392,384,0.78,0.736,0.696,25430,1528.304,506,675,0.639810426540284
"7885",195030,"UNIVERSITY OF ROCHESTER",1,0,2003,1086,508,578,747,368,379,0.746,0.688,0.637,26900,1632.857,513,650,0.598526703499079
"7886",195030,"UNIVERSITY OF ROCHESTER",1,0,2004,1083,496,587,808,409,399,0.804,0.746,0.697,28250,1774.62,556,726,0.670360110803324
"7887",195030,"University of Rochester",1,0,2005,1106,563,543,808,376,432,0.767,0.731,0.692,30540,1878.694,552,712,0.64376130198915
"7888",195030,"University of Rochester",1,0,2006,1219,561,658,906,467,439,0.782,0.743,0.71,32650,2041.783,569,667,0.547169811320755
"7889",195030,"University of Rochester",1,0,2007,1181,603,578,905,415,490,0.813,0.766,0.718,34380,2177.08,566,635,0.537679932260796
"7890",195030,"University of Rochester",1,0,2008,1282,642,640,936,442,494,0.77,0.73,0.691,36410,2338.735,567,683,0.532761310452418
"7891",195030,"University of Rochester",1,0,2009,1195,594,601,890,431,459,0.773,0.745,0.717,37870,2448.374,573,631,0.528033472803347
"7892",195030,"University of Rochester",1,0,2010,1305,641,664,120,69,51,0.08,0.092,0.104,39480,2518.123,588,777,0.595402298850575
"7893",195164,"SAINT BONAVENTURE UNIVERSITY",1,0,1991,479,236,243,267,117,150,0.636,0.557,0.481,9067,37.06,145,440,0.918580375782881
"7894",195164,"SAINT BONAVENTURE UNIVERSITY",1,0,1992,441,216,225,226,93,133,0.616,0.512,0.413,9284,40.363,169,399,0.904761904761905
"7895",195164,"SAINT BONAVENTURE UNIVERSITY",1,0,1993,370,187,183,215,95,120,0.642,0.581,0.519,9656,43.159,154,350,0.945945945945946
"7896",195164,"SAINT BONAVENTURE UNIVERSITY",1,0,1995,547,278,269,285,127,158,0.568,0.521,0.472,11604,35.539,110,482,0.881170018281536
"7897",195164,"SAINT BONAVENTURE UNIVERSITY",1,0,1996,590,311,279,327,153,174,0.559,0.554,0.548,12439,41.838863,116,534,0.905084745762712
"7898",195164,"SAINT BONAVENTURE UNIVERSITY",1,0,1997,542,274,268,309,144,165,0.602,0.57,0.537,13100,34.018764,121,292,0.538745387453875
"7899",195164,"SAINT BONAVENTURE UNIVERSITY",1,0,1998,568,284,284,290,126,164,0.578,0.511,0.444,13800,36.644475,133,463,0.815140845070423
"7900",195164,"SAINT BONAVENTURE UNIVERSITY",1,0,1999,520,294,226,273,100,173,0.588,0.525,0.442,13880,39.205258,147,276,0.530769230769231
"7901",195164,"SAINT BONAVENTURE UNIVERSITY",1,0,2000,584,316,268,309,116,193,0.611,0.529,0.433,14510,41.28382,147.5,306,0.523972602739726
"7902",195164,"SAINT BONAVENTURE UNIVERSITY",1,0,2001,518,263,255,280,121,159,0.605,0.541,0.475,15526,42.337653,148,286,0.552123552123552
"7903",195164,"SAINT BONAVENTURE UNIVERSITY",1,0,2002,584,295,289,300,136,164,0.556,0.514,0.471,16210,47.62525,154,340,0.582191780821918
"7904",195164,"SAINT BONAVENTURE UNIVERSITY",1,0,2003,595,292,303,296,135,161,0.551,0.497,0.446,17190,52.636959,156,371,0.623529411764706
"7905",195164,"SAINT BONAVENTURE UNIVERSITY",1,0,2004,574,304,270,305,134,171,0.562,0.531,0.496,18650,52.360004,153,387,0.674216027874564
"7906",195164,"Saint Bonaventure University",1,0,2005,477,225,252,239,112,127,0.564,0.501,0.444,20610,53.531564,157,352,0.737945492662474
"7907",195164,"Saint Bonaventure University",1,0,2006,459,234,225,235,105,130,0.556,0.512,0.467,21650,52.846935,149,361,0.786492374727669
"7908",195164,"Saint Bonaventure University",1,0,2007,527,264,263,283,133,150,0.568,0.537,0.506,22740,49.142191,141,389,0.738140417457306
"7909",195164,"Saint Bonaventure University",1,0,2008,563,315,248,310,113,197,0.625,0.551,0.456,23920,50.856328,145,416,0.738898756660746
"7910",195164,"Saint Bonaventure University",1,0,2009,465,249,216,252,106,146,0.586,0.542,0.491,24920,52.292147,155,338,0.726881720430108
"7911",195164,"Saint Bonaventure University",1,0,2010,494,242,252,257,116,141,0.583,0.52,0.46,25930,50.729018,157,366,0.740890688259109
"7912",195173,"ST FRANCIS COLLEGE",1,0,1991,353,207,146,68,26,42,0.203,0.193,0.178,5850,13.068,52,196,0.555240793201133
"7913",195173,"ST FRANCIS COLLEGE",1,0,1992,372,200,172,63,26,37,0.185,0.169,0.151,6550,16.59,53,206,0.553763440860215
"7914",195173,"ST FRANCIS COLLEGE",1,0,1993,358,214,144,107,40,67,0.313,0.299,0.278,6710,18.200745,56,212,0.592178770949721
"7915",195173,"ST FRANCIS COLLEGE",1,0,1995,281,145,136,89,48,41,0.283,0.317,0.353,7360,16.669,59,170,0.604982206405694
"7916",195173,"ST FRANCIS COLLEGE",1,0,1996,305,181,124,93,35,58,0.32,0.305,0.282,7739,18.926491,58,163,0.534426229508197
"7917",195173,"ST FRANCIS COLLEGE",1,0,1997,410,253,157,95,26,69,0.273,0.232,0.166,8160,14.619698,62,217,0.529268292682927
"7918",195173,"ST FRANCIS COLLEGE",1,0,1998,440,259,181,146,40,106,0.409,0.332,0.221,8480,16.271836,65,237,0.538636363636364
"7919",195173,"ST FRANCIS COLLEGE",1,0,1999,474,284,190,130,54,76,0.268,0.274,0.284,8250,18.221099,66,277,0.584388185654008
"7920",195173,"ST FRANCIS COLLEGE",1,0,2000,434,242,192,191,72,119,0.492,0.44,0.375,8900,19.761108,66,253,0.58294930875576
"7921",195173,"ST FRANCIS COLLEGE",1,0,2001,471,220,251,171,75,96,0.436,0.363,0.299,9450,21.472859,66,235,0.498938428874735
"7922",195173,"ST FRANCIS COLLEGE",1,0,2002,454,238,216,153,61,92,0.387,0.337,0.282,9920,22.799697,65,258,0.568281938325991
"7923",195173,"ST FRANCIS COLLEGE",1,0,2003,428,224,204,71,18,53,0.237,0.166,0.088,10620,23.27176,69,225,0.525700934579439
"7924",195173,"ST FRANCIS COLLEGE",1,0,2004,473,228,245,148,67,81,0.355,0.313,0.273,11420,26.206499,70,226,0.477801268498943
"7925",195173,"St Francis College",1,0,2005,497,224,273,140,68,72,0.321,0.282,0.249,12450,27.888619,71,238,0.47887323943662
"7926",195173,"St Francis College",1,0,2006,474,253,221,137,61,76,0.3,0.289,0.276,13500,30.370135,76,228,0.481012658227848
"7927",195173,"St Francis College",1,0,2007,478,261,217,130,48,82,0.314,0.272,0.221,14400,34.174412,76,204,0.426778242677824
"7928",195173,"St. Francis College",1,0,2008,566,292,274,160,68,92,0.315,0.283,0.248,15200,33.494012,75,275,0.485865724381625
"7929",195173,"St. Francis College",1,0,2009,580,301,279,168,63,105,0.349,0.29,0.226,16040,37.593041,77,279,0.481034482758621
"7930",195173,"St. Francis College",1,0,2010,559,289,270,151,65,86,0.298,0.27,0.241,16720,38.290308,80,223,0.398926654740608
"7931",195216,"SAINT LAWRENCE UNIVERSITY",1,0,1991,421,213,208,322,142,180,0.845,0.765,0.683,15735,54.136,158,381,0.904988123515439
"7932",195216,"ST LAWRENCE UNIVERSITY",1,0,1992,601,294,307,413,207,206,0.701,0.687,0.674,16820,56.726,151,552,0.91846921797005
"7933",195216,"ST LAWRENCE UNIVERSITY",1,0,1993,507,260,247,353,167,186,0.715,0.696,0.676,17890,59.739,153,442,0.871794871794872
"7934",195216,"ST LAWRENCE UNIVERSITY",1,0,1995,571,287,284,382,176,206,0.718,0.669,0.62,19790,62.201,154,517,0.905429071803853
"7935",195216,"ST LAWRENCE UNIVERSITY",1,0,1996,592,281,311,388,209,179,0.637,0.655,0.672,20560,68.136278,149,529,0.893581081081081
"7936",195216,"ST LAWRENCE UNIVERSITY",1,0,1997,476,232,244,328,148,180,0.776,0.689,0.607,21325,53.771733,154,434,0.911764705882353
"7937",195216,"ST LAWRENCE UNIVERSITY",1,0,1998,479,255,224,339,155,184,0.722,0.708,0.692,22120,54.990281,153,364,0.759916492693111
"7938",195216,"ST LAWRENCE UNIVERSITY",1,0,1999,575,301,274,410,182,228,0.758,0.713,0.664,22905,59.123953,156,459,0.798260869565217
"7939",195216,"ST LAWRENCE UNIVERSITY",1,0,2000,612,325,287,436,186,250,0.769,0.712,0.648,23765,63.984889,157,440,0.718954248366013
"7940",195216,"ST LAWRENCE UNIVERSITY",1,0,2001,511,269,242,377,179,198,0.736,0.738,0.74,24655,69.788155,158,341,0.667318982387476
"7941",195216,"ST LAWRENCE UNIVERSITY",1,0,2002,615,316,299,443,197,246,0.778,0.72,0.659,26280,74.009371,171,427,0.694308943089431
"7942",195216,"ST LAWRENCE UNIVERSITY",1,0,2003,565,296,269,444,196,248,0.838,0.786,0.729,27985,81.862382,168,394,0.697345132743363
"7943",195216,"ST LAWRENCE UNIVERSITY",1,0,2004,566,298,268,444,203,241,0.809,0.784,0.757,30270,84.971315,171,419,0.740282685512368
"7944",195216,"St Lawrence University",1,0,2005,534,268,266,407,190,217,0.81,0.762,0.714,31935,88.718122,181,415,0.777153558052434
"7945",195216,"St Lawrence University",1,0,2006,608,325,283,463,210,253,0.778,0.762,0.742,33690,94.065092,179,495,0.814144736842105
"7946",195216,"St Lawrence University",1,0,2007,627,383,244,482,181,301,0.786,0.769,0.742,35375,96.504418,187,508,0.810207336523126
"7947",195216,"St Lawrence University",1,0,2008,616,334,282,490,220,270,0.808,0.795,0.78,37675,106.976435,190,512,0.831168831168831
"7948",195216,"St Lawrence University",1,0,2009,579,307,272,476,219,257,0.837,0.822,0.805,39520,109.151302,183,492,0.849740932642487
"7949",195216,"St Lawrence University",1,0,2010,609,316,293,492,227,265,0.839,0.808,0.775,40905,109.12866,179,495,0.812807881773399
"7950",195234,"COLLEGE OF SAINT ROSE",1,0,1991,207,152,55,106,24,82,0.54,0.512,0.436,8420,25.563,118,184,0.888888888888889
"7951",195234,"COLLEGE OF SAINT ROSE",1,0,1992,233,177,56,122,21,101,0.571,0.524,0.375,9036,30.529,118,204,0.875536480686695
"7952",195234,"COLLEGE OF SAINT ROSE",1,0,1993,236,160,76,116,24,92,0.575,0.492,0.316,9562,33.295,129,213,0.902542372881356
"7953",195234,"THE COLLEGE OF SAINT ROSE",1,0,1995,248,170,78,111,34,77,0.453,0.448,0.436,10610,38.172,135,225,0.907258064516129
"7954",195234,"THE COLLEGE OF SAINT ROSE",1,0,1996,319,226,93,146,30,116,0.513,0.458,0.323,11174,38.014557,130,273,0.855799373040752
"7955",195234,"THE COLLEGE OF SAINT ROSE",1,0,1997,311,223,88,146,29,117,0.525,0.469,0.33,11684,31.965706,135,290,0.932475884244373
"7956",195234,"THE COLLEGE OF SAINT ROSE",1,0,1998,345,262,83,175,29,146,0.557,0.507,0.349,11968,33.043686,130,313,0.907246376811594
"7957",195234,"THE COLLEGE OF SAINT ROSE",1,0,1999,401,297,104,202,39,163,0.549,0.504,0.375,12434,35.754293,138,368,0.917705735660848
"7958",195234,"THE COLLEGE OF SAINT ROSE",1,0,2000,485,349,136,216,47,169,0.484,0.445,0.346,12870,38.611289,148.5,442,0.911340206185567
"7959",195234,"THE COLLEGE OF SAINT ROSE",1,0,2001,490,356,134,239,45,194,0.545,0.488,0.336,13578,42.481622,159,435,0.887755102040816
"7960",195234,"THE COLLEGE OF SAINT ROSE",1,0,2002,526,391,135,303,65,238,0.609,0.576,0.481,14244,47.392703,163,467,0.887832699619772
"7961",195234,"THE COLLEGE OF SAINT ROSE",1,0,2003,531,397,134,277,52,225,0.567,0.522,0.388,15242,52.224842,166,455,0.856873822975518
"7962",195234,"THE COLLEGE OF SAINT ROSE",1,0,2004,563,408,155,387,91,296,0.726,0.687,0.587,16230,52.975308,171,388,0.689165186500888
"7963",195234,"The College of Saint Rose",1,0,2005,595,411,184,330,75,255,0.62,0.555,0.408,17368,58.261525,181,452,0.759663865546218
"7964",195234,"The College of Saint Rose",1,0,2006,630,423,207,328,88,240,0.567,0.521,0.425,18672,63.516062,197,510,0.80952380952381
"7965",195234,"The College of Saint Rose",1,0,2007,611,456,155,326,63,263,0.577,0.534,0.406,19860,69.45843,204,487,0.797054009819967
"7966",195234,"The College of Saint Rose",1,0,2008,574,415,159,312,72,240,0.578,0.544,0.453,21260,75.704513,204,462,0.804878048780488
"7967",195234,"The College of Saint Rose",1,0,2009,583,381,202,271,76,195,0.512,0.465,0.376,22324,82.451682,207,425,0.728987993138937
"7968",195234,"The College of Saint Rose",1,0,2010,639,432,207,313,83,230,0.532,0.49,0.401,23330,84.350729,206,474,0.741784037558685
"7969",195243,"SAINT THOMAS AQUINAS COLLEGE",1,0,1991,198,113,85,95,28,67,0.593,0.48,0.329,6750,11.579,66,177,0.893939393939394
"7970",195243,"SAINT THOMAS AQUINAS COLLEGE",1,0,1992,214,125,89,53,9,44,0.352,0.248,0.101,7350,13.901,63,162,0.757009345794392
"7971",195243,"SAINT THOMAS AQUINAS COLLEGE",1,0,1993,211,132,79,86,24,62,0.47,0.408,0.304,8150,14.761,63,170,0.805687203791469
"7972",195243,"SAINT THOMAS AQUINAS COLLEGE",1,0,1995,276,162,114,74,22,52,0.321,0.268,0.193,9450,18.72,63,192,0.695652173913043
"7973",195243,"SAINT THOMAS AQUINAS COLLEGE",1,0,1996,238,142,96,65,16,49,0.345,0.273,0.167,10100,20.741311,63,183,0.76890756302521
"7974",195243,"SAINT THOMAS AQUINAS COLLEGE",1,0,1997,300,179,121,106,34,72,0.402,0.353,0.281,10700,17.316485,61,241,0.803333333333333
"7975",195243,"SAINT THOMAS AQUINAS COLLEGE",1,0,1998,306,179,127,97,34,63,0.352,0.317,0.268,11420,18.645096,62,236,0.77124183006536
"7976",195243,"SAINT THOMAS AQUINAS COLLEGE",1,0,1999,304,168,136,103,33,70,0.417,0.339,0.243,11800,19.057319,61,213,0.700657894736842
"7977",195243,"SAINT THOMAS AQUINAS COLLEGE",1,0,2000,298,173,125,117,38,79,0.457,0.393,0.304,12500,19.825788,61,188,0.630872483221476
"7978",195243,"SAINT THOMAS AQUINAS COLLEGE",1,0,2001,301,164,137,101,35,66,0.402,0.336,0.255,13120,21.382591,61,195,0.647840531561462
"7979",195243,"SAINT THOMAS AQUINAS COLLEGE",1,0,2002,329,191,138,130,38,92,0.482,0.395,0.275,13780,22.614356,62,209,0.635258358662614
"7980",195243,"SAINT THOMAS AQUINAS COLLEGE",1,0,2003,343,188,155,97,39,58,0.308,0.283,0.252,14500,24.727578,65,231,0.673469387755102
"7981",195243,"SAINT THOMAS AQUINAS COLLEGE",1,0,2004,349,168,181,112,56,56,0.333,0.321,0.309,15300,26.091865,64,225,0.644699140401146
"7982",195243,"Saint Thomas Aquinas College",1,0,2005,327,188,139,119,43,76,0.404,0.364,0.309,16200,22.444659,61,238,0.72782874617737
"7983",195243,"Saint Thomas Aquinas College",1,0,2006,323,185,138,113,39,74,0.4,0.35,0.283,17200,23.284487,62,229,0.708978328173375
"7984",195243,"Saint Thomas Aquinas College",1,0,2007,324,163,161,117,49,68,0.417,0.361,0.304,18400,24.265306,64,227,0.700617283950617
"7985",195243,"Saint Thomas Aquinas College",1,0,2008,352,213,139,140,44,96,0.451,0.398,0.317,19500,26.449588,63,239,0.678977272727273
"7986",195243,"Saint Thomas Aquinas College",1,0,2009,293,156,137,105,56,49,0.314,0.358,0.409,20670,27.713658,66,195,0.665529010238908
"7987",195243,"Saint Thomas Aquinas College",1,0,2010,290,173,117,123,40,83,0.48,0.424,0.342,21910,28.014191,61,178,0.613793103448276
"7988",195304,"SARAH LAWRENCE COLLEGE",1,0,1991,228,168,60,125,34,91,0.542,0.548,0.567,16750,24.582,64,193,0.846491228070175
"7989",195304,"SARAH LAWRENCE COLLEGE",1,0,1992,220,168,52,127,30,97,0.577,0.577,0.577,17640,26.444,67,181,0.822727272727273
"7990",195304,"SARAH LAWRENCE COLLEGE",1,0,1993,255,195,60,131,31,100,0.513,0.514,0.517,18460,28.727,69,200,0.784313725490196
"7991",195304,"SARAH LAWRENCE COLLEGE",1,0,1995,233,183,50,118,29,89,0.486,0.506,0.58,20708,32.929,76,183,0.785407725321888
"7992",195304,"SARAH LAWRENCE COLLEGE",1,0,1996,294,219,75,193,47,146,0.667,0.656,0.627,21836,35.153068,78,234,0.795918367346939
"7993",195304,"SARAH LAWRENCE COLLEGE",1,0,1997,283,222,61,174,33,141,0.635,0.615,0.541,22936,30.741031,76,236,0.833922261484099
"7994",195304,"SARAH LAWRENCE COLLEGE",1,0,1998,306,227,79,202,57,145,0.639,0.66,0.722,24066,33.307823,78,243,0.794117647058823
"7995",195304,"SARAH LAWRENCE COLLEGE",1,0,1999,278,215,63,180,44,136,0.633,0.647,0.698,24810,36.519407,88,203,0.73021582733813
"7996",195304,"SARAH LAWRENCE COLLEGE",1,0,2000,292,212,80,204,56,148,0.698,0.699,0.7,26040,39.789081,92.5,203,0.695205479452055
"7997",195304,"SARAH LAWRENCE COLLEGE",1,0,2001,323,240,83,213,50,163,0.679,0.659,0.602,27330,43.029005,97,239,0.739938080495356
"7998",195304,"SARAH LAWRENCE COLLEGE",1,0,2002,323,249,74,205,56,149,0.598,0.635,0.757,28680,46.272909,103,261,0.808049535603715
"7999",195304,"SARAH LAWRENCE COLLEGE",1,0,2003,322,234,88,218,63,155,0.662,0.677,0.716,30120,50.605341,106,243,0.754658385093168
"8000",195304,"SARAH LAWRENCE COLLEGE",1,0,2004,329,253,76,233,50,183,0.723,0.708,0.658,31680,53.860223,104,254,0.772036474164134
"8001",195304,"Sarah Lawrence College",1,0,2005,376,285,91,237,50,187,0.656,0.63,0.549,33270,56.315867,111,308,0.819148936170213
"8002",195304,"Sarah Lawrence College",1,0,2006,381,286,95,261,62,199,0.696,0.685,0.653,35280,62.27891,112,286,0.750656167979003
"8003",195304,"Sarah Lawrence College",1,0,2007,363,278,85,226,50,176,0.633,0.623,0.588,37230,65.033092,111,209,0.575757575757576
"8004",195304,"Sarah Lawrence College",1,0,2008,348,273,75,246,57,189,0.692,0.707,0.76,39450,68.143873,113,254,0.729885057471264
"8005",195304,"Sarah Lawrence College",1,0,2009,365,273,92,263,72,191,0.7,0.721,0.783,41040,69.708637,107,270,0.73972602739726
"8006",195304,"Sarah Lawrence College",1,0,2010,338,238,100,249,68,181,0.76,0.737,0.68,42600,68.550836,102,231,0.683431952662722
"8007",195474,"SIENA COLLEGE",1,0,1991,584,307,277,455,220,235,0.765,0.779,0.794,9060,36.743,143,537,0.919520547945205
"8008",195474,"SIENA COLLEGE",1,0,1992,544,315,229,399,153,246,0.781,0.733,0.668,9810,38.697,149,497,0.913602941176471
"8009",195474,"SIENA COLLEGE",1,0,1993,616,339,277,421,185,236,0.696,0.683,0.668,10505,41.501,155,554,0.899350649350649
"8010",195474,"SIENA COLLEGE",1,0,1995,590,317,273,393,182,211,0.666,0.666,0.667,11650,44.587,145,552,0.935593220338983
"8011",195474,"SIENA COLLEGE",1,0,1996,558,325,233,354,137,217,0.668,0.634,0.588,12150,49.699806,139,522,0.935483870967742
"8012",195474,"SIENA COLLEGE",1,0,1997,583,301,282,400,181,219,0.728,0.686,0.642,12770,39.064707,139,545,0.934819897084048
"8013",195474,"SIENA COLLEGE",1,0,1998,619,311,308,436,202,234,0.752,0.704,0.656,13545,41.273855,139,570,0.920840064620355
"8014",195474,"SIENA COLLEGE",1,0,1999,677,381,296,491,197,294,0.772,0.725,0.666,13660,45.448554,145,603,0.89069423929099
"8015",195474,"SIENA COLLEGE",1,0,2000,765,404,361,547,234,313,0.775,0.715,0.648,14330,48.115188,150.5,704,0.920261437908497
"8016",195474,"SIENA COLLEGE",1,0,2001,713,394,319,530,230,300,0.761,0.743,0.721,15330,50.642308,156,639,0.896213183730715
"8017",195474,"SIENA COLLEGE",1,0,2002,677,405,272,497,185,312,0.77,0.734,0.68,16405,56.650974,160,591,0.872968980797637
"8018",195474,"SIENA COLLEGE",1,0,2003,759,438,321,519,204,315,0.719,0.684,0.636,17555,60.346165,165,660,0.869565217391304
"8019",195474,"SIENA COLLEGE",1,0,2004,715,412,303,532,212,320,0.777,0.744,0.7,18590,63.410491,169,616,0.861538461538462
"8020",195474,"Siena College",1,0,2005,763,443,320,531,225,306,0.691,0.696,0.703,20100,65.175192,172,646,0.846657929226737
"8021",195474,"Siena College",1,0,2006,688,393,295,478,190,288,0.733,0.695,0.644,21285,69.764077,175,579,0.841569767441861
"8022",195474,"Siena College",1,0,2007,781,463,318,578,219,359,0.775,0.74,0.689,22510,71.69741,178,668,0.855313700384123
"8023",195474,"Siena College",1,0,2008,824,444,380,613,272,341,0.768,0.744,0.716,23750,76.778319,181,704,0.854368932038835
"8024",195474,"Siena College",1,0,2009,783,417,366,563,239,324,0.777,0.719,0.653,25060,84.258251,188,656,0.837803320561941
"8025",195474,"Siena College",1,0,2010,768,410,358,539,228,311,0.758,0.702,0.637,26185,90.353589,199,634,0.825520833333333
"8026",195526,"SKIDMORE COLLEGE",1,0,1991,652,392,260,401,139,262,0.668,0.615,0.535,15991,56.238,171,538,0.825153374233129
"8027",195526,"SKIDMORE COLLEGE",1,0,1992,615,369,246,425,144,281,0.762,0.691,0.585,16650,59.695,165,505,0.821138211382114
"8028",195526,"SKIDMORE COLLEGE",1,0,1993,588,355,233,414,153,261,0.735,0.704,0.657,17560,63.317,168,476,0.80952380952381
"8029",195526,"SKIDMORE COLLEGE",1,0,1995,606,373,233,438,152,286,0.767,0.723,0.652,19725,68.399,158,487,0.803630363036304
"8030",195526,"SKIDMORE COLLEGE",1,0,1996,702,424,278,501,196,305,0.719,0.714,0.705,20670,71.27,158,559,0.796296296296296
"8031",195526,"SKIDMORE COLLEGE",1,0,1997,605,372,233,452,175,277,0.745,0.747,0.751,21750,66.011,173,485,0.801652892561983
"8032",195526,"SKIDMORE COLLEGE",1,0,1998,596,366,230,482,193,289,0.79,0.809,0.839,22853,68.054,198,471,0.790268456375839
"8033",195526,"SKIDMORE COLLEGE",1,0,1999,642,367,275,470,189,281,0.766,0.732,0.687,24000,73.362,211,485,0.755451713395639
"8034",195526,"SKIDMORE COLLEGE",1,0,2000,599,345,254,461,186,275,0.797,0.77,0.732,25190,76.108,203.5,433,0.722871452420701
"8035",195526,"SKIDMORE COLLEGE",1,0,2001,598,352,246,469,196,273,0.776,0.784,0.797,26400,78.549,196,430,0.719063545150502
"8036",195526,"SKIDMORE COLLEGE",1,0,2002,634,383,251,494,191,303,0.791,0.779,0.761,27700,87.017,192,443,0.698738170347003
"8037",195526,"SKIDMORE COLLEGE",1,0,2003,642,377,265,527,208,319,0.846,0.821,0.785,29350,94.123,231,452,0.70404984423676
"8038",195526,"SKIDMORE COLLEGE",1,0,2004,676,383,293,539,229,310,0.809,0.797,0.782,30800,91.677,237,490,0.724852071005917
"8039",195526,"Skidmore College",1,0,2005,694,433,261,567,202,365,0.843,0.817,0.774,32340,97.665,236,508,0.731988472622478
"8040",195526,"Skidmore College",1,0,2006,672,388,284,565,231,334,0.861,0.841,0.813,34224,105.361,257,495,0.736607142857143
"8041",195526,"Skidmore College",1,0,2007,682,406,276,564,213,351,0.865,0.827,0.772,36126,116.889,248,470,0.689149560117302
"8042",195526,"Skidmore College",1,0,2008,652,400,252,552,212,340,0.85,0.847,0.841,38114,127.472,258,484,0.742331288343558
"8043",195526,"Skidmore College",1,0,2009,663,414,249,549,194,355,0.858,0.828,0.779,39600,124.735,248,494,0.745098039215686
"8044",195526,"Skidmore College",1,0,2010,768,485,283,653,225,428,0.883,0.85,0.795,40350,129.966,244,526,0.684895833333333
"8045",195544,"SAINT JOSEPHS COLLEGE MAIN CAMPUS",1,0,1991,65,47,18,41,9,32,0.681,0.631,0.5,6280,14.842,80,46,0.707692307692308
"8046",195544,"SAINT JOSEPHS COLLEGE MAIN CAMPUS",1,0,1992,55,42,13,32,7,25,0.595,0.582,0.538,6700,17.146,80,36,0.654545454545455
"8047",195544,"SAINT JOSEPHS COLLEGE-MAIN CAMPUS",1,0,1993,78,61,17,42,10,32,0.525,0.538,0.588,7122,19.227,81,55,0.705128205128205
"8048",195544,"SAINT JOSEPHS COLLEGE-MAIN CAMPUS",1,0,1995,84,64,20,56,9,47,0.734,0.667,0.45,7818,25.393,87,62,0.738095238095238
"8049",195544,"SAINT JOSEPHS COLLEGE-MAIN CAMPUS",1,0,1996,97,76,21,59,8,51,0.671,0.608,0.381,8116,25.194207,89,68,0.701030927835051
"8050",195544,"SAINT JOSEPHS COLLEGE-MAIN CAMPUS",1,0,1997,107,74,33,60,18,42,0.568,0.561,0.545,8428,22.926,92,73,0.682242990654206
"8051",195544,"SAINT JOSEPHS COLLEGE-MAIN CAMPUS",1,0,1998,100,82,18,69,9,60,0.732,0.69,0.5,8672,23.18,100,72,0.72
"8052",195544,"SAINT JOSEPHS COLLEGE-MAIN CAMPUS",1,0,1999,77,55,22,51,8,43,0.782,0.662,0.364,8600,25.007,108,57,0.74025974025974
"8053",195544,"SAINT JOSEPHS COLLEGE-MAIN CAMPUS",1,0,2000,98,80,18,67,6,61,0.763,0.684,0.333,9030,28.257,113,66,0.673469387755102
"8054",195544,"SAINT JOSEPHS COLLEGE-MAIN CAMPUS",1,0,2001,66,56,10,43,4,39,0.696,0.652,0.4,9480,32.496,118,45,0.681818181818182
"8055",195544,"SAINT JOSEPHS COLLEGE-MAIN CAMPUS",1,0,2002,109,92,17,78,11,67,0.728,0.716,0.647,10050,34.749,128,71,0.651376146788991
"8056",195544,"SAINT JOSEPHS COLLEGE-MAIN CAMPUS",1,0,2003,96,80,16,67,10,57,0.713,0.698,0.625,10550,38.442,130,67,0.697916666666667
"8057",195544,"SAINT JOSEPHS COLLEGE-MAIN CAMPUS",1,0,2004,593,420,173,311,68,243,0.579,0.524,0.393,11078,43.212,138,418,0.704890387858347
"8058",195544,"Saint Josephs College-Main Campus",1,0,2005,605,446,159,291,57,234,0.525,0.481,0.358,11854,47.792,148,466,0.770247933884298
"8059",195544,"Saint Josephs College-Main Campus",1,0,2006,597,424,173,309,68,241,0.568,0.518,0.393,12564,12.2,50,453,0.758793969849246
"8060",195544,"Saint Josephs College-Main Campus",1,0,2007,672,474,198,373,87,286,0.603,0.555,0.439,14000,13.36,48,502,0.74702380952381
"8061",195544,"Saint Josephs College-Main Campus",1,0,2008,613,420,193,326,84,242,0.576,0.532,0.435,15400,14.415,50,462,0.753670473083197
"8062",195544,"Saint Josephs College-Main Campus",1,0,2009,700,519,181,374,73,301,0.58,0.534,0.403,16200,15.151,52,489,0.698571428571429
"8063",195544,"Saint Joseph's College-New York",1,0,2010,697,498,199,403,102,301,0.604,0.578,0.513,17000,68.71,172,465,0.667144906743185
"8064",195809,"SAINT JOHN'S UNIVERSITY NEW YORK",1,0,1991,2483,1282,1201,612,253,359,0.28,0.246,0.211,7530,147.205,934,1423,0.573097060008055
"8065",195809,"SAINT JOHN'S UNIVERSITY NEW YORK",1,0,1992,2326,1211,1115,526,223,303,0.25,0.226,0.2,8230,184.347,610,1376,0.591573516766982
"8066",195809,"SAINT JOHNS UNIVERSITY-NEW YORK",1,0,1993,2324,1174,1150,565,223,342,0.291,0.243,0.194,8980,188.35603,610,1371,0.589931153184165
"8067",195809,"SAINT JOHNS UNIVERSITY-NEW YORK",1,0,1995,2206,1181,1025,629,234,395,0.334,0.285,0.228,10450,212.386,582,1146,0.519492293744334
"8068",195809,"SAINT JOHNS UNIVERSITY-NEW YORK",1,0,1996,2157,1146,1011,629,229,400,0.349,0.292,0.227,11380,207.633653,553,1105,0.512285581826611
"8069",195809,"SAINT JOHNS UNIVERSITY-NEW YORK",1,0,1997,2480,1358,1122,789,311,478,0.352,0.318,0.277,12230,186.338842,548,1135,0.457661290322581
"8070",195809,"SAINT JOHNS UNIVERSITY-NEW YORK",1,0,1998,2504,1417,1087,886,318,568,0.401,0.354,0.293,13630,200.679921,540,1157,0.462060702875399
"8071",195809,"SAINT JOHNS UNIVERSITY-NEW YORK",1,0,1999,2650,1500,1150,954,357,597,0.398,0.36,0.31,13990,203.843594,538,1087,0.410188679245283
"8072",195809,"ST JOHN'S UNIVERSITY-NEW YORK",1,0,2000,2853,1619,1234,997,387,610,0.377,0.349,0.314,15500,224.582488,539,1187,0.416053277252015
"8073",195809,"ST JOHN'S UNIVERSITY-NEW YORK",1,0,2001,2670,1523,1147,957,357,600,0.394,0.358,0.311,16900,249.237345,540,1103,0.41310861423221
"8074",195809,"ST JOHN'S UNIVERSITY-NEW YORK",1,0,2002,2954,1736,1218,1001,347,654,0.377,0.339,0.285,17850,273.409197,550,1167,0.395057549085985
"8075",195809,"ST JOHN'S UNIVERSITY-NEW YORK",1,0,2003,2966,1749,1217,1058,381,677,0.387,0.357,0.313,19600,285.298169,563,1265,0.426500337154417
"8076",195809,"ST JOHN'S UNIVERSITY-NEW YORK",1,0,2004,2996,1696,1300,1035,384,651,0.384,0.345,0.295,21150,301.519775,579,1112,0.371161548731642
"8077",195809,"St. John's University-New York",1,0,2005,3153,1742,1411,1098,435,663,0.381,0.348,0.308,22800,326.112793,597,1133,0.359340310815097
"8078",195809,"St. John's University-New York",1,0,2006,3260,1713,1547,1198,494,704,0.411,0.367,0.319,24400,345.781924,620,1158,0.35521472392638
"8079",195809,"St. John's University-New York",1,0,2007,3151,1689,1462,1121,455,666,0.394,0.356,0.311,26200,365.76538,655,1120,0.355442716597905
"8080",195809,"St. John's University-New York",1,0,2008,3258,1737,1521,1294,521,773,0.445,0.397,0.343,28100,398.710255,671,1116,0.342541436464088
"8081",195809,"St. John's University-New York",1,0,2009,3101,1651,1450,1245,534,711,0.431,0.401,0.368,29350,427.513331,668,1119,0.360851338277975
"8082",195809,"St John's University-New York",1,0,2010,3105,1626,1479,1117,500,617,0.38,0.36,0.338,31250,464.699698,628,1028,0.331078904991948
"8083",196413,"SYRACUSE UNIVERSITY MAIN CAMPUS",1,0,1991,2513,1294,1219,1388,596,792,0.612,0.552,0.489,12957,382.306,928,1697,0.675288499801035
"8084",196413,"SYRACUSE UNIVERSITY MAIN CAMPUS",1,0,1992,2581,1329,1252,1465,628,837,0.63,0.568,0.502,13811,377.017,896,1879,0.728012398295234
"8085",196413,"SYRACUSE UNIVERSITY-MAIN CAMPUS",1,0,1993,2418,1270,1148,1386,590,796,0.627,0.573,0.514,14707,391.254,891,1707,0.705955334987593
"8086",196413,"SYRACUSE UNIVERSITY",1,0,1995,2392,1259,1133,1467,631,836,0.664,0.613,0.557,16280,412.096,817,1699,0.710284280936455
"8087",196413,"SYRACUSE UNIVERSITY",1,0,1996,2652,1429,1223,1722,735,987,0.691,0.649,0.601,17092,430.548066,807,1959,0.73868778280543
"8088",196413,"SYRACUSE UNIVERSITY",1,0,1997,2562,1417,1145,1773,713,1060,0.748,0.692,0.623,17950,357.006312,807,1864,0.727556596409055
"8089",196413,"SYRACUSE UNIVERSITY",1,0,1998,2566,1383,1183,1689,702,987,0.714,0.658,0.593,18850,372.694419,805,1799,0.701091192517537
"8090",196413,"SYRACUSE UNIVERSITY",1,0,1999,2724,1534,1190,1841,748,1093,0.713,0.676,0.629,19360,399.748878,822,1991,0.730910425844347
"8091",196413,"SYRACUSE UNIVERSITY",1,0,2000,2791,1569,1222,1981,805,1176,0.75,0.71,0.659,20380,413.927395,827,2126,0.761734145467574
"8092",196413,"SYRACUSE UNIVERSITY",1,0,2001,2601,1493,1108,1837,716,1121,0.751,0.706,0.646,21500,454.474352,832,1850,0.711264898116109
"8093",196413,"SYRACUSE UNIVERSITY",1,0,2002,2894,1676,1218,2021,793,1228,0.733,0.698,0.651,22800,471.817948,859,1987,0.686592950932965
"8094",196413,"SYRACUSE UNIVERSITY",1,0,2003,2628,1501,1127,1914,755,1159,0.772,0.728,0.67,24170,517.539464,864,1926,0.732876712328767
"8095",196413,"SYRACUSE UNIVERSITY",1,0,2004,2662,1505,1157,1907,766,1141,0.758,0.716,0.662,25720,534.830611,879,1920,0.721262208865515
"8096",196413,"Syracuse University",1,0,2005,3243,1849,1394,2261,903,1358,0.735,0.697,0.648,27210,569.202965,891,2000,0.616712920135677
"8097",196413,"Syracuse University",1,0,2006,3045,1686,1359,2099,839,1260,0.747,0.689,0.617,28820,610.026774,906,1919,0.630213464696223
"8098",196413,"Syracuse University",1,0,2007,3092,1756,1336,2119,846,1273,0.725,0.685,0.633,30470,634.982371,913,1863,0.602522639068564
"8099",196413,"Syracuse University",1,0,2008,3161,1853,1308,2173,846,1327,0.716,0.687,0.647,32180,683.620756,947,1634,0.516925023726669
"8100",196413,"Syracuse University",1,0,2009,3240,1868,1372,2215,854,1361,0.729,0.684,0.622,33630,716.381803,955,1843,0.568827160493827
"8101",196413,"Syracuse University",1,0,2010,3452,1929,1523,2379,962,1417,0.735,0.689,0.632,34970,743.213766,982,2085,0.603997682502897
"8102",196592,"TOURO COLLEGE",1,0,1991,503,330,173,37,15,22,0.067,0.074,0.087,6650,58.764,202,0,0
"8103",196592,"TOURO COLLEGE",1,0,1992,1037,676,361,63,14,49,0.072,0.061,0.039,7030,98.781,232,801,0.772420443587271
"8104",196592,"TOURO COLLEGE",1,0,1993,1236,815,421,70,6,64,0.078,0.057,0.014,7130,103.794,253,982,0.794498381877023
"8105",196592,"TOURO COLLEGE",1,0,1995,1899,1266,633,136,70,66,0.052,0.072,0.111,8700,107.376,223,1445,0.760926803580832
"8106",196592,"TOURO COLLEGE",1,0,1996,2337,1646,691,73,40,33,0.02,0.031,0.058,8700,103.468775,219,1633,0.698759092854086
"8107",196592,"TOURO COLLEGE",1,0,1997,2028,1457,571,85,27,58,0.04,0.042,0.047,8750,59.240234,262,1348,0.664694280078895
"8108",196592,"TOURO COLLEGE",1,0,1998,1651,1155,496,221,65,156,0.135,0.134,0.131,8850,66.750936,264,1005,0.608721986674743
"8109",196592,"TOURO COLLEGE",1,0,1999,1756,1210,546,152,50,102,0.084,0.087,0.092,9250,75.080045,273,1230,0.700455580865604
"8110",196592,"TOURO COLLEGE",1,0,2000,1272,919,353,121,46,75,0.082,0.095,0.13,9750,79.260904,268.5,790,0.621069182389937
"8111",196592,"TOURO COLLEGE",1,0,2001,1520,1064,456,146,42,104,0.098,0.096,0.092,9950,83.572132,264,968,0.636842105263158
"8112",196592,"TOURO COLLEGE",1,0,2002,1877,1306,571,159,40,119,0.091,0.085,0.07,9900,96.970423,282,922,0.491209376664891
"8113",196592,"TOURO COLLEGE",1,0,2003,1967,1343,624,247,74,173,0.129,0.126,0.119,9900,107.888011,275,936,0.475851550584647
"8114",196592,"TOURO COLLEGE",1,0,2004,1863,1278,585,246,86,160,0.125,0.132,0.147,10200,126.665,392,977,0.524422973698336
"8115",196592,"Touro College",1,0,2005,1839,1261,578,40,13,27,0.021,0.022,0.022,10900,150.077,375,956,0.519847743338771
"8116",196592,"Touro College",1,0,2006,1479,988,491,60,25,35,0.035,0.041,0.051,11800,169.556,497,474,0.320486815415822
"8117",196592,"Touro College",1,0,2007,848,545,303,80,22,58,0.106,0.094,0.073,12300,192.127,474,352,0.415094339622642
"8118",196592,"Touro College",1,0,2008,790,486,304,69,27,42,0.086,0.087,0.089,12800,235.184,527,375,0.474683544303797
"8119",196592,"Touro College",1,0,2009,867,555,312,58,7,51,0.092,0.067,0.022,13300,259.059,593,356,0.410611303344867
"8120",196592,"Touro College",1,0,2010,1030,668,362,152,21,131,0.196,0.148,0.058,13700,198.488,506,592,0.574757281553398
"8121",197045,"UTICA COLLEGE OF SYRACUSE UNIVERSITY",1,0,1991,328,169,159,96,42,54,0.32,0.293,0.264,10536,23.271,111,258,0.786585365853659
"8122",197045,"UTICA COLLEGE OF SYRACUSE UNIVERSITY",1,0,1992,323,183,140,90,37,53,0.29,0.279,0.264,11230,27.096,111,250,0.773993808049536
"8123",197045,"UTICA COLLEGE OF SYRACUSE UNIVERSITY",1,0,1993,256,140,116,84,35,49,0.35,0.328,0.302,11980,28.334,105,214,0.8359375
"8124",197045,"UTICA COLLEGE OF SYRACUSE UNIVERSITY",1,0,1995,255,162,93,100,27,73,0.451,0.392,0.29,13406,29.187,99,184,0.72156862745098
"8125",197045,"UTICA COLLEGE OF SYRACUSE UNIVERSITY",1,0,1996,338,223,115,126,34,92,0.413,0.373,0.296,14206,28.142921,96,222,0.656804733727811
"8126",197045,"UTICA COLLEGE OF SYRACUSE UNIVERSITY",1,0,1997,320,216,104,130,44,86,0.398,0.406,0.423,14912,20.99355,98,232,0.725
"8127",197045,"UTICA COLLEGE OF SYRACUSE UNIVERSITY",1,0,1998,306,203,103,107,31,76,0.374,0.35,0.301,15654,22.143433,96,189,0.617647058823529
"8128",197045,"UTICA COLLEGE OF SYRACUSE UNIVERSITY",1,0,1999,365,221,144,158,49,109,0.493,0.433,0.34,16150,23.050994,100,240,0.657534246575342
"8129",197045,"UTICA COLLEGE OF SYRACUSE UNIVERSITY",1,0,2000,445,260,185,139,41,98,0.377,0.312,0.222,16844,26.041984,102,287,0.644943820224719
"8130",197045,"UTICA COLLEGE OF SYRACUSE UNIVERSITY",1,0,2001,475,218,257,154,76,78,0.358,0.324,0.296,17790,28.10146,104,333,0.701052631578947
"8131",197045,"UTICA COLLEGE",1,0,2002,451,226,225,180,73,107,0.474,0.399,0.324,18848,31.477461,102,327,0.725055432372506
"8132",197045,"UTICA COLLEGE",1,0,2003,447,254,193,169,70,99,0.39,0.378,0.363,19980,34.869303,107,256,0.572706935123042
"8133",197045,"UTICA COLLEGE",1,0,2004,484,248,236,143,68,75,0.302,0.295,0.288,20980,38.944107,108,310,0.640495867768595
"8134",197045,"Utica College",1,0,2005,468,264,204,139,52,87,0.33,0.297,0.255,22030,43.199889,119,276,0.58974358974359
"8135",197045,"Utica College",1,0,2006,495,277,218,164,62,102,0.368,0.331,0.284,23130,48.075161,123,270,0.545454545454545
"8136",197045,"Utica College",1,0,2007,492,265,227,146,60,86,0.324,0.297,0.264,24264,49.423452,120,316,0.642276422764228
"8137",197045,"Utica College",1,0,2008,568,254,314,171,82,89,0.35,0.301,0.261,25538,54.249221,126,354,0.623239436619718
"8138",197045,"Utica College",1,0,2009,559,271,288,161,76,85,0.314,0.288,0.264,27764,55.722917,131,351,0.627906976744186
"8139",197045,"Utica College",1,0,2010,564,281,283,190,83,107,0.381,0.337,0.293,28100,58.80589,136,376,0.666666666666667
"8140",197133,"VASSAR COLLEGE",1,0,1991,592,364,228,460,167,293,0.805,0.777,0.732,16510,74.446,209,454,0.766891891891892
"8141",197133,"VASSAR COLLEGE",1,0,1992,597,370,227,478,175,303,0.819,0.801,0.771,17620,81.355,218,458,0.767169179229481
"8142",197133,"VASSAR COLLEGE",1,0,1993,649,414,235,497,169,328,0.792,0.766,0.719,18456,86.325,218,490,0.755007704160247
"8143",197133,"VASSAR COLLEGE",1,0,1995,632,381,251,509,193,316,0.829,0.805,0.769,20420,89.348,215,511,0.808544303797468
"8144",197133,"VASSAR COLLEGE",1,0,1996,614,375,239,499,191,308,0.821,0.813,0.799,21330,98.630304,215,466,0.758957654723127
"8145",197133,"VASSAR COLLEGE",1,0,1997,646,409,237,529,186,343,0.839,0.819,0.785,22090,95.657431,215,482,0.746130030959752
"8146",197133,"VASSAR COLLEGE",1,0,1998,626,379,247,504,191,313,0.826,0.805,0.773,23000,99.379919,215,470,0.750798722044728
"8147",197133,"VASSAR COLLEGE",1,0,1999,633,381,252,543,209,334,0.877,0.858,0.829,23700,105.48156,247,478,0.755134281200632
"8148",197133,"VASSAR COLLEGE",1,0,2000,639,389,250,544,211,333,0.856,0.851,0.844,24610,110.30251,246.5,484,0.757433489827856
"8149",197133,"VASSAR COLLEGE",1,0,2001,695,447,248,612,211,401,0.897,0.881,0.851,25890,99.790888,246,508,0.730935251798561
"8150",197133,"VASSAR COLLEGE",1,0,2002,632,377,255,552,217,335,0.889,0.873,0.851,27550,108.91771,258,473,0.748417721518987
"8151",197133,"VASSAR COLLEGE",1,0,2003,631,367,264,554,226,328,0.894,0.878,0.856,29095,114.973414,253,478,0.757527733755943
"8152",197133,"VASSAR COLLEGE",1,0,2004,654,419,235,586,198,388,0.926,0.896,0.843,30895,123.709649,267,466,0.712538226299694
"8153",197133,"Vassar College",1,0,2005,647,374,273,572,238,334,0.893,0.884,0.872,33310,133.826456,277,482,0.744976816074189
"8154",197133,"Vassar College",1,0,2006,668,412,256,534,173,361,0.876,0.799,0.676,35520,138.459928,281,488,0.730538922155689
"8155",197133,"Vassar College",1,0,2007,677,409,268,607,233,374,0.914,0.897,0.869,37570,149.081067,293,467,0.689807976366322
"8156",197133,"Vassar College",1,0,2008,638,365,273,560,235,325,0.89,0.878,0.861,39635,155.662273,299,444,0.695924764890282
"8157",197133,"Vassar College",1,0,2009,658,392,266,568,217,351,0.895,0.863,0.816,41335,163.957231,296,430,0.653495440729483
"8158",197133,"Vassar College",1,0,2010,665,382,283,576,242,334,0.874,0.866,0.855,42560,164.403958,279,419,0.630075187969925
"8159",197869,"APPALACHIAN STATE UNIVERSITY",1,0,1991,1916,1025,891,562,185,377,0.368,0.293,0.208,1166,115.226141,533,1780,0.92901878914405
"8160",197869,"APPALACHIAN STATE UNIVERSITY",1,0,1992,2060,1146,914,621,215,406,0.354,0.301,0.235,1264,122.585066,539,1944,0.94368932038835
"8161",197869,"APPALACHIAN STATE UNIVERSITY",1,0,1993,1931,1098,833,603,192,411,0.374,0.312,0.23,1459,127.711344,545,1809,0.936820300362507
"8162",197869,"APPALACHIAN STATE UNIVERSITY",1,0,1995,2205,1198,1007,749,273,476,0.397,0.34,0.271,1627,142.694988,572,2082,0.94421768707483
"8163",197869,"APPALACHIAN STATE UNIVERSITY",1,0,1996,2026,1111,915,689,226,463,0.417,0.34,0.247,1663,153.713287,583,1920,0.947680157946693
"8164",197869,"APPALACHIAN STATE UNIVERSITY",1,0,1997,2161,1177,984,711,235,476,0.404,0.329,0.239,1703,154.836945,574,2029,0.938917167977788
"8165",197869,"APPALACHIAN STATE UNIVERSITY",1,0,1998,2312,1192,1120,687,239,448,0.376,0.297,0.213,1753,172.892778,581,2184,0.944636678200692
"8166",197869,"APPALACHIAN STATE UNIVERSITY",1,0,1999,2199,1186,1013,778,266,512,0.432,0.354,0.263,962,184.212974,592,2059,0.936334697589814
"8167",197869,"APPALACHIAN STATE UNIVERSITY",1,0,2000,2544,1370,1174,872,285,587,0.429,0.343,0.243,982,191.685996,612.5,2380,0.935534591194969
"8168",197869,"APPALACHIAN STATE UNIVERSITY",1,0,2001,2303,1196,1107,857,309,548,0.458,0.372,0.279,1222,212.26451,633,2181,0.947025618758142
"8169",197869,"APPALACHIAN STATE UNIVERSITY",1,0,2002,2412,1261,1151,964,385,579,0.459,0.4,0.334,1520,198.652044,619,2165,0.89759535655058
"8170",197869,"APPALACHIAN STATE UNIVERSITY",1,0,2003,2462,1216,1246,920,360,560,0.46,0.374,0.289,1596,209.909328,663,2219,0.901299756295695
"8171",197869,"APPALACHIAN STATE UNIVERSITY",1,0,2004,2507,1247,1260,941,357,584,0.468,0.375,0.283,1821,217.531011,674,2229,0.889110490626246
"8172",197869,"Appalachian State University",1,0,2005,2536,1265,1271,974,391,583,0.461,0.384,0.308,1821,229.622134,703,2308,0.910094637223975
"8173",197869,"Appalachian State University",1,0,2006,2707,1403,1304,1080,402,678,0.483,0.399,0.308,2221,254.82784,710,2369,0.875138529737717
"8174",197869,"Appalachian State University",1,0,2007,2730,1401,1329,1133,431,702,0.501,0.415,0.324,2221,278.025184,737,2347,0.85970695970696
"8175",197869,"Appalachian State University",1,0,2008,2768,1415,1353,1221,462,759,0.536,0.441,0.341,2263,308.872354,779,2403,0.868135838150289
"8176",197869,"Appalachian State University",1,0,2009,2732,1471,1261,1267,464,803,0.546,0.464,0.368,2341,317.606233,824,2437,0.892020497803807
"8177",197869,"Appalachian State University",1,0,2010,2816,1538,1278,1387,500,887,0.577,0.493,0.391,2961,337.57788,862,2434,0.864346590909091
"8178",197984,"BELMONT ABBEY COLLEGE",1,0,1991,174,92,82,56,21,35,0.38,0.322,0.256,7470,11.460826,51,141,0.810344827586207
"8179",197984,"BELMONT ABBEY COLLEGE",1,0,1992,145,67,78,42,22,20,0.299,0.29,0.282,7974,11.171813,49,122,0.841379310344828
"8180",197984,"BELMONT ABBEY COLLEGE",1,0,1993,136,69,67,44,20,24,0.348,0.324,0.299,8684,12.003017,46,120,0.882352941176471
"8181",197984,"BELMONT ABBEY COLLEGE",1,0,1995,114,45,69,47,26,21,0.467,0.412,0.377,9818,11.550027,41,98,0.859649122807018
"8182",197984,"BELMONT ABBEY COLLEGE",1,0,1996,181,93,88,62,30,32,0.344,0.343,0.341,10408,11.703736,36,156,0.861878453038674
"8183",197984,"BELMONT ABBEY COLLEGE",1,0,1997,159,68,91,61,27,34,0.5,0.384,0.297,11034,9.461328,36,133,0.836477987421384
"8184",197984,"BELMONT ABBEY COLLEGE",1,0,1998,198,94,104,87,41,46,0.489,0.439,0.394,11640,13.564159,38,179,0.904040404040404
"8185",197984,"BELMONT ABBEY COLLEGE",1,0,1999,195,90,105,57,27,30,0.333,0.292,0.257,11650,14.633627,40,163,0.835897435897436
"8186",197984,"BELMONT ABBEY COLLEGE",1,0,2000,188,113,75,63,22,41,0.363,0.335,0.293,12116,15.549141,41.5,162,0.861702127659574
"8187",197984,"BELMONT ABBEY COLLEGE",1,0,2001,143,68,75,61,22,39,0.574,0.427,0.293,12722,16.727383,43,113,0.79020979020979
"8188",197984,"BELMONT ABBEY COLLEGE",1,0,2002,223,136,87,64,20,44,0.324,0.287,0.23,13358,17.403576,43,137,0.614349775784753
"8189",197984,"BELMONT ABBEY COLLEGE",1,0,2003,147,70,77,48,25,23,0.329,0.327,0.325,14160,18.04651,43,110,0.748299319727891
"8190",197984,"BELMONT ABBEY COLLEGE",1,0,2004,174,96,78,47,20,27,0.281,0.27,0.256,15010,17.145778,40,123,0.706896551724138
"8191",197984,"Belmont Abbey College",1,0,2005,224,109,115,75,23,52,0.477,0.335,0.2,15910,18.502063,48,154,0.6875
"8192",197984,"Belmont Abbey College",1,0,2006,279,142,137,94,34,60,0.422,0.337,0.248,16870,18.231243,53,198,0.709677419354839
"8193",197984,"Belmont Abbey College",1,0,2007,210,90,120,69,28,41,0.456,0.329,0.233,17880,19.988701,54,144,0.685714285714286
"8194",197984,"Belmont Abbey College",1,0,2008,286,134,152,93,39,54,0.403,0.325,0.257,19114,21.007087,59,184,0.643356643356643
"8195",197984,"Belmont Abbey College",1,0,2009,396,224,172,138,50,88,0.393,0.348,0.291,20356,23.67045,69,211,0.532828282828283
"8196",197984,"Belmont Abbey College",1,0,2010,307,139,168,103,53,50,0.36,0.336,0.315,23183,24.039767,72,21,0.0684039087947883
"8197",198385,"DAVIDSON COLLEGE",1,0,1991,397,179,218,339,178,161,0.899,0.854,0.817,14058,40.727735,126,352,0.886649874055416
"8198",198385,"DAVIDSON COLLEGE",1,0,1992,414,221,193,367,170,197,0.891,0.886,0.881,14950,44.513862,126,375,0.905797101449275
"8199",198385,"DAVIDSON COLLEGE",1,0,1993,452,195,257,381,212,169,0.867,0.843,0.825,16263,48.240561,130,383,0.847345132743363
"8200",198385,"DAVIDSON COLLEGE",1,0,1995,429,209,220,373,186,187,0.895,0.869,0.845,18626,54.756557,137,373,0.869463869463869
"8201",198385,"DAVIDSON COLLEGE",1,0,1996,439,230,209,385,181,204,0.887,0.877,0.866,19631,56.970449,137,399,0.908883826879271
"8202",198385,"DAVIDSON COLLEGE",1,0,1997,470,230,240,417,206,211,0.917,0.887,0.858,20595,49.321087,147,407,0.865957446808511
"8203",198385,"DAVIDSON COLLEGE",1,0,1998,472,253,219,423,198,225,0.889,0.896,0.904,21395,51.223707,145,405,0.858050847457627
"8204",198385,"DAVIDSON COLLEGE",1,0,1999,456,226,230,380,187,193,0.854,0.833,0.813,22014,57.42596,152,394,0.864035087719298
"8205",198385,"DAVIDSON COLLEGE",1,0,2000,465,229,236,413,193,220,0.961,0.888,0.818,22872,62.358784,153,407,0.875268817204301
"8206",198385,"DAVIDSON COLLEGE",1,0,2001,465,246,219,420,193,227,0.923,0.903,0.881,23739,67.897975,154,369,0.793548387096774
"8207",198385,"DAVIDSON COLLEGE",1,0,2002,468,243,225,430,201,229,0.942,0.919,0.893,24930,72.023737,159,382,0.816239316239316
"8208",198385,"DAVIDSON COLLEGE",1,0,2003,489,237,252,435,218,217,0.916,0.89,0.865,24987,75.904845,159,385,0.787321063394683
"8209",198385,"DAVIDSON COLLEGE",1,0,2004,462,238,224,410,192,218,0.916,0.887,0.857,26211,76.822029,158,345,0.746753246753247
"8210",198385,"Davidson College",1,0,2005,459,234,225,400,182,218,0.932,0.871,0.809,27653,82.384817,158,358,0.779956427015251
"8211",198385,"Davidson College",1,0,2006,461,233,228,410,197,213,0.914,0.889,0.864,29119,82.996372,162,340,0.737527114967462
"8212",198385,"Davidson College",1,0,2007,464,234,230,417,198,219,0.936,0.899,0.861,30662,89.711974,167,346,0.745689655172414
"8213",198385,"Davidson College",1,0,2008,480,250,230,436,209,227,0.908,0.908,0.909,33148,91.721726,168,345,0.71875
"8214",198385,"Davidson College",1,0,2009,487,252,235,438,207,231,0.917,0.899,0.881,34776,93.774858,164,365,0.749486652977413
"8215",198385,"Davidson College",1,0,2010,499,246,253,452,223,229,0.931,0.906,0.881,36320,90.91657,166,344,0.68937875751503
"8216",198464,"EAST CAROLINA UNIVERSITY",1,0,1991,2338,1288,1050,386,124,262,0.203,0.165,0.118,1204,225.204867,741,2025,0.866124893071001
"8217",198464,"EAST CAROLINA UNIVERSITY",1,0,1992,2880,1673,1207,561,166,395,0.236,0.195,0.138,1246,245.591802,791,2552,0.886111111111111
"8218",198464,"EAST CAROLINA UNIVERSITY",1,0,1993,2428,1417,1011,558,151,407,0.287,0.23,0.149,1366,272.241795,792,2106,0.867380560131796
"8219",198464,"EAST CAROLINA UNIVERSITY",1,0,1995,2635,1550,1085,630,189,441,0.284,0.239,0.174,1673,289.129262,804,2263,0.858823529411765
"8220",198464,"EAST CAROLINA UNIVERSITY",1,0,1996,2626,1581,1045,673,216,457,0.289,0.256,0.207,1752,292.550208,804,2208,0.840822543792841
"8221",198464,"EAST CAROLINA UNIVERSITY",1,0,1997,2871,1718,1153,705,222,483,0.281,0.246,0.193,1832,315.663244,808,2411,0.839777081156391
"8222",198464,"EAST CAROLINA UNIVERSITY",1,0,1998,2803,1714,1089,720,196,524,0.306,0.257,0.18,1886,344.24723,808,2288,0.816268283981448
"8223",198464,"EAST CAROLINA UNIVERSITY",1,0,1999,3255,1931,1324,822,266,556,0.288,0.253,0.201,992,366.997754,827,2600,0.798771121351767
"8224",198464,"EAST CAROLINA UNIVERSITY",1,0,2000,3105,1837,1268,856,248,608,0.331,0.276,0.196,1195,386.714191,791,2533,0.815780998389694
"8225",198464,"EAST CAROLINA UNIVERSITY",1,0,2001,3182,1877,1305,813,242,571,0.304,0.255,0.185,1453,421.525847,755,2576,0.809553739786298
"8226",198464,"EAST CAROLINA UNIVERSITY",1,0,2002,3561,2117,1444,968,294,674,0.318,0.272,0.204,1819,411.394191,791,2973,0.834877843302443
"8227",198464,"EAST CAROLINA UNIVERSITY",1,0,2003,3458,2117,1341,1035,293,742,0.35,0.299,0.218,1910,426.72762,886,2811,0.812897628687102
"8228",198464,"EAST CAROLINA UNIVERSITY",1,0,2004,3451,2143,1308,1009,294,715,0.334,0.292,0.225,2135,476.668385,932,2746,0.795711388003477
"8229",198464,"East Carolina University",1,0,2005,3220,1973,1247,1048,345,703,0.356,0.325,0.277,2135,526.722495,961,2505,0.777950310559006
"8230",198464,"East Carolina University",1,0,2006,3784,2331,1453,1240,347,893,0.383,0.328,0.239,2335,575.311906,1033,2820,0.745243128964059
"8231",198464,"East Carolina University",1,0,2007,4195,2535,1660,1294,391,903,0.356,0.308,0.236,2431,631.349386,1058,3123,0.74445768772348
"8232",198464,"East Carolina University",1,0,2008,4515,2608,1907,1468,483,985,0.378,0.325,0.253,2445,658.46538,1280,3483,0.771428571428571
"8233",198464,"East Carolina University",1,0,2009,3942,2273,1669,1397,445,952,0.419,0.354,0.267,2491,704.06687,1234,3021,0.766362252663623
"8234",198464,"East Carolina University",1,0,2010,4196,2446,1750,1417,448,969,0.396,0.338,0.256,2881,728.230354,1246,2984,0.71115347950429
"8235",198507,"ELIZABETH CITY STATE UNIVERSITY",1,0,1991,402,217,185,135,48,87,0.401,0.336,0.259,1150,24.497328,103,49,0.121890547263682
"8236",198507,"ELIZABETH CITY STATE UNIVERSITY",1,0,1992,541,317,224,181,47,134,0.423,0.335,0.21,1184,28.220777,105,72,0.133086876155268
"8237",198507,"ELIZABETH CITY STATE UNIVERSITY",1,0,1993,460,273,187,164,47,117,0.429,0.357,0.251,1242,31.129007,105,93,0.202173913043478
"8238",198507,"ELIZABETH CITY STATE UNIVERSITY",1,0,1995,381,222,159,162,47,115,0.518,0.425,0.296,1410,34.584354,109,49,0.128608923884514
"8239",198507,"ELIZABETH CITY STATE UNIVERSITY",1,0,1996,380,205,175,130,44,86,0.42,0.342,0.251,1468,37.076434,108,66,0.173684210526316
"8240",198507,"ELIZABETH CITY STATE UNIVERSITY",1,0,1997,424,251,173,133,33,100,0.398,0.314,0.191,1522,38.836281,86,70,0.165094339622642
"8241",198507,"ELIZABETH CITY STATE UNIVERSITY",1,0,1998,378,229,149,109,22,87,0.38,0.288,0.148,1572,39.976108,98,51,0.134920634920635
"8242",198507,"ELIZABETH CITY STATE UNIVERSITY",1,0,1999,402,247,155,109,22,87,0.352,0.271,0.142,806,39.626719,109,71,0.176616915422886
"8243",198507,"ELIZABETH CITY STATE UNIVERSITY",1,0,2000,441,248,193,133,32,101,0.407,0.302,0.166,822,41.201019,105.5,51,0.115646258503401
"8244",198507,"ELIZABETH CITY STATE UNIVERSITY",1,0,2001,363,200,163,102,32,70,0.35,0.281,0.196,896,42.6369,102,49,0.134986225895317
"8245",198507,"ELIZABETH CITY STATE UNIVERSITY",1,0,2002,458,270,188,108,16,92,0.341,0.236,0.085,1118,40.697191,122,60,0.131004366812227
"8246",198507,"ELIZABETH CITY STATE UNIVERSITY",1,0,2003,459,258,201,104,36,68,0.264,0.227,0.179,1174,45.929229,133,73,0.159041394335512
"8247",198507,"ELIZABETH CITY STATE UNIVERSITY",1,0,2004,554,295,259,107,30,77,0.261,0.193,0.116,1399,46.288376,131,78,0.140794223826715
"8248",198507,"Elizabeth City State University",1,0,2005,556,328,228,99,28,71,0.216,0.178,0.123,1399,50.75924,128,66,0.118705035971223
"8249",198507,"Elizabeth City State University",1,0,2006,534,313,221,90,20,70,0.224,0.169,0.09,1490,59.044607,149,49,0.0917602996254682
"8250",198507,"Elizabeth City State University",1,0,2007,642,391,251,138,39,99,0.253,0.215,0.155,1587,64.960364,175,49,0.0763239875389408
"8251",198507,"Elizabeth City State University",1,0,2008,636,368,268,95,25,70,0.19,0.149,0.093,1611,73.353102,161,41,0.0644654088050314
"8252",198507,"Elizabeth City State University",1,0,2009,659,375,284,106,35,71,0.189,0.161,0.123,1681,76.600139,165,70,0.106221547799697
"8253",198507,"Elizabeth City State University",1,0,2010,573,319,254,94,31,63,0.198,0.164,0.122,2204,76.956426,170,45,0.0785340314136126
"8254",198516,"ELON COLLEGE",1,0,1991,780,461,319,381,121,260,0.564,0.488,0.379,7520,31.344142,134,729,0.934615384615385
"8255",198516,"ELON COLLEGE",1,0,1992,817,470,347,455,175,280,0.596,0.557,0.504,8110,29.83544,136,742,0.908200734394125
"8256",198516,"ELON COLLEGE",1,0,1993,857,492,365,478,197,281,0.571,0.558,0.54,8630,35.080115,138,787,0.918319719953326
"8257",198516,"ELON COLLEGE",1,0,1995,907,545,362,548,198,350,0.642,0.604,0.547,9910,42.494165,148,827,0.911797133406836
"8258",198516,"ELON COLLEGE",1,0,1996,941,569,372,551,204,347,0.61,0.586,0.548,10667,45.08607,151,851,0.904357066950053
"8259",198516,"ELON COLLEGE",1,0,1997,964,584,380,599,207,392,0.671,0.621,0.545,11542,39.357973,158,860,0.892116182572614
"8260",198516,"ELON COLLEGE",1,0,1998,1013,632,381,660,234,426,0.674,0.652,0.614,12147,45.518109,175,894,0.882527147087858
"8261",198516,"ELON COLLEGE",1,0,1999,999,637,362,701,232,469,0.736,0.702,0.641,12671,49.804075,192,885,0.885885885885886
"8262",198516,"ELON COLLEGE",1,0,2000,1144,718,426,744,244,500,0.696,0.65,0.573,13556,55.93619,201,1034,0.903846153846154
"8263",198516,"ELON UNIVERSITY",1,0,2001,1212,757,455,797,263,534,0.705,0.658,0.578,14335,63.794254,210,1058,0.872937293729373
"8264",198516,"ELON UNIVERSITY",1,0,2002,1192,736,456,856,308,548,0.745,0.718,0.675,15280,70.851898,235,1054,0.884228187919463
"8265",198516,"ELON UNIVERSITY",1,0,2003,1227,775,452,875,294,581,0.75,0.713,0.65,16325,78.478277,252,1083,0.882640586797066
"8266",198516,"ELON UNIVERSITY",1,0,2004,1230,775,455,918,319,599,0.773,0.746,0.701,17310,83.913654,261,1038,0.84390243902439
"8267",198516,"Elon University",1,0,2005,1237,748,489,959,370,589,0.787,0.775,0.757,18699,90.303254,279,1060,0.856911883589329
"8268",198516,"Elon University",1,0,2006,1283,740,543,991,378,613,0.828,0.772,0.696,20171,100.339646,291,1064,0.829306313328137
"8269",198516,"Elon University",1,0,2007,1286,746,540,987,380,607,0.814,0.767,0.704,21886,115.642833,311,1055,0.820373250388802
"8270",198516,"Elon University",1,0,2008,1290,777,513,977,358,619,0.797,0.757,0.698,23746,129.576324,333,983,0.762015503875969
"8271",198516,"Elon University",1,0,2009,1290,774,516,1025,374,651,0.841,0.795,0.725,25159,141.121837,343,1065,0.825581395348837
"8272",198516,"Elon University",1,0,2010,1359,794,565,1041,386,655,0.825,0.766,0.683,26480,141.950536,358,1052,0.774098601913171
"8273",198835,"LENOIR-RHYNE COLLEGE",1,0,1991,279,153,126,113,33,80,0.523,0.405,0.262,8520,22.773798,95,251,0.899641577060932
"8274",198835,"LENOIR-RHYNE COLLEGE",1,0,1992,255,162,93,104,30,74,0.457,0.408,0.323,9500,21.269513,95,227,0.890196078431372
"8275",198835,"LENOIR-RHYNE COLLEGE",1,0,1993,254,135,119,115,39,76,0.563,0.453,0.328,10220,19.651894,91,229,0.901574803149606
"8276",198835,"LENOIR-RHYNE COLLEGE",1,0,1995,287,157,130,132,47,85,0.541,0.46,0.362,10960,19.683676,91,258,0.898954703832753
"8277",198835,"LENOIR-RHYNE COLLEGE",1,0,1996,232,135,97,96,32,64,0.474,0.414,0.33,11416,21.256545,98,205,0.883620689655172
"8278",198835,"LENOIR-RHYNE COLLEGE",1,0,1997,306,167,139,119,41,78,0.467,0.389,0.295,12036,16.901113,102,270,0.882352941176471
"8279",198835,"LENOIR-RHYNE COLLEGE",1,0,1998,267,138,129,112,38,74,0.536,0.419,0.295,12386,18.198562,104,219,0.820224719101124
"8280",198835,"LENOIR-RHYNE COLLEGE",1,0,1999,288,168,120,117,37,80,0.476,0.406,0.308,12310,19.197636,101,228,0.791666666666667
"8281",198835,"LENOIR-RHYNE COLLEGE",1,0,2000,268,142,126,122,42,80,0.563,0.455,0.333,12870,16.837039,98,229,0.854477611940298
"8282",198835,"LENOIR-RHYNE COLLEGE",1,0,2001,268,159,109,107,27,80,0.503,0.399,0.248,13600,21.337059,95,234,0.873134328358209
"8283",198835,"LENOIR-RHYNE COLLEGE",1,0,2002,319,161,158,145,69,76,0.472,0.455,0.437,14350,22.039818,95,271,0.849529780564263
"8284",198835,"LENOIR-RHYNE COLLEGE",1,0,2003,308,178,130,124,45,79,0.444,0.403,0.346,15750,23.323801,86,264,0.857142857142857
"8285",198835,"LENOIR-RHYNE COLLEGE",1,0,2004,322,196,126,123,35,88,0.449,0.382,0.278,17120,22.656152,90,262,0.813664596273292
"8286",198835,"Lenoir-Rhyne College",1,0,2005,326,203,123,122,37,85,0.419,0.374,0.301,18130,24.265021,88,264,0.809815950920245
"8287",198835,"Lenoir-Rhyne College",1,0,2006,347,195,152,117,40,77,0.395,0.337,0.263,19350,25.526336,90,275,0.792507204610951
"8288",198835,"Lenoir-Rhyne College",1,0,2007,367,214,153,146,48,98,0.458,0.398,0.314,20690,27.05097,93,288,0.784741144414169
"8289",198835,"Lenoir-Rhyne University",1,0,2008,345,217,128,140,32,108,0.498,0.406,0.25,23070,28.135779,93,259,0.750724637681159
"8290",198835,"Lenoir-Rhyne University",1,0,2009,355,215,140,119,36,83,0.386,0.335,0.257,24200,30.200387,88,170,0.47887323943662
"8291",198835,"Lenoir-Rhyne University",1,0,2010,423,229,194,149,53,96,0.419,0.352,0.273,25290,29.516899,89,325,0.768321513002364
"8292",198969,"METHODIST COLLEGE",1,0,1991,254,86,168,59,35,24,0.279,0.232,0.208,7700,11.273277,53,217,0.854330708661417
"8293",198969,"METHODIST COLLEGE",1,0,1992,290,98,192,54,36,18,0.184,0.186,0.188,8250,14.574503,58,217,0.748275862068966
"8294",198969,"METHODIST COLLEGE",1,0,1993,310,81,229,49,28,21,0.259,0.158,0.122,8850,16.701561,62,227,0.732258064516129
"8295",198969,"METHODIST COLLEGE",1,0,1995,370,121,249,67,37,30,0.248,0.181,0.149,9950,20.591729,94,267,0.721621621621622
"8296",198969,"METHODIST COLLEGE",1,0,1996,320,100,220,55,30,25,0.25,0.172,0.136,10600,22.705511,93,241,0.753125
"8297",198969,"METHODIST COLLEGE",1,0,1997,350,107,243,69,41,28,0.262,0.197,0.169,11250,17.388701,87,270,0.771428571428571
"8298",198969,"METHODIST COLLEGE",1,0,1998,437,117,320,88,55,33,0.282,0.201,0.172,11900,18.99573,82,312,0.71395881006865
"8299",198969,"METHODIST COLLEGE",1,0,1999,378,123,255,53,23,30,0.244,0.14,0.09,12600,20.110164,101,285,0.753968253968254
"8300",198969,"METHODIST COLLEGE",1,0,2000,308,115,193,46,18,28,0.244,0.149,0.093,13300,22.129217,98,226,0.733766233766234
"8301",198969,"METHODIST COLLEGE",1,0,2001,379,117,262,59,28,31,0.265,0.156,0.107,14070,23.884343,95,265,0.699208443271768
"8302",198969,"METHODIST COLLEGE",1,0,2002,395,118,277,58,20,38,0.322,0.147,0.072,14840,26.131627,100,274,0.693670886075949
"8303",198969,"METHODIST COLLEGE",1,0,2003,384,120,264,58,26,32,0.267,0.151,0.098,15650,27.398706,101,275,0.716145833333333
"8304",198969,"METHODIST COLLEGE",1,0,2004,435,143,292,71,25,46,0.322,0.163,0.086,16500,27.181021,108,290,0.666666666666667
"8305",198969,"Methodist College",1,0,2005,387,143,244,59,22,37,0.259,0.152,0.09,17580,29.418621,119,266,0.68733850129199
"8306",198969,"Methodist University",1,0,2006,449,135,314,75,31,44,0.326,0.167,0.099,18780,31.290309,117,306,0.681514476614699
"8307",198969,"Methodist University",1,0,2007,433,138,295,76,31,45,0.326,0.176,0.105,20050,34.33552,127,262,0.605080831408776
"8308",198969,"Methodist University",1,0,2008,439,148,291,64,26,38,0.257,0.146,0.089,21470,34.717404,127,239,0.544419134396355
"8309",198969,"Methodist University",1,0,2009,472,144,328,80,35,45,0.312,0.169,0.107,22620,36.052448,128,161,0.341101694915254
"8310",198969,"Methodist University",1,0,2010,531,190,341,104,46,58,0.305,0.196,0.135,23780,37.492816,139,282,0.531073446327684
"8311",199102,"NORTH CAROLINA AGRICULTURAL AND TECHNICAL ST UNIV",1,0,1991,1469,803,666,275,63,212,0.264,0.187,0.095,1228,78.839421,318,35,0.0238257317903336
"8312",199102,"NORTH CAROLINA AGRICULTURAL AND TECHNICAL ST UNIV",1,0,1992,1484,780,704,290,86,204,0.262,0.195,0.122,1270,83.49568,352,40,0.0269541778975741
"8313",199102,"NORTH CAROLINA AGRICULTURAL AND TECHNICAL ST UNIV",1,0,1993,1429,775,654,300,85,215,0.277,0.21,0.13,1367,90.884592,361,40,0.0279916025192442
"8314",199102,"NORTH CAROLINA AGRICULTURAL AND TECHNICAL ST UNIV",1,0,1995,1396,706,690,339,117,222,0.314,0.243,0.17,1532,111.172058,398,40,0.0286532951289398
"8315",199102,"NORTH CAROLINA AGRICULTURAL AND TECHNICAL ST UNIV",1,0,1996,1313,692,621,300,90,210,0.304,0.228,0.145,1561,114.866282,414,30,0.0228484386900229
"8316",199102,"NORTH CAROLINA AGRICULTURAL AND TECHNICAL ST UNIV",1,0,1997,1383,727,656,363,118,245,0.337,0.262,0.18,1622,120.999876,401,43,0.0310918293564714
"8317",199102,"NORTH CAROLINA AGRICULTURAL AND TECHNICAL ST UNIV",1,0,1998,1366,695,671,323,104,219,0.315,0.236,0.155,1680,121.886119,412,34,0.0248901903367496
"8318",199102,"NORTH CAROLINA AGRICULTURAL AND TECHNICAL ST UNIV",1,0,1999,1530,850,680,348,112,236,0.278,0.227,0.165,962,129.952156,369,37,0.0241830065359477
"8319",199102,"NORTH CAROLINA AGRICULTURAL AND TECHNICAL ST UNIV",1,0,2000,1661,884,777,321,97,224,0.253,0.193,0.125,982,139.947635,368.5,46,0.0276941601444913
"8320",199102,"NORTH CAROLINA AGRICULTURAL AND TECHNICAL ST UNIV",1,0,2001,1760,874,886,354,117,237,0.271,0.201,0.132,1222,150.164438,368,56,0.0318181818181818
"8321",199102,"NORTH CAROLINA AGRICULTURAL AND TECHNICAL ST UNIV",1,0,2002,2025,1043,982,299,90,209,0.2,0.148,0.092,1470,145.150522,367,60,0.0296296296296296
"8322",199102,"NORTH CAROLINA A & T STATE UNIVERSITY",1,0,2003,2221,1176,1045,389,104,285,0.242,0.175,0.1,1544,160.390063,307,69,0.0310670868977938
"8323",199102,"NORTH CAROLINA  A &T STATE UNIVERSITY",1,0,2004,2212,1147,1065,335,86,249,0.217,0.151,0.081,1769,173.229624,339,39,0.017631103074141
"8324",199102,"North Carolina A & T State University",1,0,2005,2237,1178,1059,369,116,253,0.215,0.165,0.11,1769,196.699042,364,34,0.0151989271345552
"8325",199102,"North Carolina A & T State University",1,0,2006,2068,1102,966,340,81,259,0.235,0.164,0.084,1994,205.94527,425,53,0.0256286266924565
"8326",199102,"North Carolina A & T State University",1,0,2007,1569,819,750,251,64,187,0.228,0.16,0.085,1994,219.771837,442,34,0.0216698534098152
"8327",199102,"North Carolina A & T State University",1,0,2008,1592,848,744,342,105,237,0.28,0.215,0.141,1994,227.411422,472,44,0.0276381909547739
"8328",199102,"North Carolina A & T State University",1,0,2009,1875,1028,847,383,116,267,0.26,0.204,0.137,1994,236.594179,522,45,0.024
"8329",199102,"North Carolina A & T State University",1,0,2010,2040,1065,975,374,108,266,0.25,0.183,0.111,2621,257.302365,519,38,0.0186274509803922
"8330",199111,"UNIVERSITY OF NORTH CAROLINA AT ASHEVILLE",1,0,1991,336,199,137,77,18,59,0.296,0.229,0.131,1116,26.481493,139,316,0.94047619047619
"8331",199111,"UNIVERSITY OF NORTH CAROLINA AT ASHEVILLE",1,0,1992,364,195,169,101,33,68,0.349,0.277,0.195,1150,28.04759,144,339,0.931318681318681
"8332",199111,"UNIVERSITY OF NORTH CAROLINA AT ASHEVILLE",1,0,1993,394,222,172,129,42,87,0.392,0.327,0.244,1436,29.407068,147,368,0.934010152284264
"8333",199111,"UNIVERSITY OF NORTH CAROLINA AT ASHEVILLE",1,0,1995,393,235,158,123,35,88,0.375,0.313,0.222,1658,33.558433,153,346,0.880407124681934
"8334",199111,"UNIVERSITY OF NORTH CAROLINA AT ASHEVILLE",1,0,1996,450,275,175,139,42,97,0.353,0.309,0.24,1723,35.712571,158,408,0.906666666666667
"8335",199111,"UNIVERSITY OF NORTH CAROLINA AT ASHEVILLE",1,0,1997,470,264,206,138,49,89,0.337,0.294,0.238,1784,37.528625,156,427,0.908510638297872
"8336",199111,"UNIVERSITY OF NORTH CAROLINA AT ASHEVILLE",1,0,1998,474,278,196,120,35,85,0.306,0.253,0.179,1832,40.164358,161,434,0.915611814345992
"8337",199111,"UNIVERSITY OF NORTH CAROLINA AT ASHEVILLE",1,0,1999,456,267,189,128,48,80,0.3,0.281,0.254,806,44.418181,157,414,0.907894736842105
"8338",199111,"UNIVERSITY OF NORTH CAROLINA AT ASHEVILLE",1,0,2000,496,284,212,154,54,100,0.352,0.31,0.255,822,46.427863,165,451,0.909274193548387
"8339",199111,"UNIVERSITY OF NORTH CAROLINA AT ASHEVILLE",1,0,2001,446,281,165,149,43,106,0.377,0.334,0.261,1196,49.917632,173,396,0.887892376681614
"8340",199111,"UNIVERSITY OF NORTH CAROLINA AT ASHEVILLE",1,0,2002,421,250,171,140,41,99,0.396,0.333,0.24,1592,50.597343,180,383,0.909738717339667
"8341",199111,"UNIVERSITY OF NORTH CAROLINA AT ASHEVILLE",1,0,2003,590,332,258,170,45,125,0.376,0.288,0.174,1672,52.16513,177,535,0.906779661016949
"8342",199111,"UNIVERSITY OF NORTH CAROLINA AT ASHEVILLE",1,0,2004,694,418,276,208,59,149,0.356,0.3,0.214,1897,56.97968,184,626,0.902017291066282
"8343",199111,"University of North Carolina at Asheville",1,0,2005,471,291,180,154,51,103,0.354,0.327,0.283,1897,65.739029,200,418,0.887473460721868
"8344",199111,"University of North Carolina at Asheville",1,0,2006,567,328,239,180,57,123,0.375,0.317,0.238,2172,69.635046,206,503,0.887125220458554
"8345",199111,"University of North Carolina at Asheville",1,0,2007,571,341,230,211,67,144,0.422,0.37,0.291,2307,73.316585,207,487,0.852889667250438
"8346",199111,"University of North Carolina at Asheville",1,0,2008,586,361,225,225,77,148,0.41,0.384,0.342,2339,76.1667,207,498,0.849829351535836
"8347",199111,"University of North Carolina at Asheville",1,0,2009,637,363,274,230,75,155,0.427,0.361,0.274,2389,77.421385,208,556,0.872841444270016
"8348",199111,"University of North Carolina at Asheville",1,0,2010,590,335,255,231,87,144,0.43,0.392,0.341,2626,77.320999,217,497,0.842372881355932
"8349",199120,"UNIVERSITY OF NORTH CAROLINA AT CHAPEL HILL",1,0,1991,3133,1941,1192,1966,672,1294,0.667,0.628,0.564,1248,686.365846,1261,2589,0.826364506862432
"8350",199120,"UNIVERSITY OF NORTH CAROLINA AT CHAPEL HILL",1,0,1992,3200,1957,1243,2009,733,1276,0.652,0.628,0.59,1249,729.021834,1277,2626,0.820625
"8351",199120,"UNIVERSITY OF NORTH CAROLINA AT CHAPEL HILL",1,0,1993,3310,2048,1262,2089,744,1345,0.657,0.631,0.59,1419,792.652542,1268,2702,0.81631419939577
"8352",199120,"UNIVERSITY OF NORTH CAROLINA AT CHAPEL HILL",1,0,1995,3229,1982,1247,2101,732,1369,0.691,0.651,0.587,1640,918.411488,1261,2610,0.808299783214617
"8353",199120,"UNIVERSITY OF NORTH CAROLINA AT CHAPEL HILL",1,0,1996,3270,2065,1205,2185,718,1467,0.71,0.668,0.596,2110,974.985662,1225,2629,0.803975535168196
"8354",199120,"UNIVERSITY OF NORTH CAROLINA AT CHAPEL HILL",1,0,1997,3412,2118,1294,2371,816,1555,0.734,0.695,0.631,2173,1050.409,1222,2728,0.799531066822978
"8355",199120,"UNIVERSITY OF NORTH CAROLINA AT CHAPEL HILL",1,0,1998,3425,2116,1309,2289,794,1495,0.707,0.668,0.607,2211,1116.68,1240,2778,0.811094890510949
"8356",199120,"UNIVERSITY OF NORTH CAROLINA AT CHAPEL HILL",1,0,1999,3388,2099,1289,2389,797,1592,0.758,0.705,0.618,1528,1185.644,1285,2706,0.798701298701299
"8357",199120,"UNIVERSITY OF NORTH CAROLINA AT CHAPEL HILL",1,0,2000,3406,2121,1285,2426,829,1597,0.753,0.712,0.645,1860,1259.979,1244,2680,0.786846741045214
"8358",199120,"UNIVERSITY OF NORTH CAROLINA AT CHAPEL HILL",1,0,2001,3681,2195,1486,2611,986,1625,0.74,0.709,0.664,2328,1368.498,1203,2827,0.767997826677533
"8359",199120,"UNIVERSITY OF NORTH CAROLINA AT CHAPEL HILL",1,0,2002,3455,2053,1402,2513,935,1578,0.769,0.727,0.667,2814,1499.705592,1356,2581,0.747033285094067
"8360",199120,"UNIVERSITY OF NORTH CAROLINA AT CHAPEL HILL",1,0,2003,3511,2068,1443,2535,945,1590,0.769,0.722,0.655,2955,1561.296449,1296,2558,0.728567359726574
"8361",199120,"UNIVERSITY OF NORTH CAROLINA AT CHAPEL HILL",1,0,2004,3584,2099,1485,2685,1027,1658,0.79,0.749,0.692,3205,1629.856862,1318,2610,0.728236607142857
"8362",199120,"University of North Carolina at Chapel Hill",1,0,2005,3747,2270,1477,2819,1050,1769,0.779,0.752,0.711,3205,1703.723624,1382,2740,0.731251668001068
"8363",199120,"University of North Carolina at Chapel Hill",1,0,2006,3796,2276,1520,2893,1107,1786,0.785,0.762,0.728,3455,1842.583328,1490,2649,0.697839831401475
"8364",199120,"University of North Carolina at Chapel Hill",1,0,2007,3877,2338,1539,3124,1151,1973,0.844,0.806,0.748,3705,1995.887493,1514,2684,0.692287851431519
"8365",199120,"University of North Carolina at Chapel Hill",1,0,2008,3852,2270,1582,3096,1188,1908,0.841,0.804,0.751,3705,2149.017644,1600,2641,0.685617860851506
"8366",199120,"University of North Carolina at Chapel Hill",1,0,2009,3955,2354,1601,3216,1225,1991,0.846,0.813,0.765,3865,2286.087886,1628,2655,0.671302149178255
"8367",199120,"University of North Carolina at Chapel Hill",1,0,2010,3944,2371,1573,3299,1235,2064,0.87,0.836,0.785,4815,2360.248766,1671,2763,0.700557809330629
"8368",199139,"UNIVERSITY OF NORTH CAROLINA AT CHARLOTTE",1,0,1991,1552,876,676,347,86,261,0.298,0.224,0.127,1147,107.863199,611,1216,0.783505154639175
"8369",199139,"UNIVERSITY OF NORTH CAROLINA AT CHARLOTTE",1,0,1992,1575,813,762,291,111,180,0.221,0.185,0.146,1189,118.29785,639,1202,0.763174603174603
"8370",199139,"UNIVERSITY OF NORTH CAROLINA AT CHARLOTTE",1,0,1993,1685,845,840,312,111,201,0.238,0.185,0.132,1383,125.129376,643,1245,0.738872403560831
"8371",199139,"UNIVERSITY OF NORTH CAROLINA AT CHARLOTTE",1,0,1995,1663,974,689,396,115,281,0.289,0.238,0.167,1618,142.53602,625,1231,0.740228502705953
"8372",199139,"UNIVERSITY OF NORTH CAROLINA AT CHARLOTTE",1,0,1996,1682,952,730,359,113,246,0.258,0.213,0.155,1716,167.739656,637,1243,0.739001189060642
"8373",199139,"UNIVERSITY OF NORTH CAROLINA AT CHARLOTTE",1,0,1997,1904,1077,827,418,155,263,0.244,0.22,0.187,1777,169.817197,643,1417,0.74422268907563
"8374",199139,"UNIVERSITY OF NORTH CAROLINA AT CHARLOTTE",1,0,1998,2122,1178,944,456,169,287,0.244,0.215,0.179,1834,186.043587,644,1508,0.710650329877474
"8375",199139,"UNIVERSITY OF NORTH CAROLINA AT CHARLOTTE",1,0,1999,2078,1111,967,489,181,308,0.277,0.235,0.187,962,195.828945,664,1575,0.757940327237729
"8376",199139,"UNIVERSITY OF NORTH CAROLINA AT CHARLOTTE",1,0,2000,2142,1208,934,553,194,359,0.297,0.258,0.208,1132,206.923641,654,1648,0.76937441643324
"8377",199139,"UNIVERSITY OF NORTH CAROLINA AT CHARLOTTE",1,0,2001,2309,1273,1036,610,209,401,0.315,0.264,0.202,1417,224.101462,644,1795,0.77739281074058
"8378",199139,"UNIVERSITY OF NORTH CAROLINA AT CHARLOTTE",1,0,2002,2383,1234,1149,577,204,373,0.302,0.242,0.178,1813,200.206907,721,1890,0.793117918590013
"8379",199139,"UNIVERSITY OF NORTH CAROLINA AT CHARLOTTE",1,0,2003,2472,1291,1181,630,244,386,0.299,0.255,0.207,1904,217.919178,769,1975,0.798948220064725
"8380",199139,"UNIVERSITY OF NORTH CAROLINA AT CHARLOTTE",1,0,2004,2599,1416,1183,707,249,458,0.323,0.272,0.21,2129,229.119828,787,2092,0.804924971142747
"8381",199139,"University of North Carolina at Charlotte",1,0,2005,2859,1498,1361,741,273,468,0.312,0.259,0.201,2129,258.544125,837,2288,0.800279818118223
"8382",199139,"University of North Carolina at Charlotte",1,0,2006,2764,1475,1289,728,280,448,0.304,0.263,0.217,2344,298.111461,878,2161,0.781837916063676
"8383",199139,"University of North Carolina at Charlotte",1,0,2007,2926,1520,1406,749,304,445,0.293,0.256,0.216,2461,342.003149,922,2238,0.764866712235133
"8384",199139,"University of North Carolina at Charlotte",1,0,2008,3059,1610,1449,766,289,477,0.296,0.25,0.199,2516,363.877005,971,2238,0.731611637790128
"8385",199139,"University of North Carolina at Charlotte",1,0,2009,3152,1571,1581,820,319,501,0.319,0.26,0.202,2516,391.494696,953,2078,0.659263959390863
"8386",199139,"University of North Carolina at Charlotte",1,0,2010,2947,1513,1434,840,312,528,0.349,0.285,0.218,3044,409.143441,949,1927,0.653885307091958
"8387",199148,"UNIVERSITY OF NORTH CAROLINA AT GREENSBORO",1,0,1991,1345,890,455,358,82,276,0.31,0.266,0.18,1492,101.871101,568,1090,0.810408921933085
"8388",199148,"UNIVERSITY OF NORTH CAROLINA AT GREENSBORO",1,0,1992,1509,1000,509,363,80,283,0.283,0.241,0.157,1540,113.40492,580,1182,0.783300198807157
"8389",199148,"UNIVERSITY OF NORTH CAROLINA AT GREENSBORO",1,0,1993,1500,959,541,297,61,236,0.246,0.198,0.113,1717,119.797086,572,1187,0.791333333333333
"8390",199148,"UNIVERSITY OF NORTH CAROLINA AT GREENSBORO",1,0,1995,1804,1234,570,376,77,299,0.242,0.208,0.135,1868,139.143822,548,1333,0.738913525498891
"8391",199148,"UNIVERSITY OF NORTH CAROLINA AT GREENSBORO",1,0,1996,1552,1075,477,390,77,313,0.291,0.251,0.161,1943,148.242922,562,1182,0.76159793814433
"8392",199148,"UNIVERSITY OF NORTH CAROLINA AT GREENSBORO",1,0,1997,1577,1091,486,431,90,341,0.313,0.273,0.185,2019,151.222261,565,1150,0.729232720355105
"8393",199148,"UNIVERSITY OF NORTH CAROLINA AT GREENSBORO",1,0,1998,1791,1257,534,472,94,378,0.301,0.264,0.176,2039,170.790514,587,1283,0.716359575656058
"8394",199148,"UNIVERSITY OF NORTH CAROLINA AT GREENSBORO",1,0,1999,1908,1346,562,540,107,433,0.322,0.283,0.19,1086,195.549607,601,1373,0.719601677148847
"8395",199148,"UNIVERSITY OF NORTH CAROLINA AT GREENSBORO",1,0,2000,1867,1355,512,556,112,444,0.328,0.298,0.219,1108,203.577098,624,1363,0.730048205677558
"8396",199148,"UNIVERSITY OF NORTH CAROLINA AT GREENSBORO",1,0,2001,1898,1350,548,511,102,409,0.303,0.269,0.186,1358,218.468517,647,1336,0.703898840885142
"8397",199148,"UNIVERSITY OF NORTH CAROLINA AT GREENSBORO",1,0,2002,2071,1420,651,570,118,452,0.318,0.275,0.181,1717,203.985076,629,1487,0.718010622887494
"8398",199148,"UNIVERSITY OF NORTH CAROLINA AT GREENSBORO",1,0,2003,2039,1422,617,577,123,454,0.319,0.283,0.199,1803,218.765786,686,1436,0.70426679744973
"8399",199148,"UNIVERSITY OF NORTH CAROLINA AT GREENSBORO",1,0,2004,2159,1525,634,625,124,501,0.328,0.289,0.196,2028,238.766913,695,1517,0.702640111162575
"8400",199148,"University of North Carolina at Greensboro",1,0,2005,2399,1690,709,670,125,545,0.322,0.279,0.176,2028,249.736811,727,1664,0.693622342642768
"8401",199148,"University of North Carolina at Greensboro",1,0,2006,2400,1698,702,706,128,578,0.34,0.294,0.182,2308,273.884654,736,1546,0.644166666666667
"8402",199148,"University of North Carolina at Greensboro",1,0,2007,2431,1689,742,721,166,555,0.329,0.297,0.224,2458,301.083371,784,1532,0.630193336075689
"8403",199148,"University of North Carolina at Greensboro",1,0,2008,2471,1703,768,759,183,576,0.338,0.307,0.238,2507,321.637738,796,1581,0.639821934439498
"8404",199148,"University of North Carolina at Greensboro",1,0,2009,2495,1733,762,804,180,624,0.36,0.322,0.236,2590,336.132177,788,1553,0.622444889779559
"8405",199148,"University of North Carolina at Greensboro",1,0,2010,2505,1722,783,762,162,600,0.348,0.304,0.207,3243,360.22787,839,1485,0.592814371257485
"8406",199157,"NORTH CAROLINA CENTRAL UNIVERSITY",1,0,1991,531,336,195,93,21,72,0.214,0.175,0.108,1169,50.76848,234,7,0.0131826741996234
"8407",199157,"NORTH CAROLINA CENTRAL UNIVERSITY",1,0,1992,759,452,307,134,30,104,0.23,0.177,0.098,1211,51.887945,241,12,0.0158102766798419
"8408",199157,"NORTH CAROLINA CENTRAL UNIVERSITY",1,0,1993,810,525,285,201,40,161,0.307,0.248,0.14,1338,53.324808,263,5,0.00617283950617284
"8409",199157,"NORTH CAROLINA CENTRAL UNIVERSITY",1,0,1995,510,309,201,139,34,105,0.34,0.273,0.169,1512,64.814473,269,21,0.0411764705882353
"8410",199157,"NORTH CAROLINA CENTRAL UNIVERSITY",1,0,1996,681,441,240,179,38,141,0.32,0.263,0.158,1595,67.890327,281,11,0.0161527165932452
"8411",199157,"NORTH CAROLINA CENTRAL UNIVERSITY",1,0,1997,712,467,245,202,45,157,0.336,0.284,0.184,1736,72.018916,261,17,0.023876404494382
"8412",199157,"NORTH CAROLINA CENTRAL UNIVERSITY",1,0,1998,673,409,264,184,41,143,0.35,0.273,0.155,1793,75.549944,264,17,0.025260029717682
"8413",199157,"NORTH CAROLINA CENTRAL UNIVERSITY",1,0,1999,625,345,280,143,31,112,0.325,0.229,0.111,962,82.15088,265,9,0.0144
"8414",199157,"NORTH CAROLINA CENTRAL UNIVERSITY",1,0,2000,720,443,277,162,26,136,0.307,0.225,0.094,982,84.967619,251,12,0.0166666666666667
"8415",199157,"NORTH CAROLINA CENTRAL UNIVERSITY",1,0,2001,763,492,271,174,29,145,0.295,0.228,0.107,1272,88.654041,237,9,0.0117955439056356
"8416",199157,"NORTH CAROLINA CENTRAL UNIVERSITY",1,0,2002,821,542,279,191,42,149,0.275,0.233,0.151,1574,96.967571,234,15,0.0182704019488429
"8417",199157,"NORTH CAROLINA CENTRAL UNIVERSITY",1,0,2003,1025,679,346,190,32,158,0.233,0.185,0.092,1653,102.360182,250,13,0.0126829268292683
"8418",199157,"NORTH CAROLINA CENTRAL UNIVERSITY",1,0,2004,1138,732,406,205,51,154,0.21,0.18,0.126,1878,122.185588,240,18,0.015817223198594
"8419",199157,"North Carolina Central University",1,0,2005,1195,800,395,181,45,136,0.17,0.151,0.114,1878,131.837965,281,20,0.0167364016736402
"8420",199157,"North Carolina Central University",1,0,2006,975,631,344,145,30,115,0.182,0.149,0.087,2078,146.845127,319,18,0.0184615384615385
"8421",199157,"North Carolina Central University",1,0,2007,1236,764,472,185,47,138,0.181,0.15,0.1,2218,160.07293,348,26,0.0210355987055016
"8422",199157,"North Carolina Central University",1,0,2008,1026,683,343,224,56,168,0.246,0.218,0.163,2218,170.78743,366,23,0.0224171539961014
"8423",199157,"North Carolina Central University",1,0,2009,1345,858,487,215,49,166,0.194,0.16,0.101,2264,181.323965,369,27,0.0200743494423792
"8424",199157,"North Carolina Central University",1,0,2010,1218,809,409,238,56,182,0.225,0.195,0.137,2812,184.346845,412,22,0.0180623973727422
"8425",199193,"NORTH CAROLINA STATE UNIVERSITY AT RALEIGH",1,0,1991,3296,1290,2006,773,370,403,0.312,0.235,0.184,1238,460.027562,1233,2724,0.826456310679612
"8426",199193,"NORTH CAROLINA STATE UNIVERSITY AT RALEIGH",1,0,1992,3176,1219,1957,759,338,421,0.345,0.239,0.173,1286,478.02451,1240,2589,0.815176322418136
"8427",199193,"NORTH CAROLINA STATE UNIVERSITY AT RALEIGH",1,0,1993,3277,1248,2029,841,397,444,0.356,0.257,0.196,1389,510.774934,1235,2724,0.831248092767775
"8428",199193,"NORTH CAROLINA STATE UNIVERSITY AT RALEIGH",1,0,1995,3607,1523,2084,900,395,505,0.332,0.25,0.19,1732,578.099302,1210,2898,0.803437759911284
"8429",199193,"NORTH CAROLINA STATE UNIVERSITY AT RALEIGH",1,0,1996,3630,1457,2173,968,442,526,0.361,0.267,0.203,2200,594.95607,1198,2996,0.82534435261708
"8430",199193,"NORTH CAROLINA STATE UNIVERSITY AT RALEIGH",1,0,1997,3756,1496,2260,961,427,534,0.357,0.256,0.189,2270,638.099864,1215,3049,0.811767838125666
"8431",199193,"NORTH CAROLINA STATE UNIVERSITY AT RALEIGH",1,0,1998,3751,1513,2238,1075,492,583,0.385,0.287,0.22,2634,676.615974,1171,3044,0.811516928818982
"8432",199193,"NORTH CAROLINA STATE UNIVERSITY AT RALEIGH",1,0,1999,3636,1499,2137,1253,559,694,0.463,0.345,0.262,1528,733.688339,1202,3029,0.833058305830583
"8433",199193,"NORTH CAROLINA STATE UNIVERSITY AT RALEIGH",1,0,2000,3816,1622,2194,1379,634,745,0.459,0.361,0.289,1860,766.576509,1234,3082,0.807651991614256
"8434",199193,"NORTH CAROLINA STATE UNIVERSITY AT RALEIGH",1,0,2001,3862,1630,2232,1404,619,785,0.482,0.364,0.277,2328,816.003937,1266,3128,0.809943034697048
"8435",199193,"NORTH CAROLINA STATE UNIVERSITY AT RALEIGH",1,0,2002,3713,1561,2152,1391,580,811,0.52,0.375,0.27,2814,781.426292,1285,3032,0.816590358200916
"8436",199193,"NORTH CAROLINA STATE UNIVERSITY AT RALEIGH",1,0,2003,3915,1665,2250,1595,734,861,0.517,0.407,0.326,2955,811.816688,1647,3235,0.826309067688378
"8437",199193,"NORTH CAROLINA STATE UNIVERSITY AT RALEIGH",1,0,2004,3935,1702,2233,1585,682,903,0.531,0.403,0.305,3205,845.755865,1638,3154,0.801524777636595
"8438",199193,"North Carolina State University at Raleigh",1,0,2005,4364,1918,2446,1732,716,1016,0.53,0.397,0.293,3205,894.641835,1671,3513,0.804995417048579
"8439",199193,"North Carolina State University at Raleigh",1,0,2006,4667,2067,2600,1781,761,1020,0.494,0.382,0.293,3530,965.075655,1652,3719,0.796871652024855
"8440",199193,"North Carolina State University at Raleigh",1,0,2007,4895,2179,2716,1975,836,1139,0.523,0.403,0.308,3760,1026.727112,1723,3908,0.798365679264556
"8441",199193,"North Carolina State University at Raleigh",1,0,2008,4792,2184,2608,2029,863,1166,0.534,0.423,0.331,3860,1113.056893,1768,3770,0.786727879799666
"8442",199193,"North Carolina State University at Raleigh",1,0,2009,4716,2067,2649,2031,920,1111,0.537,0.431,0.347,3953,1138.694539,1773,3589,0.761026293469042
"8443",199193,"North Carolina State University at Raleigh",1,0,2010,4685,2098,2587,2187,962,1225,0.584,0.467,0.372,4853,1138.229261,1755,3592,0.766702241195304
"8444",199218,"UNIVERSITY OF NORTH CAROLINA AT WILMINGTON",1,0,1991,1545,923,622,385,111,274,0.297,0.249,0.178,1302,63.652438,340,1444,0.93462783171521
"8445",199218,"UNIVERSITY OF NORTH CAROLINA AT WILMINGTON",1,0,1992,1225,771,454,320,95,225,0.292,0.261,0.209,1344,70.627464,356,1104,0.901224489795918
"8446",199218,"UNIVERSITY OF NORTH CAROLINA AT WILMINGTON",1,0,1993,1439,860,579,417,131,286,0.333,0.29,0.226,1492,76.864933,346,1296,0.900625434329395
"8447",199218,"UNIVERSITY OF NORTH CAROLINA AT WILMINGTON",1,0,1995,1370,863,507,463,133,330,0.382,0.338,0.262,1664,86.305397,363,1253,0.914598540145985
"8448",199218,"UNIVERSITY OF NORTH CAROLINA AT WILMINGTON",1,0,1996,1619,990,629,602,196,406,0.41,0.372,0.312,1734,90.08563,369,1472,0.909203211859172
"8449",199218,"UNIVERSITY OF NORTH CAROLINA-WILMINGTON",1,0,1997,1350,837,513,478,149,329,0.393,0.354,0.29,1782,94.89501,382,1216,0.900740740740741
"8450",199218,"UNIVERSITY OF NORTH CAROLINA-WILMINGTON",1,0,1998,1681,1030,651,628,180,448,0.435,0.374,0.276,1934,106.406075,388,1551,0.92266508030934
"8451",199218,"UNIVERSITY OF NORTH CAROLINA-WILMINGTON",1,0,1999,1649,1011,638,672,213,459,0.454,0.408,0.334,962,119.60446,413,1522,0.922983626440267
"8452",199218,"UNIVERSITY OF NORTH CAROLINA-WILMINGTON",1,0,2000,1661,1081,580,711,185,526,0.487,0.428,0.319,1102,130.773146,423,1524,0.917519566526189
"8453",199218,"UNIVERSITY OF NORTH CAROLINA-WILMINGTON",1,0,2001,1983,1246,737,824,205,619,0.497,0.416,0.278,1317,139.462003,433,1823,0.919314170448815
"8454",199218,"UNIVERSITY OF NORTH CAROLINA-WILMINGTON",1,0,2002,1629,1014,615,733,209,524,0.517,0.45,0.34,1622,139.826196,433,1489,0.914057704112953
"8455",199218,"UNIVERSITY OF NORTH CAROLINA-WILMINGTON",1,0,2003,1764,1133,631,783,227,556,0.491,0.444,0.36,1703,144.505671,467,1557,0.88265306122449
"8456",199218,"UNIVERSITY OF NORTH CAROLINA-WILMINGTON",1,0,2004,1891,1154,737,841,272,569,0.493,0.445,0.369,1928,155.306593,464,1668,0.882072977260709
"8457",199218,"University of North Carolina-Wilmington",1,0,2005,1933,1133,800,842,302,540,0.477,0.436,0.378,1928,167.180811,493,1693,0.875840662183135
"8458",199218,"University of North Carolina-Wilmington",1,0,2006,1980,1140,840,973,335,638,0.56,0.491,0.399,2221,183.416805,515,1652,0.834343434343434
"8459",199218,"University of North Carolina-Wilmington",1,0,2007,1913,1138,775,991,340,651,0.572,0.518,0.439,2413,214.366584,543,1607,0.840041819132253
"8460",199218,"University of North Carolina-Wilmington",1,0,2008,2069,1229,840,1017,326,691,0.562,0.492,0.388,2459,241.451001,580,1761,0.851135814403093
"8461",199218,"University of North Carolina-Wilmington",1,0,2009,1943,1178,765,975,314,661,0.561,0.502,0.41,2565,237.664684,617,1607,0.827071538857437
"8462",199218,"University of North Carolina at Wilmington",1,0,2010,1985,1236,749,1044,320,724,0.586,0.526,0.427,3029,254.030596,617,1655,0.83375314861461
"8463",199281,"PEMBROKE STATE UNIVERSITY",1,0,1991,379,195,184,58,21,37,0.19,0.153,0.114,914,23.802216,141,229,0.604221635883905
"8464",199281,"PEMBROKE STATE UNIVERSITY",1,0,1992,417,199,218,68,26,42,0.211,0.163,0.119,948,23.912464,145,251,0.601918465227818
"8465",199281,"PEMBROKE STATE UNIVERSITY",1,0,1993,422,216,206,71,19,52,0.241,0.168,0.092,1078,25.184577,143,245,0.580568720379147
"8466",199281,"UNIVERSITY OF NORTH CAROLINA-PEMBROKE",1,0,1995,410,199,211,81,34,47,0.236,0.198,0.161,1325,27.732418,144,230,0.560975609756098
"8467",199281,"UNIVERSITY OF NORTH CAROLINA-PEMBROKE",1,0,1996,450,211,239,80,30,50,0.237,0.178,0.126,1467,30.259011,145,228,0.506666666666667
"8468",199281,"UNIVERSITY OF NORTH CAROLINA-PEMBROKE",1,0,1997,480,258,222,98,34,64,0.248,0.204,0.153,1536,32.42613,143,272,0.566666666666667
"8469",199281,"UNIVERSITY OF NORTH CAROLINA AT PEMBROKE",1,0,1998,464,244,220,99,36,63,0.258,0.213,0.164,1600,34.499131,145,241,0.519396551724138
"8470",199281,"UNIVERSITY OF NORTH CAROLINA AT PEMBROKE",1,0,1999,475,241,234,89,33,56,0.232,0.187,0.141,962,38.301605,145,268,0.564210526315789
"8471",199281,"UNIVERSITY OF NORTH CAROLINA AT PEMBROKE",1,0,2000,567,303,264,114,34,80,0.264,0.201,0.129,982,40.04449,156,307,0.541446208112875
"8472",199281,"UNIVERSITY OF NORTH CAROLINA AT PEMBROKE",1,0,2001,688,363,325,100,31,69,0.19,0.145,0.095,1152,44.609544,167,378,0.549418604651163
"8473",199281,"UNIVERSITY OF NORTH CAROLINA AT PEMBROKE",1,0,2002,709,376,333,101,38,63,0.168,0.142,0.114,1394,47.712591,180,413,0.582510578279267
"8474",199281,"UNIVERSITY OF NORTH CAROLINA AT PEMBROKE",1,0,2003,792,415,377,130,45,85,0.205,0.164,0.119,1464,53.920608,202,459,0.579545454545455
"8475",199281,"UNIVERSITY OF NORTH CAROLINA AT PEMBROKE",1,0,2004,741,393,348,113,44,69,0.176,0.152,0.126,1689,63.395151,219,358,0.483130904183536
"8476",199281,"University of North Carolina at Pembroke",1,0,2005,961,528,433,142,50,92,0.174,0.148,0.115,1689,69.402329,243,437,0.454734651404787
"8477",199281,"University of North Carolina at Pembroke",1,0,2006,929,475,454,148,54,94,0.198,0.159,0.119,1869,77.214905,257,414,0.445640473627556
"8478",199281,"University of North Carolina at Pembroke",1,0,2007,1101,585,516,170,57,113,0.193,0.154,0.11,1949,88.941257,285,487,0.442325158946412
"8479",199281,"University of North Carolina at Pembroke",1,0,2008,1054,563,491,157,50,107,0.19,0.149,0.102,2007,110.511061,291,448,0.425047438330171
"8480",199281,"University of North Carolina at Pembroke",1,0,2009,1202,642,560,218,77,141,0.22,0.181,0.138,2060,108.863703,293,454,0.377703826955075
"8481",199281,"University of North Carolina at Pembroke",1,0,2010,1036,582,454,209,74,135,0.232,0.202,0.163,2423,114.850322,329,410,0.395752895752896
"8482",199306,"PFEIFFER COLLEGE",1,0,1991,166,82,84,45,17,28,0.341,0.271,0.202,7295,9.764805,47,149,0.897590361445783
"8483",199306,"PFEIFFER COLLEGE",1,0,1992,147,66,81,45,18,27,0.409,0.306,0.222,7730,10.148392,47,130,0.884353741496599
"8484",199306,"PFEIFFER COLLEGE",1,0,1993,156,70,86,40,14,26,0.371,0.256,0.163,8190,10.438322,49,126,0.807692307692308
"8485",199306,"PFEIFFER UNIVERSITY",1,0,1995,146,66,80,31,10,21,0.318,0.212,0.125,8990,11.065736,47,121,0.828767123287671
"8486",199306,"PFEIFFER UNIVERSITY",1,0,1996,120,54,66,26,12,14,0.259,0.217,0.182,9260,11.900116,51,99,0.825
"8487",199306,"PFEIFFER UNIVERSITY",1,0,1997,162,59,103,40,21,19,0.322,0.247,0.204,9816,11.491205,51,129,0.796296296296296
"8488",199306,"PFEIFFER UNIVERSITY",1,0,1998,148,67,81,45,17,28,0.418,0.304,0.21,10230,12.718556,58,122,0.824324324324324
"8489",199306,"PFEIFFER UNIVERSITY",1,0,1999,159,80,79,52,15,37,0.462,0.327,0.19,10844,12.797199,59,126,0.792452830188679
"8490",199306,"PFEIFFER UNIVERSITY",1,0,2000,185,90,95,58,17,41,0.456,0.314,0.179,11380,13.453906,58.5,154,0.832432432432432
"8491",199306,"PFEIFFER UNIVERSITY",1,0,2001,146,69,77,63,26,37,0.536,0.432,0.338,12066,14.310055,58,120,0.821917808219178
"8492",199306,"PFEIFFER UNIVERSITY",1,0,2002,166,97,69,71,29,42,0.433,0.428,0.42,12780,15.476383,63,138,0.831325301204819
"8493",199306,"PFEIFFER UNIVERSITY",1,0,2003,158,86,72,56,20,36,0.419,0.354,0.278,13550,17.659535,65,130,0.822784810126582
"8494",199306,"PFEIFFER UNIVERSITY",1,0,2004,191,88,103,54,17,37,0.42,0.283,0.165,14570,18.813564,65,153,0.801047120418848
"8495",199306,"Pfeiffer University",1,0,2005,198,90,108,74,28,46,0.511,0.374,0.259,15590,19.929176,65,147,0.742424242424242
"8496",199306,"Pfeiffer University",1,0,2006,196,85,111,72,38,34,0.4,0.367,0.342,16450,22.047782,67,145,0.739795918367347
"8497",199306,"Pfeiffer University",1,0,2007,189,90,99,63,28,35,0.389,0.333,0.283,17520,24.063619,77,154,0.814814814814815
"8498",199306,"Pfeiffer University",1,0,2008,192,91,101,48,15,33,0.363,0.25,0.149,18570,26.632146,74,133,0.692708333333333
"8499",199306,"Pfeiffer University",1,0,2009,225,100,125,71,34,37,0.37,0.316,0.272,19040,24.578762,73,172,0.764444444444444
"8500",199306,"Pfeiffer University",1,0,2010,199,88,111,67,31,36,0.409,0.337,0.279,20182,24.782605,81,127,0.638190954773869
"8501",199412,"QUEENS COLLEGE",1,0,1991,144,102,42,47,9,38,0.372,0.326,0.214,9300,13.917283,67,117,0.8125
"8502",199412,"QUEENS COLLEGE",1,0,1992,127,95,32,45,8,37,0.39,0.354,0.25,9850,18.821992,66,102,0.803149606299213
"8503",199412,"QUEENS COLLEGE",1,0,1993,169,134,35,60,13,47,0.351,0.355,0.371,10400,15.576455,63,139,0.822485207100592
"8504",199412,"QUEENS COLLEGE",1,0,1995,146,110,36,72,19,53,0.482,0.493,0.528,11520,19.080135,64,113,0.773972602739726
"8505",199412,"QUEENS COLLEGE",1,0,1996,155,116,39,80,14,66,0.569,0.516,0.359,12310,18.985364,64,117,0.754838709677419
"8506",199412,"QUEENS COLLEGE",1,0,1997,198,142,56,80,20,60,0.422,0.404,0.357,12980,15.57692,65,148,0.747474747474748
"8507",199412,"QUEENS COLLEGE",1,0,1998,147,111,36,67,15,52,0.469,0.456,0.417,9410,16.05939,69,114,0.775510204081633
"8508",199412,"QUEENS COLLEGE",1,0,1999,123,85,38,67,15,52,0.612,0.545,0.395,10020,18.275776,62,89,0.723577235772358
"8509",199412,"QUEENS COLLEGE",1,0,2000,188,136,52,93,23,70,0.515,0.495,0.442,10680,19.984631,61,150,0.797872340425532
"8510",199412,"QUEENS COLLEGE",1,0,2001,209,166,43,105,23,82,0.494,0.502,0.535,11360,21.514483,60,165,0.789473684210526
"8511",199412,"QUEENS UNIVERSITY OF CHARLOTTE",1,0,2002,193,150,43,111,24,87,0.58,0.575,0.558,12290,23.407894,63,168,0.870466321243523
"8512",199412,"QUEENS UNIVERSITY OF CHARLOTTE",1,0,2003,252,186,66,127,34,93,0.5,0.504,0.515,15650,25.870898,75,216,0.857142857142857
"8513",199412,"QUEENS UNIVERSITY OF CHARLOTTE",1,0,2004,223,154,69,98,28,70,0.454,0.439,0.406,17008,24.500933,85,183,0.820627802690583
"8514",199412,"Queens University of Charlotte",1,0,2005,238,171,67,116,30,86,0.503,0.487,0.448,18028,27.521609,90,189,0.794117647058823
"8515",199412,"Queens University of Charlotte",1,0,2006,235,173,62,104,22,82,0.474,0.443,0.355,19450,28.659767,92,148,0.629787234042553
"8516",199412,"Queens University of Charlotte",1,0,2007,290,198,92,126,32,94,0.475,0.434,0.348,20720,30.769153,102,202,0.696551724137931
"8517",199412,"Queens University of Charlotte",1,0,2008,307,214,93,164,49,115,0.537,0.534,0.527,22068,37.936556,103,190,0.618892508143323
"8518",199412,"Queens University of Charlotte",1,0,2009,311,232,79,144,31,113,0.487,0.463,0.392,22730,39.712385,109,177,0.569131832797428
"8519",199412,"Queens University of Charlotte",1,0,2010,349,252,97,162,38,124,0.492,0.464,0.392,23752,44.431377,119,205,0.587392550143267
"8520",199582,"SAINT AUGUSTINE'S COLLEGE",1,0,1991,418,237,181,44,10,34,0.144,0.105,0.055,4950,24.601848,109,1,0.00239234449760766
"8521",199582,"SAINT AUGUSTINE'S COLLEGE",1,0,1992,401,232,169,61,14,47,0.203,0.152,0.083,5300,24.158006,89,0,0
"8522",199582,"SAINT AUGUSTINES COLLEGE",1,0,1993,361,196,165,49,12,37,0.189,0.136,0.073,5700,25.173806,91,1,0.00277008310249307
"8523",199582,"SAINT AUGUSTINES COLLEGE",1,0,1995,385,203,182,61,17,44,0.217,0.158,0.093,5872,23.370969,94,0,0
"8524",199582,"SAINT AUGUSTINES COLLEGE",1,0,1996,408,228,180,46,21,25,0.11,0.113,0.117,6284,29.01601,94,0,0
"8525",199582,"SAINT AUGUSTINES COLLEGE",1,0,1997,400,228,172,60,14,46,0.202,0.15,0.081,6472,22.849424,91,1,0.0025
"8526",199582,"SAINT AUGUSTINES COLLEGE",1,0,1998,299,164,135,57,13,44,0.268,0.191,0.096,6796,22.782591,85,1,0.00334448160535117
"8527",199582,"SAINT AUGUSTINES COLLEGE",1,0,1999,331,173,158,57,16,41,0.237,0.172,0.101,5132,23.949176,87,0,0
"8528",199582,"SAINT AUGUSTINES COLLEGE",1,0,2000,398,232,166,67,17,50,0.216,0.168,0.102,5650,24.317507,82,1,0.00251256281407035
"8529",199582,"SAINT AUGUSTINES COLLEGE",1,0,2001,324,172,152,52,16,36,0.209,0.16,0.105,5780,23.153979,77,0,0
"8530",199582,"SAINT AUGUSTINES COLLEGE",1,0,2002,449,183,266,25,13,12,0.066,0.056,0.049,6030,22.7774,79,0,0
"8531",199582,"SAINT AUGUSTINES COLLEGE",1,0,2003,542,238,304,46,15,31,0.13,0.085,0.049,7398,24.617634,78,3,0.00553505535055351
"8532",199582,"SAINT AUGUSTINES COLLEGE",1,0,2004,324,140,184,45,15,30,0.214,0.139,0.082,8138,27.238148,89,3,0.00925925925925926
"8533",199582,"Saint Augustines College",1,0,2005,261,129,132,34,16,18,0.139,0.13,0.121,8952,25.543337,78,0,0
"8534",199582,"Saint Augustines College",1,0,2006,363,146,217,58,23,35,0.24,0.16,0.106,9980,26.046792,78,2,0.00550964187327824
"8535",199582,"Saint Augustines College",1,0,2007,417,188,229,91,31,60,0.319,0.218,0.135,10580,27.090028,82,4,0.00959232613908873
"8536",199582,"Saint Augustines College",1,0,2008,484,233,251,87,33,54,0.232,0.18,0.131,10580,30.946509,72,3,0.00619834710743802
"8537",199582,"Saint Augustines College",1,0,2009,424,206,218,91,35,56,0.272,0.215,0.161,12004,33.153065,72,13,0.0306603773584906
"8538",199582,"Saint Augustines College",1,0,2010,440,196,244,78,25,53,0.27,0.177,0.102,12364,36.154727,79,3,0.00681818181818182
"8539",199643,"SHAW UNIVERSITY",1,0,1991,579,330,249,190,82,108,0.327,0.328,0.329,4894,19.786174,73,22,0.0379965457685665
"8540",199643,"SHAW UNIVERSITY",1,0,1992,740,428,312,124,33,91,0.213,0.168,0.106,5272,22.451455,103,17,0.022972972972973
"8541",199643,"SHAW UNIVERSITY",1,0,1993,601,336,265,140,43,97,0.289,0.233,0.162,5562,27.717843,92,7,0.0116472545757072
"8542",199643,"SHAW UNIVERSITY",1,0,1995,518,305,213,127,29,98,0.321,0.245,0.136,5946,30.102557,99,14,0.027027027027027
"8543",199643,"SHAW UNIVERSITY",1,0,1996,374,232,142,67,17,50,0.216,0.179,0.12,5946,32.18454,82,5,0.0133689839572193
"8544",199643,"SHAW UNIVERSITY",1,0,1997,304,173,131,43,12,31,0.179,0.141,0.092,6304,29.75521,84,5,0.0164473684210526
"8545",199643,"SHAW UNIVERSITY",1,0,1998,382,220,162,73,20,53,0.241,0.191,0.123,6494,31.870102,88,8,0.0209424083769634
"8546",199643,"SHAW UNIVERSITY",1,0,1999,440,258,182,61,21,40,0.155,0.139,0.115,6272,24.372092,80,3,0.00681818181818182
"8547",199643,"SHAW UNIVERSITY",1,0,2000,401,247,154,43,13,30,0.122,0.107,0.084,6712,38.043487,88,7,0.0174563591022444
"8548",199643,"SHAW UNIVERSITY",1,0,2001,445,283,162,83,18,65,0.23,0.187,0.111,7056,40.720949,96,13,0.0292134831460674
"8549",199643,"SHAW UNIVERSITY",1,0,2002,526,240,286,67,26,41,0.171,0.127,0.091,7560,29.89823,85,11,0.0209125475285171
"8550",199643,"SHAW UNIVERSITY",1,0,2003,469,249,220,79,31,48,0.193,0.168,0.141,7800,35.945192,88,6,0.0127931769722814
"8551",199643,"SHAW UNIVERSITY",1,0,2004,417,227,190,61,16,45,0.198,0.146,0.084,7800,38.941877,105,9,0.0215827338129496
"8552",199643,"Shaw University",1,0,2005,573,307,266,75,29,46,0.15,0.131,0.109,7800,44.333827,111,5,0.0087260034904014
"8553",199643,"Shaw University",1,0,2006,674,423,251,82,23,59,0.139,0.122,0.092,8280,41.67657,112,10,0.0148367952522255
"8554",199643,"Shaw University",1,0,2007,565,321,244,89,35,54,0.168,0.158,0.143,8800,46.607835,116,11,0.0194690265486726
"8555",199643,"Shaw University",1,0,2008,532,308,224,64,21,43,0.14,0.12,0.094,9336,51.415955,114,9,0.0169172932330827
"8556",199643,"Shaw University",1,0,2009,581,334,247,74,24,50,0.15,0.127,0.097,9336,49.133124,105,11,0.0189328743545611
"8557",199643,"Shaw University",1,0,2010,679,360,319,54,23,31,0.086,0.08,0.072,9840,46.36996,120,9,0.0132547864506627
"8558",199847,"WAKE FOREST UNIVERSITY",1,0,1991,857,425,432,659,299,360,0.847,0.769,0.692,10800,296.979272,317,753,0.878646441073512
"8559",199847,"WAKE FOREST UNIVERSITY",1,0,1992,909,445,464,639,300,339,0.762,0.703,0.647,12000,325.932635,313,805,0.885588558855886
"8560",199847,"WAKE FOREST UNIVERSITY",1,0,1993,904,443,461,676,314,362,0.817,0.748,0.681,13000,357.49889,323,793,0.877212389380531
"8561",199847,"WAKE FOREST UNIVERSITY",1,0,1995,962,458,504,720,357,363,0.793,0.748,0.708,14750,411.465504,331,841,0.874220374220374
"8562",199847,"WAKE FOREST UNIVERSITY",1,0,1996,934,500,434,707,297,410,0.82,0.757,0.684,18500,448.124309,365,802,0.858672376873662
"8563",199847,"WAKE FOREST UNIVERSITY",1,0,1997,962,483,479,739,338,401,0.83,0.768,0.706,19450,477.012669,383,849,0.882536382536383
"8564",199847,"WAKE FOREST UNIVERSITY",1,0,1998,993,505,488,746,334,412,0.816,0.751,0.684,20450,516.337,394,875,0.881168177240685
"8565",199847,"WAKE FOREST UNIVERSITY",1,0,1999,969,498,471,760,327,433,0.87,0.784,0.694,21420,562.383172,409,865,0.892672858617131
"8566",199847,"WAKE FOREST UNIVERSITY",1,0,2000,1020,530,490,804,355,449,0.847,0.788,0.724,22410,602.731,418,886,0.868627450980392
"8567",199847,"WAKE FOREST UNIVERSITY",1,0,2001,960,481,479,756,343,413,0.859,0.787,0.716,23530,637.563,427,846,0.88125
"8568",199847,"WAKE FOREST UNIVERSITY",1,0,2002,999,509,490,832,393,439,0.863,0.833,0.802,24750,694.329,430,847,0.847847847847848
"8569",199847,"WAKE FOREST UNIVERSITY",1,0,2003,984,507,477,834,386,448,0.884,0.848,0.809,26490,747.149,434,850,0.863821138211382
"8570",199847,"WAKE FOREST UNIVERSITY",1,0,2004,1109,552,557,921,438,483,0.875,0.83,0.786,28210,776.132,431,946,0.853020739404869
"8571",199847,"Wake Forest University",1,0,2005,1114,565,549,918,431,487,0.862,0.824,0.785,30110,848.437,450,916,0.822262118491921
"8572",199847,"Wake Forest University",1,0,2006,1119,576,543,927,432,495,0.859,0.828,0.796,32040,880.155,466,927,0.828418230563003
"8573",199847,"Wake Forest University",1,0,2007,1123,573,550,919,433,486,0.848,0.818,0.787,34230,947.914307,468,936,0.833481745325022
"8574",199847,"Wake Forest University",1,0,2008,1197,621,576,991,455,536,0.863,0.828,0.79,36560,1007.182797,471,969,0.80952380952381
"8575",199847,"Wake Forest University",1,0,2009,1193,628,565,983,445,538,0.857,0.824,0.788,38206,1032.195854,476,914,0.766135792120704
"8576",199847,"Wake Forest University",1,0,2010,1217,639,578,1019,462,557,0.872,0.837,0.799,39544,1094.58,505,941,0.773212818405916
"8577",199962,"WINGATE COLLEGE",1,0,1991,371,181,190,93,28,65,0.359,0.251,0.147,6120,14.441504,79,321,0.865229110512129
"8578",199962,"WINGATE COLLEGE",1,0,1992,365,179,186,84,36,48,0.268,0.23,0.194,6740,14.801292,77,307,0.841095890410959
"8579",199962,"WINGATE COLLEGE",1,0,1993,376,171,205,78,31,47,0.275,0.207,0.151,7410,15.511844,79,314,0.835106382978723
"8580",199962,"WINGATE UNIVERSITY",1,0,1995,334,157,177,113,45,68,0.433,0.338,0.254,8760,17.11071,80,289,0.865269461077844
"8581",199962,"WINGATE UNIVERSITY",1,0,1996,331,137,194,101,43,58,0.423,0.305,0.222,11090,18.129196,83,289,0.873111782477341
"8582",199962,"WINGATE UNIVERSITY",1,0,1997,296,123,173,103,43,60,0.488,0.348,0.249,11730,20.898424,82,255,0.861486486486487
"8583",199962,"WINGATE UNIVERSITY",1,0,1998,273,127,146,89,34,55,0.433,0.326,0.233,12150,22.610917,79,245,0.897435897435897
"8584",199962,"WINGATE UNIVERSITY",1,0,1999,301,144,157,102,32,70,0.486,0.339,0.204,11950,22.896256,79,242,0.803986710963455
"8585",199962,"WINGATE UNIVERSITY",1,0,2000,380,181,199,142,54,88,0.486,0.374,0.271,12300,25.14358,79.5,303,0.797368421052632
"8586",199962,"WINGATE UNIVERSITY",1,0,2001,393,209,184,147,44,103,0.493,0.374,0.239,12900,21.88753,80,334,0.849872773536896
"8587",199962,"WINGATE UNIVERSITY",1,0,2002,374,197,177,167,62,105,0.533,0.447,0.35,13550,21.480104,83,314,0.839572192513369
"8588",199962,"WINGATE UNIVERSITY",1,0,2003,372,198,174,160,55,105,0.53,0.43,0.316,14200,23.276722,95,314,0.844086021505376
"8589",199962,"WINGATE UNIVERSITY",1,0,2004,358,174,184,155,66,89,0.511,0.433,0.359,15000,25.920346,100,296,0.826815642458101
"8590",199962,"Wingate University",1,0,2005,371,183,188,154,54,100,0.546,0.415,0.287,15800,27.134805,102,319,0.859838274932615
"8591",199962,"Wingate University",1,0,2006,385,198,187,152,57,95,0.48,0.395,0.305,16600,29.988279,110,294,0.763636363636364
"8592",199962,"Wingate University",1,0,2007,426,209,217,200,87,113,0.541,0.469,0.401,17430,32.288341,114,318,0.746478873239437
"8593",199962,"Wingate University",1,0,2008,431,223,208,183,79,104,0.466,0.425,0.38,18300,34.755853,111,291,0.675174013921114
"8594",199962,"Wingate University",1,0,2009,375,195,180,150,59,91,0.467,0.4,0.328,18990,37.651227,122,243,0.648
"8595",199962,"Wingate University",1,0,2010,605,336,269,267,95,172,0.512,0.441,0.353,19990,38.599921,120,366,0.60495867768595
"8596",199999,"WINSTON-SALEM STATE UNIVERSITY",1,0,1991,431,287,144,59,7,52,0.181,0.137,0.049,1060,28.014394,147,16,0.037122969837587
"8597",199999,"WINSTON-SALEM STATE UNIVERSITY",1,0,1992,391,267,124,83,20,63,0.236,0.212,0.161,1094,29.794754,146,14,0.0358056265984655
"8598",199999,"WINSTON-SALEM STATE UNIVERSITY",1,0,1993,369,225,144,79,26,53,0.236,0.214,0.181,1172,29.731085,149,19,0.0514905149051491
"8599",199999,"WINSTON-SALEM STATE UNIVERSITY",1,0,1995,446,298,148,121,32,89,0.299,0.271,0.216,1351,35.005407,156,27,0.0605381165919283
"8600",199999,"WINSTON-SALEM STATE UNIVERSITY",1,0,1996,480,351,129,95,19,76,0.216,0.198,0.147,1414,38.083276,156,35,0.0729166666666667
"8601",199999,"WINSTON-SALEM STATE UNIVERSITY",1,0,1997,485,329,156,117,27,90,0.274,0.241,0.173,1504,44.122182,157,23,0.0474226804123711
"8602",199999,"WINSTON SALEM STATE UNIVERSITY",1,0,1998,524,364,160,114,23,91,0.25,0.218,0.144,1561,43.694628,163,19,0.0362595419847328
"8603",199999,"WINSTON-SALEM STATE UNIVERSITY",1,0,1999,476,316,160,103,19,84,0.266,0.216,0.119,806,46.380188,162,12,0.0252100840336134
"8604",199999,"WINSTON-SALEM STATE UNIVERSITY",1,0,2000,499,359,140,97,19,78,0.217,0.194,0.136,822,49.045277,168.5,21,0.0420841683366733
"8605",199999,"WINSTON-SALEM STATE UNIVERSITY",1,0,2001,614,424,190,124,17,107,0.252,0.202,0.089,896,54.027212,175,15,0.0244299674267101
"8606",199999,"WINSTON-SALEM STATE UNIVERSITY",1,0,2002,670,471,199,121,28,93,0.198,0.181,0.141,1168,55.039536,179,25,0.0373134328358209
"8607",199999,"WINSTON-SALEM STATE UNIVERSITY",1,0,2003,883,580,303,124,25,99,0.171,0.14,0.083,1226,60.688933,170,17,0.0192525481313703
"8608",199999,"WINSTON-SALEM STATE UNIVERSITY",1,0,2004,891,619,272,117,35,82,0.132,0.131,0.129,1451,75.641559,191,29,0.0325476992143659
"8609",199999,"Winston-Salem State University",1,0,2005,1050,701,349,167,42,125,0.178,0.159,0.12,1451,85.167369,200,37,0.0352380952380952
"8610",199999,"Winston-Salem State University",1,0,2006,976,692,284,144,36,108,0.156,0.148,0.127,1651,98.48319,258,24,0.0245901639344262
"8611",199999,"Winston-Salem State University",1,0,2007,962,661,301,171,40,131,0.198,0.178,0.133,1701,119.859841,319,34,0.0353430353430353
"8612",199999,"Winston-Salem State University",1,0,2008,1353,886,467,234,62,172,0.194,0.173,0.133,1701,125.464808,338,27,0.0199556541019956
"8613",199999,"Winston-Salem State University",1,0,2009,794,540,254,135,39,96,0.178,0.17,0.154,1769,132.733103,325,21,0.026448362720403
"8614",199999,"Winston-Salem State University",1,0,2010,690,465,225,139,25,114,0.245,0.201,0.111,2274,137.864428,343,32,0.0463768115942029
"8615",200004,"WESTERN CAROLINA UNIVERSITY",1,0,1991,1011,522,489,210,84,126,0.241,0.208,0.172,1229,64.499457,291,933,0.922848664688427
"8616",200004,"WESTERN CAROLINA UNIVERSITY",1,0,1992,1065,543,522,208,76,132,0.243,0.195,0.146,1271,67.987254,308,998,0.937089201877934
"8617",200004,"WESTERN CAROLINA UNIVERSITY",1,0,1993,1051,509,542,226,91,135,0.265,0.215,0.168,1391,75.278888,319,968,0.921027592768792
"8618",200004,"WESTERN CAROLINA UNIVERSITY",1,0,1995,1156,608,548,259,78,181,0.298,0.224,0.142,1589,79.62621,325,1062,0.918685121107266
"8619",200004,"WESTERN CAROLINA UNIVERSITY",1,0,1996,1177,560,617,260,87,173,0.309,0.221,0.141,1663,82.723451,335,1090,0.926083262531861
"8620",200004,"WESTERN CAROLINA UNIVERSITY",1,0,1997,1224,629,595,310,100,210,0.334,0.253,0.168,1723,85.820486,328,1119,0.91421568627451
"8621",200004,"WESTERN CAROLINA UNIVERSITY",1,0,1998,1098,544,554,249,80,169,0.311,0.227,0.144,1793,90.469027,316,1004,0.914389799635701
"8622",200004,"WESTERN CAROLINA UNIVERSITY",1,0,1999,1151,569,582,261,103,158,0.278,0.227,0.177,962,95.250648,313,1043,0.90616854908775
"8623",200004,"WESTERN CAROLINA UNIVERSITY",1,0,2000,1211,594,617,298,120,178,0.3,0.246,0.194,982,98.092911,309,1075,0.887696118909992
"8624",200004,"WESTERN CAROLINA UNIVERSITY",1,0,2001,1176,530,646,266,108,158,0.298,0.226,0.167,1072,101.874263,305,1057,0.898809523809524
"8625",200004,"WESTERN CAROLINA UNIVERSITY",1,0,2002,1216,627,589,344,127,217,0.346,0.283,0.216,1358,97.568645,315,1074,0.883223684210526
"8626",200004,"WESTERN CAROLINA UNIVERSITY",1,0,2003,1485,739,746,394,138,256,0.346,0.265,0.185,1426,103.453787,326,1346,0.906397306397306
"8627",200004,"WESTERN CAROLINA UNIVERSITY",1,0,2004,1571,805,766,447,154,293,0.364,0.285,0.201,1651,117.975762,359,1400,0.891152132399745
"8628",200004,"Western Carolina University",1,0,2005,1549,775,774,453,181,272,0.351,0.292,0.234,1651,128.711491,416,1354,0.87411233053583
"8629",200004,"Western Carolina University",1,0,2006,1558,784,774,434,163,271,0.346,0.279,0.211,1904,148.232425,433,1341,0.860718870346598
"8630",200004,"Western Carolina University",1,0,2007,1249,651,598,400,142,258,0.396,0.32,0.237,2028,161.104681,456,1038,0.831064851881505
"8631",200004,"Western Carolina University",1,0,2008,1218,617,601,485,198,287,0.465,0.398,0.329,2078,172.883555,472,1036,0.850574712643678
"8632",200004,"Western Carolina University",1,0,2009,1547,848,699,568,211,357,0.421,0.367,0.302,2106,177.025145,460,1253,0.809954751131222
"8633",200004,"Western Carolina University",1,0,2010,1415,746,669,520,196,324,0.434,0.367,0.293,2816,168.434269,451,1176,0.831095406360424
"8634",200059,"DICKINSON STATE UNIVERSITY",1,0,1991,315,165,150,30,12,18,0.109,0.095,0.08,1706,10.560906,67,306,0.971428571428571
"8635",200059,"DICKINSON STATE UNIVERSITY",1,0,1992,336,191,145,32,9,23,0.12,0.095,0.062,1706,11.008164,67,328,0.976190476190476
"8636",200059,"DICKINSON STATE UNIVERSITY",1,0,1993,300,148,152,22,5,17,0.115,0.073,0.033,1782,11.852361,72,289,0.963333333333333
"8637",200059,"DICKINSON STATE UNIVERSITY",1,0,1995,296,140,156,27,10,17,0.121,0.091,0.064,1856,12.57954,73,279,0.942567567567568
"8638",200059,"DICKINSON STATE UNIVERSITY",1,0,1996,397,193,204,24,9,15,0.078,0.06,0.044,1970,12.524529,72,375,0.944584382871537
"8639",200059,"DICKINSON STATE UNIVERSITY",1,0,1997,408,233,175,39,15,24,0.103,0.096,0.086,2096,13.272999,71,391,0.958333333333333
"8640",200059,"DICKINSON STATE UNIVERSITY",1,0,1998,363,204,159,26,4,22,0.108,0.072,0.025,2196,13.496673,70,349,0.961432506887052
"8641",200059,"DICKINSON STATE UNIVERSITY",1,0,1999,359,179,180,39,15,24,0.134,0.109,0.083,1906,15.683917,72,346,0.963788300835655
"8642",200059,"DICKINSON STATE UNIVERSITY",1,0,2000,350,208,142,34,14,20,0.096,0.097,0.099,1982,17.513993,71.5,329,0.94
"8643",200059,"DICKINSON STATE UNIVERSITY",1,0,2001,375,188,187,39,8,31,0.165,0.104,0.043,2067,18.488388,71,341,0.909333333333333
"8644",200059,"DICKINSON STATE UNIVERSITY",1,0,2002,368,193,175,32,8,24,0.124,0.087,0.046,2202,18.04474,72,327,0.888586956521739
"8645",200059,"DICKINSON STATE UNIVERSITY",1,0,2003,383,201,182,42,14,28,0.139,0.11,0.077,2554,18.949013,83,335,0.87467362924282
"8646",200059,"DICKINSON STATE UNIVERSITY",1,0,2004,332,170,162,37,15,22,0.129,0.111,0.093,3040,20.135147,94,286,0.86144578313253
"8647",200059,"Dickinson State University",1,0,2005,317,162,155,29,11,18,0.111,0.091,0.071,3329,22.104203,89,263,0.829652996845426
"8648",200059,"Dickinson State University",1,0,2006,333,160,173,50,22,28,0.175,0.15,0.127,3645,24.219064,87,240,0.720720720720721
"8649",200059,"Dickinson State University",1,0,2007,355,191,164,48,19,29,0.152,0.135,0.116,3828,26.348263,86,270,0.76056338028169
"8650",200059,"Dickinson State University",1,0,2008,320,142,178,34,16,18,0.127,0.106,0.09,4019,27.259803,93,228,0.7125
"8651",200059,"Dickinson State University",1,0,2009,307,177,130,43,13,30,0.169,0.14,0.1,4160,29.008236,95,211,0.687296416938111
"8652",200059,"Dickinson State University",1,0,2010,307,146,161,33,14,19,0.13,0.107,0.087,4304,29.571623,93,226,0.736156351791531
"8653",200156,"JAMESTOWN COLLEGE",1,0,1991,288,134,154,68,21,47,0.351,0.236,0.136,6670,9.987004,48,256,0.888888888888889
"8654",200156,"JAMESTOWN COLLEGE",1,0,1992,292,140,152,86,27,59,0.421,0.295,0.178,6920,12.370116,47,263,0.900684931506849
"8655",200156,"JAMESTOWN COLLEGE",1,0,1993,262,121,141,62,27,35,0.289,0.237,0.191,7270,12.310374,52,244,0.931297709923664
"8656",200156,"JAMESTOWN COLLEGE",1,0,1995,289,144,145,89,32,57,0.396,0.308,0.221,7970,13.235665,50,282,0.975778546712803
"8657",200156,"JAMESTOWN COLLEGE",1,0,1996,288,159,129,90,25,65,0.409,0.312,0.194,8420,13.583434,52,269,0.934027777777778
"8658",200156,"JAMESTOWN COLLEGE",1,0,1997,232,134,98,100,36,64,0.478,0.431,0.367,8770,9.711538,51,220,0.948275862068966
"8659",200156,"JAMESTOWN COLLEGE",1,0,1998,278,150,128,99,39,60,0.4,0.356,0.305,6770,9.942702,50,261,0.938848920863309
"8660",200156,"JAMESTOWN COLLEGE",1,0,1999,284,165,119,84,31,53,0.321,0.296,0.261,7150,10.842389,53,269,0.947183098591549
"8661",200156,"JAMESTOWN COLLEGE",1,0,2000,331,192,139,107,35,72,0.375,0.323,0.252,7550,11.799264,53.5,304,0.918429003021148
"8662",200156,"JAMESTOWN COLLEGE",1,0,2001,293,173,120,96,35,61,0.353,0.328,0.292,7925,12.48553,54,274,0.935153583617747
"8663",200156,"JAMESTOWN COLLEGE",1,0,2002,332,176,156,98,29,69,0.392,0.295,0.186,8350,12.332878,57,302,0.909638554216867
"8664",200156,"JAMESTOWN COLLEGE",1,0,2003,261,142,119,82,27,55,0.387,0.314,0.227,8750,12.568543,58,232,0.888888888888889
"8665",200156,"JAMESTOWN COLLEGE",1,0,2004,229,135,94,63,33,30,0.222,0.275,0.351,9400,13.791444,56,210,0.91703056768559
"8666",200156,"Jamestown College",1,0,2005,270,139,131,67,24,43,0.309,0.248,0.183,10000,13.087106,56,249,0.922222222222222
"8667",200156,"Jamestown College",1,0,2006,238,129,109,75,21,54,0.419,0.315,0.193,10550,13.641549,56,223,0.936974789915966
"8668",200156,"Jamestown College",1,0,2007,264,140,124,88,26,62,0.443,0.333,0.21,11235,14.037446,54,239,0.90530303030303
"8669",200156,"Jamestown College",1,0,2008,267,123,144,74,27,47,0.382,0.277,0.188,12748,14.930614,55,234,0.876404494382023
"8670",200156,"Jamestown College",1,0,2009,233,116,117,49,17,32,0.276,0.21,0.145,14432,15.716489,57,208,0.892703862660944
"8671",200156,"Jamestown College",1,0,2010,202,98,104,72,27,45,0.459,0.356,0.26,15680,15.757374,58,161,0.797029702970297
"8672",200217,"UNIVERSITY OF MARY",1,0,1991,317,179,138,96,33,63,0.352,0.303,0.239,5550,11.369664,66,294,0.927444794952681
"8673",200217,"UNIVERSITY OF MARY",1,0,1992,343,205,138,104,30,74,0.361,0.303,0.217,5900,13.030383,70,312,0.909620991253644
"8674",200217,"UNIVERSITY OF MARY",1,0,1993,350,224,126,91,20,71,0.317,0.26,0.159,6260,14.575056,75,326,0.931428571428571
"8675",200217,"UNIVERSITY OF MARY",1,0,1995,412,234,178,115,32,83,0.355,0.279,0.18,6950,16.232706,76,388,0.941747572815534
"8676",200217,"UNIVERSITY OF MARY",1,0,1996,440,266,174,117,36,81,0.304,0.266,0.207,7330,21.913103,78,408,0.927272727272727
"8677",200217,"UNIVERSITY OF MARY",1,0,1997,381,242,139,131,32,99,0.409,0.344,0.23,7590,18.391483,82,366,0.960629921259842
"8678",200217,"UNIVERSITY OF MARY",1,0,1998,404,244,160,149,39,110,0.451,0.369,0.244,8080,20.575285,85,385,0.952970297029703
"8679",200217,"UNIVERSITY OF MARY",1,0,1999,373,242,131,155,42,113,0.467,0.416,0.321,8200,20.326058,83,359,0.962466487935657
"8680",200217,"UNIVERSITY OF MARY",1,0,2000,351,201,150,142,37,105,0.522,0.405,0.247,8500,23.864083,87,335,0.954415954415954
"8681",200217,"UNIVERSITY OF MARY",1,0,2001,372,213,159,143,43,100,0.47,0.384,0.27,8800,25.860343,91,348,0.935483870967742
"8682",200217,"UNIVERSITY OF MARY",1,0,2002,402,240,162,168,44,124,0.517,0.418,0.272,9200,28.025394,91,381,0.947761194029851
"8683",200217,"UNIVERSITY OF MARY",1,0,2003,390,226,164,147,36,111,0.491,0.377,0.22,9600,28.364408,90,353,0.905128205128205
"8684",200217,"UNIVERSITY OF MARY",1,0,2004,430,251,179,156,46,110,0.438,0.363,0.257,9990,29.697446,93,400,0.930232558139535
"8685",200217,"University of Mary",1,0,2005,392,220,172,103,28,75,0.341,0.263,0.163,10600,31.573727,100,358,0.913265306122449
"8686",200217,"University of Mary",1,0,2006,343,187,156,19,10,9,0.048,0.055,0.064,11100,32.692775,100,316,0.921282798833819
"8687",200217,"University of Mary",1,0,2007,352,206,146,99,20,79,0.384,0.281,0.137,11530,34.078643,103,302,0.857954545454545
"8688",200217,"University of Mary",1,0,2008,373,227,146,108,25,83,0.366,0.29,0.171,11940,35.86203,98,339,0.908847184986595
"8689",200217,"University of Mary",1,0,2009,311,192,119,122,32,90,0.469,0.392,0.269,12360,37.054471,95,280,0.90032154340836
"8690",200217,"University of Mary",1,0,2010,362,203,159,138,38,100,0.493,0.381,0.239,12800,36.616858,93,307,0.848066298342541
"8691",200226,"MAYVILLE STATE UNIVERSITY",0,1,1991,162,83,79,21,3,18,0.217,0.13,0.038,2133,6.489673,33,150,0.925925925925926
"8692",200226,"MAYVILLE STATE UNIVERSITY",1,0,1992,165,86,79,15,5,10,0.116,0.091,0.063,2755,7.097166,36,143,0.866666666666667
"8693",200226,"MAYVILLE STATE UNIVERSITY",1,0,1993,146,61,85,17,4,13,0.213,0.116,0.047,1831,7.679234,37,122,0.835616438356164
"8694",200226,"MAYVILLE STATE UNIVERSITY",1,0,1995,193,80,113,25,10,15,0.188,0.13,0.088,2340,7.907681,36,172,0.89119170984456
"8695",200226,"MAYVILLE STATE UNIVERSITY",1,0,1996,148,79,69,22,7,15,0.19,0.149,0.101,2016,8.187579,39,141,0.952702702702703
"8696",200226,"MAYVILLE STATE UNIVERSITY",1,0,1997,129,73,56,20,6,14,0.192,0.155,0.107,2946,8.629243,37,112,0.868217054263566
"8697",200226,"MAYVILLE STATE UNIVERSITY",1,0,1998,153,56,97,32,16,16,0.286,0.209,0.165,3032,9.141511,38,132,0.862745098039216
"8698",200226,"MAYVILLE STATE UNIVERSITY",1,0,1999,140,71,69,41,15,26,0.366,0.293,0.217,1906,9.350614,39,130,0.928571428571429
"8699",200226,"MAYVILLE STATE UNIVERSITY",1,0,2000,153,73,80,22,6,16,0.219,0.144,0.075,1982,9.239771,37.5,145,0.947712418300654
"8700",200226,"MAYVILLE STATE UNIVERSITY",1,0,2001,133,62,71,18,6,12,0.194,0.135,0.085,2067,9.748057,36,127,0.954887218045113
"8701",200226,"MAYVILLE STATE UNIVERSITY",1,0,2002,135,79,56,32,4,28,0.354,0.237,0.071,2202,11.110985,39,125,0.925925925925926
"8702",200226,"MAYVILLE STATE UNIVERSITY",1,0,2003,135,70,65,26,9,17,0.243,0.193,0.138,2576,12.08186,36,113,0.837037037037037
"8703",200226,"MAYVILLE STATE UNIVERSITY",1,0,2004,162,72,90,25,5,20,0.278,0.154,0.056,3014,11.486732,37,128,0.790123456790123
"8704",200226,"Mayville State University",1,0,2005,144,63,81,28,10,18,0.286,0.194,0.123,3300,13.30326,36,121,0.840277777777778
"8705",200226,"Mayville State University",1,0,2006,137,59,78,29,7,22,0.373,0.212,0.09,3614,12.743712,36,116,0.846715328467153
"8706",200226,"Mayville State University",1,0,2007,89,42,47,18,5,13,0.31,0.202,0.106,3795,12.724384,42,76,0.853932584269663
"8707",200226,"Mayville State University",1,0,2008,89,52,37,17,5,12,0.231,0.191,0.135,3985,13.502006,40,71,0.797752808988764
"8708",200226,"Mayville State University",1,0,2009,147,57,90,17,7,10,0.175,0.116,0.078,4124,13.63168,39,98,0.666666666666667
"8709",200226,"Mayville State University",1,0,2010,130,54,76,17,10,7,0.13,0.131,0.132,4268,15.716217,38,99,0.761538461538461
"8710",200253,"MINOT STATE UNIVERSITY",0,1,1991,546,363,183,52,14,38,0.105,0.095,0.077,1701,21.227869,166,457,0.836996336996337
"8711",200253,"MINOT STATE UNIVERSITY",1,0,1992,624,398,226,30,6,24,0.06,0.048,0.027,1710,23.801848,169,483,0.774038461538462
"8712",200253,"MINOT STATE UNIVERSITY",1,0,1993,579,346,233,48,13,35,0.101,0.083,0.056,1836,25.424522,188,455,0.785837651122625
"8713",200253,"MINOT STATE UNIVERSITY",1,0,1995,525,322,203,36,11,25,0.078,0.069,0.054,1960,28.543612,183,447,0.851428571428571
"8714",200253,"MINOT STATE UNIVERSITY",1,0,1996,457,304,153,35,10,25,0.082,0.077,0.065,2044,27.355287,209,396,0.866520787746171
"8715",200253,"MINOT STATE UNIVERSITY",1,0,1997,442,270,172,38,9,29,0.107,0.086,0.052,2139,31.36524,176,389,0.880090497737557
"8716",200253,"MINOT STATE UNIVERSITY",1,0,1998,371,217,154,28,7,21,0.097,0.075,0.045,2240,32.105149,166,325,0.876010781671159
"8717",200253,"MINOT STATE UNIVERSITY",1,0,1999,433,251,182,40,11,29,0.116,0.092,0.06,2050,33.196981,186,395,0.912240184757506
"8718",200253,"MINOT STATE UNIVERSITY",1,0,2000,452,260,192,61,25,36,0.138,0.135,0.13,2144,30.012989,171,396,0.876106194690266
"8719",200253,"MINOT STATE UNIVERSITY",1,0,2001,419,241,178,43,11,32,0.133,0.103,0.062,2244,32.123074,156,370,0.883054892601432
"8720",200253,"MINOT STATE UNIVERSITY",1,0,2002,476,268,208,62,11,51,0.19,0.13,0.053,2344,31.983363,177,414,0.869747899159664
"8721",200253,"MINOT STATE UNIVERSITY",1,0,2003,435,252,183,70,16,54,0.214,0.161,0.087,2730,36.654774,159,375,0.862068965517241
"8722",200253,"MINOT STATE UNIVERSITY",1,0,2004,431,254,177,72,20,52,0.205,0.167,0.113,3160,37.133801,176,369,0.85614849187935
"8723",200253,"Minot State University",1,0,2005,431,240,191,64,19,45,0.188,0.148,0.099,3460,38.539855,171,378,0.877030162412993
"8724",200253,"Minot State University",1,0,2006,461,263,198,58,13,45,0.171,0.126,0.066,3790,39.90512,185,355,0.770065075921909
"8725",200253,"Minot State University",1,0,2007,418,231,187,60,21,39,0.169,0.144,0.112,3980,42.563128,180,347,0.830143540669856
"8726",200253,"Minot State University",1,0,2008,406,259,147,55,11,44,0.17,0.135,0.075,4179,41.42809,189,318,0.783251231527094
"8727",200253,"Minot State University",1,0,2009,418,238,180,68,21,47,0.198,0.163,0.117,4325,43.176406,179,321,0.767942583732057
"8728",200253,"Minot State University",1,0,2010,461,298,163,83,10,73,0.245,0.18,0.061,4476,49.394209,187,344,0.746203904555314
"8729",200280,"UNIVERSITY OF NORTH DAKOTA-MAIN CAMPUS",1,0,1991,1288,588,700,161,78,83,0.141,0.125,0.111,2145,178.321194,458,1188,0.922360248447205
"8730",200280,"UNIVERSITY OF NORTH DAKOTA-MAIN CAMPUS",1,0,1992,1579,724,855,189,87,102,0.141,0.12,0.102,2165,195.727621,473,1466,0.928435718809373
"8731",200280,"UNIVERSITY OF NORTH DAKOTA-MAIN CAMPUS",1,0,1993,1465,747,718,205,80,125,0.167,0.14,0.111,2298,200.56233,472,1371,0.935836177474403
"8732",200280,"UNIVERSITY OF NORTH DAKOTA-MAIN CAMPUS",1,0,1995,1407,665,742,190,81,109,0.164,0.135,0.109,2428,217.025833,505,1314,0.933901918976546
"8733",200280,"UNIVERSITY OF NORTH DAKOTA-MAIN CAMPUS",1,0,1996,1365,630,735,194,92,102,0.162,0.142,0.125,2528,202.017128,495,1269,0.92967032967033
"8734",200280,"UNIVERSITY OF NORTH DAKOTA-MAIN CAMPUS",1,0,1997,1516,742,774,222,94,128,0.173,0.146,0.121,2677,192.078254,457,1394,0.919525065963061
"8735",200280,"UNIVERSITY OF NORTH DAKOTA-MAIN CAMPUS",1,0,1998,1465,722,743,326,141,185,0.256,0.223,0.19,2830,205.996973,440,1377,0.939931740614334
"8736",200280,"UNIVERSITY OF NORTH DAKOTA-MAIN CAMPUS",1,0,1999,1742,846,896,394,179,215,0.254,0.226,0.2,2956,200.226704,442,1636,0.939150401836969
"8737",200280,"UNIVERSITY OF NORTH DAKOTA-MAIN CAMPUS",1,0,2000,1832,858,974,394,192,202,0.235,0.215,0.197,2604,199.352765,455.5,1731,0.944868995633188
"8738",200280,"UNIVERSITY OF NORTH DAKOTA-MAIN CAMPUS",1,0,2001,1969,870,1099,436,191,245,0.282,0.221,0.174,2754,210.147716,469,1816,0.922295581513459
"8739",200280,"UNIVERSITY OF NORTH DAKOTA-MAIN CAMPUS",1,0,2002,1987,935,1052,438,205,233,0.249,0.22,0.195,2954,235.044663,482,1856,0.934071464519376
"8740",200280,"UNIVERSITY OF NORTH DAKOTA-MAIN CAMPUS",1,0,2003,2213,1039,1174,511,244,267,0.257,0.231,0.208,3441,246.246874,515,2063,0.932218707636692
"8741",200280,"UNIVERSITY OF NORTH DAKOTA-MAIN CAMPUS",1,0,2004,2178,1016,1162,459,216,243,0.239,0.211,0.186,4009,272.185438,526,2015,0.925160697887971
"8742",200280,"University of North Dakota",1,0,2005,1851,858,993,425,198,227,0.265,0.23,0.199,4390,293.657592,577,1769,0.95569962182604
"8743",200280,"University of North Dakota",1,0,2006,1868,869,999,438,199,239,0.275,0.234,0.199,4786,304.062813,485,1754,0.938972162740899
"8744",200280,"University of North Dakota",1,0,2007,1832,883,949,441,200,241,0.273,0.241,0.211,5025,317.457758,488,1673,0.9132096069869
"8745",200280,"University of North Dakota",1,0,2008,1923,896,1027,450,214,236,0.263,0.234,0.208,5276,333.474592,505,1781,0.926157046281851
"8746",200280,"University of North Dakota",1,0,2009,1970,940,1030,468,218,250,0.266,0.238,0.212,5461,359.245923,527,1744,0.885279187817259
"8747",200280,"University of North Dakota",1,0,2010,2073,978,1095,527,237,290,0.296,0.254,0.216,5652,374.77697,550,1773,0.855282199710564
"8748",200332,"NORTH DAKOTA STATE UNIVERSITY MAIN CAMPUS",0,1,1991,1192,491,701,134,58,76,0.155,0.112,0.083,2248,120.230824,465,1157,0.970637583892617
"8749",200332,"NORTH DAKOTA STATE UNIVERSITY MAIN CAMPUS",1,0,1992,1550,674,876,155,68,87,0.129,0.1,0.078,2032,131.704195,464,1504,0.970322580645161
"8750",200332,"NORTH DAKOTA STATE UNIVERSITY MAIN CAMPUS",1,0,1993,1433,571,862,182,76,106,0.186,0.127,0.088,2184,133.019603,448,1395,0.973482205163992
"8751",200332,"NORTH DAKOTA STATE UNIVERSITY MAIN CAMPUS",1,0,1995,1482,661,821,189,87,102,0.154,0.128,0.106,2310,144.666895,501,1445,0.975033738191633
"8752",200332,"NORTH DAKOTA STATE UNIVERSITY MAIN CAMPUS",1,0,1996,1295,543,752,169,83,86,0.158,0.131,0.11,2410,145.564523,484,1250,0.965250965250965
"8753",200332,"NORTH DAKOTA STATE UNIVERSITY MAIN CAMPUS",1,0,1997,1199,497,702,194,83,111,0.223,0.162,0.118,2566,149.863168,487,1154,0.962468723936614
"8754",200332,"NORTH DAKOTA STATE UNIVERSITY-MAIN CAMPUS",1,0,1998,1259,524,735,181,83,98,0.187,0.144,0.113,2730,154.633478,473,1191,0.945988880063543
"8755",200332,"NORTH DAKOTA STATE UNIVERSITY-MAIN CAMPUS",1,0,1999,1268,514,754,240,111,129,0.251,0.189,0.147,2596,163.599463,484,1204,0.949526813880126
"8756",200332,"NORTH DAKOTA STATE UNIVERSITY-MAIN CAMPUS",1,0,2000,1280,512,768,217,102,115,0.225,0.17,0.133,2604,167.737324,487.5,1234,0.9640625
"8757",200332,"NORTH DAKOTA STATE UNIVERSITY-MAIN CAMPUS",1,0,2001,1187,491,696,162,80,82,0.167,0.136,0.115,2754,184.680315,491,1130,0.951979780960404
"8758",200332,"NORTH DAKOTA STATE UNIVERSITY-MAIN CAMPUS",1,0,2002,1803,785,1018,387,186,201,0.256,0.215,0.183,2904,204.971957,527,1721,0.954520244037715
"8759",200332,"NORTH DAKOTA STATE UNIVERSITY-MAIN CAMPUS",1,0,2003,1944,902,1042,423,178,245,0.272,0.218,0.171,3374,216.557185,527,1840,0.946502057613169
"8760",200332,"NORTH DAKOTA STATE UNIVERSITY-MAIN CAMPUS",1,0,2004,2089,949,1140,481,220,261,0.275,0.23,0.193,3981,226.343511,531,1940,0.928674006701771
"8761",200332,"North Dakota State University-Main Campus",1,0,2005,1970,940,1030,457,191,266,0.283,0.232,0.185,4360,241.514229,837,1879,0.953807106598985
"8762",200332,"North Dakota State University-Main Campus",1,0,2006,2040,920,1120,486,221,265,0.288,0.238,0.197,4774,262.386066,580,1902,0.932352941176471
"8763",200332,"North Dakota State University-Main Campus",1,0,2007,2125,965,1160,544,244,300,0.311,0.256,0.21,5013,273.79201,609,1999,0.940705882352941
"8764",200332,"North Dakota State University-Main Campus",1,0,2008,2650,1182,1468,667,326,341,0.289,0.252,0.222,5264,298.618911,539,2439,0.920377358490566
"8765",200332,"North Dakota State University-Main Campus",1,0,2009,2435,1111,1324,655,299,356,0.32,0.269,0.226,5448,322.595971,564,2250,0.924024640657084
"8766",200332,"North Dakota State University-Main Campus",1,0,2010,2373,1074,1299,635,297,338,0.315,0.268,0.229,5639,350.326893,568,2131,0.898019384745048
"8767",200572,"VALLEY CITY STATE UNIVERSITY",0,1,1991,186,100,86,21,2,19,0.19,0.113,0.023,1707,8.405845,54,171,0.919354838709677
"8768",200572,"VALLEY CITY STATE UNIVERSITY",1,0,1992,193,90,103,28,12,16,0.178,0.145,0.117,1707,8.916437,56,172,0.89119170984456
"8769",200572,"VALLEY CITY STATE UNIVERSITY",1,0,1993,196,80,116,34,12,22,0.275,0.173,0.103,1815,9.131216,55,171,0.872448979591837
"8770",200572,"VALLEY CITY STATE UNIVERSITY",1,0,1995,166,80,86,32,11,21,0.262,0.193,0.128,1893,9.988352,53,149,0.897590361445783
"8771",200572,"VALLEY CITY STATE UNIVERSITY",1,0,1996,178,99,79,38,15,23,0.232,0.213,0.19,2843,10.438168,53,167,0.938202247191011
"8772",200572,"VALLEY CITY STATE UNIVERSITY",1,0,1997,177,100,77,37,8,29,0.29,0.209,0.104,2919,11.372601,51,158,0.892655367231638
"8773",200572,"VALLEY CITY STATE UNIVERSITY",1,0,1998,193,100,93,47,12,35,0.35,0.244,0.129,3023,11.853363,50,172,0.89119170984456
"8774",200572,"VALLEY CITY STATE UNIVERSITY",1,0,1999,158,76,82,35,8,27,0.355,0.222,0.098,1906,12.212215,56,142,0.89873417721519
"8775",200572,"VALLEY CITY STATE UNIVERSITY",1,0,2000,179,92,87,35,11,24,0.261,0.196,0.126,1982,12.744333,57,160,0.893854748603352
"8776",200572,"VALLEY CITY STATE UNIVERSITY",1,0,2001,155,75,80,40,15,25,0.333,0.258,0.188,2067,13.341774,58,140,0.903225806451613
"8777",200572,"VALLEY CITY STATE UNIVERSITY",1,0,2002,153,72,81,41,21,20,0.278,0.268,0.259,2202,14.46102,61,133,0.869281045751634
"8778",200572,"VALLEY CITY STATE UNIVERSITY",1,0,2003,159,71,88,36,15,21,0.296,0.226,0.17,2652,12.932444,61,143,0.89937106918239
"8779",200572,"VALLEY CITY STATE UNIVERSITY",1,0,2004,167,71,96,39,16,23,0.324,0.234,0.167,3130,13.836535,60,143,0.856287425149701
"8780",200572,"Valley City State University",1,0,2005,171,73,98,40,16,24,0.329,0.234,0.163,3656,14.291693,65,135,0.789473684210526
"8781",200572,"Valley City State University",1,0,2006,177,70,107,44,20,24,0.343,0.249,0.187,4003,14.88441,62,150,0.847457627118644
"8782",200572,"Valley City State University",1,0,2007,184,86,98,42,14,28,0.326,0.228,0.143,4204,15.067855,55,154,0.83695652173913
"8783",200572,"Valley City State University",1,0,2008,154,70,84,35,14,21,0.3,0.227,0.167,4412,15.904956,56,121,0.785714285714286
"8784",200572,"Valley City State University",1,0,2009,152,53,99,32,13,19,0.359,0.211,0.131,4568,16.670507,58,119,0.782894736842105
"8785",200572,"Valley City State University",1,0,2010,217,95,122,45,22,23,0.242,0.207,0.18,4433,18.69049,66,173,0.797235023041475
"8786",201104,"ASHLAND UNIVERSITY",1,0,1991,542,238,304,145,52,93,0.391,0.268,0.171,9985,40.979715,150,454,0.837638376383764
"8787",201104,"ASHLAND UNIVERSITY",1,0,1992,650,307,343,172,69,103,0.335,0.265,0.201,10583,49.065779,165,559,0.86
"8788",201104,"ASHLAND UNIVERSITY",1,0,1993,510,268,242,134,29,105,0.392,0.263,0.12,10733,51.692454,162,452,0.886274509803922
"8789",201104,"ASHLAND UNIVERSITY",1,0,1995,549,269,280,214,67,147,0.546,0.39,0.239,12174,52.815921,218,493,0.89799635701275
"8790",201104,"ASHLAND UNIVERSITY",1,0,1996,432,240,192,150,47,103,0.429,0.347,0.245,12600,56.301754,200,398,0.921296296296296
"8791",201104,"ASHLAND UNIVERSITY",1,0,1997,531,302,229,220,76,144,0.477,0.414,0.332,13293,55.581886,192,493,0.928436911487759
"8792",201104,"ASHLAND UNIVERSITY",1,0,1998,570,351,219,235,66,169,0.482,0.412,0.301,13726,60.752007,176,541,0.949122807017544
"8793",201104,"ASHLAND UNIVERSITY",1,0,1999,541,313,228,246,80,166,0.53,0.455,0.351,14276,64.235154,198,512,0.946395563770795
"8794",201104,"ASHLAND UNIVERSITY",1,0,2000,448,265,183,187,51,136,0.513,0.417,0.279,15134,70.051231,207.5,413,0.921875
"8795",201104,"ASHLAND UNIVERSITY",1,0,2001,492,273,219,200,69,131,0.48,0.407,0.315,15814,62.717782,217,458,0.930894308943089
"8796",201104,"ASHLAND UNIVERSITY",1,0,2002,559,373,186,258,60,198,0.531,0.462,0.323,16764,66.44947,213,512,0.915921288014311
"8797",201104,"ASHLAND UNIVERSITY",1,0,2003,605,379,226,275,76,199,0.525,0.455,0.336,17518,72.87815,224,547,0.904132231404959
"8798",201104,"ASHLAND UNIVERSITY",1,0,2004,571,340,231,245,70,175,0.515,0.429,0.303,18394,81.611282,234,522,0.914185639229422
"8799",201104,"Ashland University",1,0,2005,573,357,216,271,86,185,0.518,0.473,0.398,19314,85.362587,232,530,0.924956369982548
"8800",201104,"Ashland University",1,0,2006,554,313,241,238,78,160,0.511,0.43,0.324,20666,88.625975,229,477,0.86101083032491
"8801",201104,"Ashland University",1,0,2007,639,371,268,264,77,187,0.504,0.413,0.287,22216,90.869415,234,558,0.873239436619718
"8802",201104,"Ashland University",1,0,2008,570,306,264,236,83,153,0.5,0.414,0.314,23550,95.993437,233,455,0.798245614035088
"8803",201104,"Ashland University",1,0,2009,614,338,276,281,94,187,0.553,0.458,0.341,24828,95.662639,213,507,0.825732899022801
"8804",201104,"Ashland University",1,0,2010,688,407,281,345,115,230,0.565,0.501,0.409,26566,92.876485,272,607,0.882267441860465
"8805",201371,"BLUFFTON COLLEGE",0,1,1991,193,93,100,85,30,55,0.591,0.44,0.3,8100,8.856202,45,178,0.922279792746114
"8806",201371,"BLUFFTON COLLEGE",0,1,1992,181,104,77,92,39,53,0.51,0.508,0.506,8685,9.878359,45,173,0.955801104972376
"8807",201371,"BLUFFTON COLLEGE",0,1,1993,214,105,109,110,43,67,0.638,0.514,0.394,9225,10.96465,49,193,0.901869158878505
"8808",201371,"BLUFFTON COLLEGE",0,1,1995,248,163,85,125,39,86,0.528,0.504,0.459,10620,14.257746,51,235,0.94758064516129
"8809",201371,"BLUFFTON COLLEGE",0,1,1996,183,115,68,97,38,59,0.513,0.53,0.559,11250,16.709091,65,174,0.950819672131147
"8810",201371,"BLUFFTON COLLEGE",0,1,1997,254,149,105,124,37,87,0.584,0.488,0.352,11835,14.604545,65,233,0.917322834645669
"8811",201371,"BLUFFTON COLLEGE",0,1,1998,190,112,78,102,32,70,0.625,0.537,0.41,12375,14.561143,65,177,0.931578947368421
"8812",201371,"BLUFFTON COLLEGE",1,0,1999,248,156,92,114,32,82,0.526,0.46,0.348,13156,14.715198,66,231,0.931451612903226
"8813",201371,"BLUFFTON COLLEGE",1,0,2000,227,124,103,114,48,66,0.532,0.502,0.466,14076,16.173238,69,210,0.92511013215859
"8814",201371,"BLUFFTON COLLEGE",1,0,2001,239,133,106,117,44,73,0.549,0.49,0.415,15076,17.631733,72,225,0.941422594142259
"8815",201371,"BLUFFTON COLLEGE",1,0,2002,262,141,121,135,55,80,0.567,0.515,0.455,16130,18.81365,72,226,0.862595419847328
"8816",201371,"BLUFFTON COLLEGE",1,0,2003,236,143,93,133,51,82,0.573,0.564,0.548,17260,20.177741,71,208,0.88135593220339
"8817",201371,"BLUFFTON UNIVERSITY",1,0,2004,266,130,136,136,61,75,0.577,0.511,0.449,17950,20.43422,64,236,0.887218045112782
"8818",201371,"Bluffton University",1,0,2005,228,141,87,123,45,78,0.553,0.539,0.517,19028,20.579279,67,198,0.868421052631579
"8819",201371,"Bluffton University",1,0,2006,241,122,119,119,50,69,0.566,0.494,0.42,20170,21.329259,68,203,0.842323651452282
"8820",201371,"Bluffton University",1,0,2007,206,117,89,108,41,67,0.573,0.524,0.461,21380,21.723051,66,181,0.878640776699029
"8821",201371,"Bluffton University",1,0,2008,272,140,132,144,62,82,0.586,0.529,0.47,22470,21.987626,64,250,0.919117647058823
"8822",201371,"Bluffton University",1,0,2009,257,116,141,107,48,59,0.509,0.416,0.34,23594,22.269485,62,213,0.828793774319066
"8823",201371,"Bluffton University",1,0,2010,219,91,128,96,45,51,0.56,0.438,0.352,24480,21.721263,63,169,0.771689497716895
"8824",201548,"CAPITAL UNIVERSITY",1,0,1991,370,218,152,232,87,145,0.665,0.627,0.572,11085,31.710296,137,342,0.924324324324324
"8825",201548,"CAPITAL UNIVERSITY",1,0,1992,330,213,117,163,56,107,0.502,0.494,0.479,11810,36.621178,139,296,0.896969696969697
"8826",201548,"CAPITAL UNIVERSITY",1,0,1993,448,266,182,238,81,157,0.59,0.531,0.445,12500,39.762702,158,396,0.883928571428571
"8827",201548,"CAPITAL UNIVERSITY",1,0,1995,474,296,178,306,108,198,0.669,0.646,0.607,13700,47.388273,176,415,0.875527426160338
"8828",201548,"CAPITAL UNIVERSITY",1,0,1996,468,285,183,275,90,185,0.649,0.588,0.492,14200,52.318895,174,399,0.852564102564103
"8829",201548,"CAPITAL UNIVERSITY",1,0,1997,478,290,188,239,82,157,0.541,0.5,0.436,14760,44.032742,176,413,0.864016736401674
"8830",201548,"CAPITAL UNIVERSITY",1,0,1998,518,313,205,250,79,171,0.546,0.483,0.385,15260,42.772794,171,444,0.857142857142857
"8831",201548,"CAPITAL UNIVERSITY",1,0,1999,532,301,231,255,101,154,0.512,0.479,0.437,16000,45.108336,174,474,0.890977443609023
"8832",201548,"CAPITAL UNIVERSITY",1,0,2000,558,333,225,305,111,194,0.583,0.547,0.493,16880,46.540902,178,476,0.853046594982079
"8833",201548,"CAPITAL UNIVERSITY",1,0,2001,519,324,195,243,68,175,0.54,0.468,0.349,17990,50.636628,182,449,0.865125240847784
"8834",201548,"CAPITAL UNIVERSITY",1,0,2002,563,330,233,296,104,192,0.582,0.526,0.446,18980,51.51101,196,482,0.856127886323268
"8835",201548,"CAPITAL UNIVERSITY",1,0,2003,565,352,213,284,100,184,0.523,0.503,0.469,20500,55.712693,198,473,0.83716814159292
"8836",201548,"CAPITAL UNIVERSITY",1,0,2004,517,298,219,253,96,157,0.527,0.489,0.438,22035,63.004367,201,438,0.847195357833656
"8837",201548,"Capital University",1,0,2005,599,363,236,310,109,201,0.554,0.518,0.462,23433,70.226515,218,504,0.841402337228714
"8838",201548,"Capital University",1,0,2006,690,410,280,342,130,212,0.517,0.496,0.464,25100,74.800352,223,591,0.856521739130435
"8839",201548,"Capital University",1,0,2007,627,377,250,323,117,206,0.546,0.515,0.468,26360,71.587675,217,525,0.837320574162679
"8840",201548,"Capital University",1,0,2008,632,354,278,321,122,199,0.562,0.508,0.439,27680,68.680876,199,517,0.818037974683544
"8841",201548,"Capital University",1,0,2009,608,323,285,336,150,186,0.576,0.553,0.526,28480,71.729324,203,520,0.855263157894737
"8842",201548,"Capital University",1,0,2010,715,409,306,381,167,214,0.523,0.533,0.546,29310,71.371474,202,616,0.861538461538462
"8843",201645,"CASE WESTERN RESERVE UNIVERSITY",1,0,1991,647,245,402,327,173,154,0.629,0.505,0.43,13708,282.647,507,438,0.676970633693972
"8844",201645,"CASE WESTERN RESERVE UNIVERSITY",1,0,1992,762,321,441,350,152,198,0.617,0.459,0.345,14616,297.891,507,542,0.711286089238845
"8845",201645,"CASE WESTERN RESERVE UNIVERSITY",1,0,1993,712,249,463,354,201,153,0.615,0.497,0.434,15322,322.8,530,487,0.683988764044944
"8846",201645,"CASE WESTERN RESERVE UNIVERSITY",1,0,1995,729,275,454,388,205,183,0.665,0.532,0.452,16430,366.326,517,544,0.746227709190672
"8847",201645,"CASE WESTERN RESERVE UNIVERSITY",1,0,1996,738,284,454,387,202,185,0.651,0.524,0.445,17235,379.286475,532,507,0.686991869918699
"8848",201645,"CASE WESTERN RESERVE UNIVERSITY",1,0,1997,736,269,467,408,235,173,0.643,0.554,0.503,17942,359.011,536,494,0.671195652173913
"8849",201645,"CASE WESTERN RESERVE UNIVERSITY",1,0,1998,830,301,529,476,265,211,0.701,0.573,0.501,18546,329.785334,536,554,0.667469879518072
"8850",201645,"CASE WESTERN RESERVE UNIVERSITY",1,0,1999,762,292,470,432,245,187,0.64,0.567,0.521,19200,394.271,553,579,0.759842519685039
"8851",201645,"CASE WESTERN RESERVE UNIVERSITY",1,0,2000,833,305,528,489,279,210,0.689,0.587,0.528,20100,448.445907,557.5,615,0.738295318127251
"8852",201645,"CASE WESTERN RESERVE UNIVERSITY",1,0,2001,737,288,449,433,228,205,0.712,0.588,0.508,21000,474.312221,562,523,0.709633649932157
"8853",201645,"CASE WESTERN RESERVE UNIVERSITY",1,0,2002,835,322,513,482,264,218,0.677,0.577,0.515,22500,513.304963,590,603,0.722155688622754
"8854",201645,"CASE WESTERN RESERVE UNIVERSITY",1,0,2003,874,350,524,552,292,260,0.743,0.632,0.557,24100,571.603766,637,624,0.71395881006865
"8855",201645,"CASE WESTERN RESERVE UNIVERSITY",1,0,2004,782,306,476,508,282,226,0.739,0.65,0.592,26500,639.329928,686,511,0.653452685421995
"8856",201645,"Case Western Reserve University",1,0,2005,1162,456,706,702,386,316,0.693,0.604,0.547,28400,719.930321,646,682,0.586919104991394
"8857",201645,"Case Western Reserve University",1,0,2006,1015,441,574,636,325,311,0.705,0.627,0.566,31090,780.035911,651,632,0.622660098522168
"8858",201645,"Case Western Reserve University",1,0,2007,1132,492,640,734,368,366,0.744,0.648,0.575,32800,791.650861,656,652,0.575971731448763
"8859",201645,"Case Western Reserve University",1,0,2008,1023,442,581,651,337,314,0.71,0.636,0.58,34450,774.80591,664,566,0.55327468230694
"8860",201645,"Case Western Reserve University",1,0,2009,965,401,564,609,309,300,0.748,0.631,0.548,35900,806.905477,683,546,0.56580310880829
"8861",201645,"Case Western Reserve University",1,0,2010,1019,415,604,655,356,299,0.721,0.643,0.589,37300,817.854575,680,537,0.526987242394504
"8862",201690,"CENTRAL STATE UNIVERSITY",0,1,1991,661,327,334,92,34,58,0.177,0.139,0.102,2388,38.314533,114,13,0.0196671709531014
"8863",201690,"CENTRAL STATE UNIVERSITY",0,1,1992,665,319,346,42,12,30,0.094,0.063,0.035,2679,40.946469,128,6,0.00902255639097744
"8864",201690,"CENTRAL STATE UNIVERSITY",0,1,1993,613,301,312,66,18,48,0.16,0.108,0.058,2811,43.160099,136,2,0.0032626427406199
"8865",201690,"CENTRAL STATE UNIVERSITY",0,1,1995,597,262,335,25,5,20,0.076,0.042,0.015,2664,41.997668,94,4,0.0067001675041876
"8866",201690,"CENTRAL STATE UNIVERSITY",0,1,1996,330,161,169,28,12,16,0.099,0.085,0.071,3318,42.817451,95,1,0.00303030303030303
"8867",201690,"CENTRAL STATE UNIVERSITY",0,1,1997,88,47,41,4,0,4,0.085,0.045,0,3318,38.778423,75,0,0
"8868",201690,"CENTRAL STATE UNIVERSITY",0,1,1998,230,130,100,27,5,22,0.169,0.117,0.05,3336,30.59557,69,13,0.0565217391304348
"8869",201690,"CENTRAL STATE UNIVERSITY",0,1,1999,294,164,130,46,12,34,0.207,0.156,0.092,1926,39.404625,75,5,0.0170068027210884
"8870",201690,"CENTRAL STATE UNIVERSITY",0,1,2000,307,173,134,39,5,34,0.196,0.127,0.037,2046,37.82545,76,5,0.0162866449511401
"8871",201690,"CENTRAL STATE UNIVERSITY",0,1,2001,397,204,193,33,7,26,0.128,0.083,0.036,2064,43.646589,77,0,0
"8872",201690,"CENTRAL STATE UNIVERSITY",0,1,2002,378,207,171,51,14,37,0.179,0.135,0.082,2208,43.965408,87,2,0.00529100529100529
"8873",201690,"CENTRAL STATE UNIVERSITY",0,1,2003,542,277,265,43,10,33,0.119,0.079,0.038,2340,46.981958,87,4,0.00738007380073801
"8874",201690,"CENTRAL STATE UNIVERSITY",0,1,2004,583,270,313,46,11,35,0.13,0.079,0.035,2571,46.483398,92,2,0.00343053173241852
"8875",201690,"Central State University",1,0,2005,343,156,187,31,15,16,0.103,0.09,0.08,2726,50.715931,90,3,0.0087463556851312
"8876",201690,"Central State University",1,0,2006,535,266,269,65,21,44,0.165,0.121,0.078,2890,51.392088,97,5,0.00934579439252336
"8877",201690,"Central State University",1,0,2007,564,278,286,59,15,44,0.158,0.105,0.052,2890,50.761774,107,1,0.00177304964539007
"8878",201690,"Central State University",1,0,2008,646,330,316,72,10,62,0.188,0.111,0.032,2890,57.147067,106,2,0.00309597523219814
"8879",201690,"Central State University",1,0,2009,702,363,339,42,14,28,0.077,0.06,0.041,2890,58.068978,113,4,0.0056980056980057
"8880",201690,"Central State University",1,0,2010,503,231,272,49,18,31,0.134,0.097,0.066,2992,63.559722,111,4,0.00795228628230616
"8881",202134,"CLEVELAND STATE UNIVERSITY",0,1,1991,959,435,524,70,34,36,0.083,0.073,0.065,2682,132.83856,553,699,0.7288842544317
"8882",202134,"CLEVELAND STATE UNIVERSITY",0,1,1992,868,409,459,55,21,34,0.083,0.063,0.046,2976,137.304685,556,625,0.720046082949309
"8883",202134,"CLEVELAND STATE UNIVERSITY",0,1,1993,942,479,463,77,26,51,0.107,0.082,0.056,3126,135.782259,530,641,0.680467091295117
"8884",202134,"CLEVELAND STATE UNIVERSITY",0,1,1995,856,463,393,71,26,45,0.097,0.083,0.066,3332,140.904418,517,511,0.59696261682243
"8885",202134,"CLEVELAND STATE UNIVERSITY",0,1,1996,845,443,402,80,25,55,0.124,0.095,0.062,3442,146.915084,499,505,0.597633136094675
"8886",202134,"CLEVELAND STATE UNIVERSITY",0,1,1997,924,464,460,89,36,53,0.114,0.096,0.078,3456,152.132019,513,588,0.636363636363636
"8887",202134,"CLEVELAND STATE UNIVERSITY",0,1,1998,962,455,507,86,37,49,0.108,0.089,0.073,3670,164.788475,522,509,0.529106029106029
"8888",202134,"CLEVELAND STATE UNIVERSITY",1,0,1999,1048,494,554,114,50,64,0.13,0.109,0.09,3864,173.034479,543,661,0.630725190839695
"8889",202134,"CLEVELAND STATE UNIVERSITY",1,0,2000,934,471,463,103,42,61,0.13,0.11,0.091,4110,183.1551,534,561,0.600642398286938
"8890",202134,"CLEVELAND STATE UNIVERSITY",1,0,2001,1008,493,515,95,47,48,0.097,0.094,0.091,4464,190.573188,525,614,0.609126984126984
"8891",202134,"CLEVELAND STATE UNIVERSITY",1,0,2002,946,463,483,80,39,41,0.089,0.085,0.081,5196,201.263175,534,571,0.603594080338266
"8892",202134,"CLEVELAND STATE UNIVERSITY",1,0,2003,925,463,462,65,34,31,0.067,0.07,0.074,5760,209.416654,541,530,0.572972972972973
"8893",202134,"CLEVELAND STATE UNIVERSITY",1,0,2004,922,463,459,79,31,48,0.104,0.086,0.068,6792,226.387259,564,527,0.571583514099783
"8894",202134,"Cleveland State University",1,0,2005,955,507,448,87,31,56,0.111,0.091,0.069,6972,235.887718,575,553,0.579057591623037
"8895",202134,"Cleveland State University",1,0,2006,947,520,427,95,31,64,0.123,0.1,0.073,7920,241.944811,572,560,0.591341077085533
"8896",202134,"Cleveland State University",1,0,2007,1132,622,510,94,37,57,0.092,0.083,0.073,7920,248.174106,571,612,0.540636042402827
"8897",202134,"Cleveland State University",1,0,2008,1005,548,457,150,50,100,0.182,0.149,0.109,7920,260.171626,549,616,0.612935323383085
"8898",202134,"Cleveland State University",1,0,2009,1127,601,526,181,70,111,0.185,0.161,0.133,7920,273.255255,537,662,0.587400177462289
"8899",202134,"Cleveland State University",1,0,2010,1148,615,533,237,105,132,0.215,0.206,0.197,8466,275.01334,538,704,0.613240418118467
"8900",202480,"UNIVERSITY OF DAYTON",0,1,1991,1499,744,755,758,322,436,0.586,0.506,0.426,9410,150.603072,420,1361,0.9079386257505
"8901",202480,"UNIVERSITY OF DAYTON",0,1,1992,1622,778,844,832,343,489,0.629,0.513,0.406,10210,163.544431,420,1467,0.904438964241677
"8902",202480,"UNIVERSITY OF DAYTON",0,1,1993,1507,730,777,769,324,445,0.61,0.51,0.417,11090,175.292767,419,1360,0.902455209024552
"8903",202480,"UNIVERSITY OF DAYTON",0,1,1995,1610,836,774,890,342,548,0.655,0.553,0.442,12350,196.145421,404,1466,0.91055900621118
"8904",202480,"UNIVERSITY OF DAYTON",0,1,1996,1553,845,708,890,310,580,0.686,0.573,0.438,13640,201.046909,404,1437,0.925305859626529
"8905",202480,"UNIVERSITY OF DAYTON",0,1,1997,1622,872,750,896,351,545,0.625,0.552,0.468,14180,186.509273,400,1473,0.908138101109741
"8906",202480,"UNIVERSITY OF DAYTON",0,1,1998,1792,919,873,991,385,606,0.659,0.553,0.441,14670,193.217097,387,1620,0.904017857142857
"8907",202480,"UNIVERSITY OF DAYTON",0,1,1999,1744,921,823,1041,412,629,0.683,0.597,0.501,15020,195.810904,386,1516,0.869266055045872
"8908",202480,"UNIVERSITY OF DAYTON",0,1,2000,1764,932,832,1055,431,624,0.67,0.598,0.518,15550,209.354136,387,1619,0.917800453514739
"8909",202480,"UNIVERSITY OF DAYTON",0,1,2001,1715,879,836,971,389,582,0.662,0.566,0.465,16320,230.69935,388,1574,0.917784256559767
"8910",202480,"UNIVERSITY OF DAYTON",0,1,2002,1644,797,847,944,390,554,0.695,0.574,0.46,17450,236.267,407,1404,0.854014598540146
"8911",202480,"UNIVERSITY OF DAYTON",0,1,2003,1858,956,902,1084,431,653,0.683,0.583,0.478,18390,248.65,401,1568,0.843918191603875
"8912",202480,"UNIVERSITY OF DAYTON",0,1,2004,1805,905,900,1048,437,611,0.675,0.581,0.486,19570,270.478,439,1574,0.87202216066482
"8913",202480,"University of Dayton",1,0,2005,1970,1004,966,1149,475,674,0.671,0.583,0.492,21246,278.527,446,1783,0.90507614213198
"8914",202480,"University of Dayton",1,0,2006,1738,864,874,1041,450,591,0.684,0.599,0.515,23000,294.491,458,1595,0.917721518987342
"8915",202480,"University of Dayton",1,0,2007,1763,893,870,1064,460,604,0.676,0.604,0.529,24880,316.162,457,1563,0.886557005104935
"8916",202480,"University of Dayton",1,0,2008,1985,1045,940,1177,452,725,0.694,0.593,0.481,26200,333.988,462,1732,0.872544080604534
"8917",202480,"University of Dayton",1,0,2009,1692,834,858,1050,463,587,0.704,0.621,0.54,27510,363.804,514,1493,0.882387706855792
"8918",202480,"University of Dayton",1,0,2010,2029,995,1034,1187,506,681,0.684,0.585,0.489,28700,361.684,545,1752,0.863479546574667
"8919",202523,"DENISON UNIVERSITY",1,0,1991,501,271,230,351,150,201,0.742,0.701,0.652,14700,42.785936,159,438,0.874251497005988
"8920",202523,"DENISON UNIVERSITY",1,0,1992,570,301,269,392,174,218,0.724,0.688,0.647,15640,44.679899,157,506,0.887719298245614
"8921",202523,"DENISON UNIVERSITY",1,0,1993,535,290,245,342,142,200,0.69,0.639,0.58,15950,47.584744,146,496,0.927102803738318
"8922",202523,"DENISON UNIVERSITY",1,0,1995,701,357,344,488,221,267,0.748,0.696,0.642,18630,48.139208,138,606,0.864479315263909
"8923",202523,"DENISON UNIVERSITY",1,0,1996,642,305,337,464,229,235,0.77,0.723,0.68,19470,52.724862,141,562,0.875389408099688
"8924",202523,"DENISON UNIVERSITY",1,0,1997,593,325,268,438,185,253,0.778,0.739,0.69,20250,45.690252,149,510,0.860033726812816
"8925",202523,"DENISON UNIVERSITY",1,0,1998,631,364,267,456,173,283,0.777,0.723,0.648,21060,48.993211,141,527,0.835182250396197
"8926",202523,"DENISON UNIVERSITY",1,0,1999,587,335,252,444,171,273,0.815,0.756,0.679,20680,52.962477,152,499,0.850085178875639
"8927",202523,"DENISON UNIVERSITY",1,0,2000,648,370,278,484,198,286,0.773,0.747,0.712,21710,55.858982,164.5,553,0.853395061728395
"8928",202523,"DENISON UNIVERSITY",1,0,2001,553,309,244,414,170,244,0.79,0.749,0.697,22550,58.286634,177,450,0.81374321880651
"8929",202523,"DENISON UNIVERSITY",1,0,2002,633,338,295,469,192,277,0.82,0.741,0.651,23680,70.227853,189,519,0.819905213270142
"8930",202523,"DENISON UNIVERSITY",1,0,2003,629,358,271,502,199,303,0.846,0.798,0.734,25090,73.858438,180,535,0.850556438791733
"8931",202523,"DENISON UNIVERSITY",1,0,2004,616,362,254,501,200,301,0.832,0.813,0.787,26700,80.562639,179,512,0.831168831168831
"8932",202523,"Denison University",1,0,2005,620,337,283,473,211,262,0.777,0.763,0.746,28170,87.092483,202,506,0.816129032258065
"8933",202523,"Denison University",1,0,2006,573,335,238,481,190,291,0.869,0.839,0.798,29860,89.759158,218,479,0.835951134380454
"8934",202523,"Denison University",1,0,2007,585,325,260,455,199,256,0.788,0.778,0.765,32160,94.419742,217,480,0.82051282051282
"8935",202523,"Denison University",1,0,2008,604,325,279,476,202,274,0.843,0.788,0.724,34410,98.145736,214,472,0.781456953642384
"8936",202523,"Denison University",1,0,2009,649,362,287,500,205,295,0.815,0.77,0.714,35650,101.606153,213,486,0.74884437596302
"8937",202523,"Denison University",1,0,2010,623,349,274,482,199,283,0.811,0.774,0.726,37270,103.044708,224,452,0.725521669341894
"8938",202763,"THE UNIVERSITY OF FINDLAY",1,0,1991,342,152,190,95,46,49,0.322,0.278,0.242,8880,25.124522,102,262,0.766081871345029
"8939",202763,"THE UNIVERSITY OF FINDLAY",1,0,1992,412,197,215,153,62,91,0.462,0.371,0.288,10054,29.733986,110,337,0.817961165048544
"8940",202763,"THE UNIVERSITY OF FINDLAY",1,0,1993,394,190,204,162,76,86,0.453,0.411,0.373,10920,35.463005,115,286,0.725888324873096
"8941",202763,"THE UNIVERSITY OF FINDLAY",1,0,1995,591,306,285,205,78,127,0.415,0.347,0.274,12500,39.533904,116,386,0.653130287648054
"8942",202763,"THE UNIVERSITY OF FINDLAY",1,0,1996,553,302,251,210,83,127,0.42,0.38,0.331,13112,46.152899,124,428,0.773960216998192
"8943",202763,"THE UNIVERSITY OF FINDLAY",1,0,1997,651,390,261,264,75,189,0.485,0.406,0.287,13766,33.634057,126,545,0.837173579109063
"8944",202763,"THE UNIVERSITY OF FINDLAY",1,0,1998,585,384,201,228,64,164,0.427,0.39,0.318,14320,37.199479,130,533,0.911111111111111
"8945",202763,"THE UNIVERSITY OF FINDLAY",1,0,1999,522,337,185,212,52,160,0.475,0.406,0.281,15080,42.091065,130,452,0.865900383141762
"8946",202763,"THE UNIVERSITY OF FINDLAY",1,0,2000,684,399,285,257,87,170,0.426,0.376,0.305,15830,47.076375,145,603,0.881578947368421
"8947",202763,"THE UNIVERSITY OF FINDLAY",1,0,2001,613,377,236,255,69,186,0.493,0.416,0.292,17088,51.111684,160,537,0.876019575856444
"8948",202763,"THE UNIVERSITY OF FINDLAY",1,0,2002,651,386,265,276,98,178,0.461,0.424,0.37,18114,54.38298,157,571,0.877112135176651
"8949",202763,"THE UNIVERSITY OF FINDLAY",1,0,2003,671,441,230,260,72,188,0.426,0.387,0.313,19052,56.007203,154,569,0.847988077496274
"8950",202763,"THE UNIVERSITY OF FINDLAY",1,0,2004,580,387,193,248,60,188,0.486,0.428,0.311,19996,59.50477,164,517,0.891379310344828
"8951",202763,"The University of Findlay",1,0,2005,584,399,185,240,64,176,0.441,0.411,0.346,20796,57.794716,164,537,0.919520547945205
"8952",202763,"The University of Findlay",1,0,2006,616,441,175,243,58,185,0.42,0.394,0.331,21836,61.385756,176,541,0.878246753246753
"8953",202763,"The University of Findlay",1,0,2007,594,416,178,258,53,205,0.493,0.434,0.298,22906,66.586782,190,535,0.900673400673401
"8954",202763,"The University of Findlay",1,0,2008,562,391,171,242,56,186,0.476,0.431,0.327,23938,70.801046,192,504,0.896797153024911
"8955",202763,"The University of Findlay",1,0,2009,565,398,167,251,51,200,0.503,0.444,0.305,25016,72.921968,194,461,0.815929203539823
"8956",202763,"The University of Findlay",1,0,2010,659,461,198,338,95,243,0.527,0.513,0.48,26016,72.868861,201,585,0.887708649468892
"8957",203085,"HEIDELBERG COLLEGE",1,0,1991,252,100,152,100,56,44,0.44,0.397,0.368,11680,14.739912,70,236,0.936507936507937
"8958",203085,"HEIDELBERG COLLEGE",1,0,1992,229,88,141,86,46,40,0.454,0.376,0.326,12380,16.568755,70,203,0.88646288209607
"8959",203085,"HEIDELBERG COLLEGE",1,0,1993,217,105,112,86,38,48,0.457,0.396,0.339,13000,19.110902,68,204,0.940092165898618
"8960",203085,"HEIDELBERG COLLEGE",1,0,1995,220,87,133,94,46,48,0.552,0.427,0.346,14606,20.385018,70,208,0.945454545454545
"8961",203085,"HEIDELBERG COLLEGE",1,0,1996,303,141,162,141,68,73,0.518,0.465,0.42,15140,21.688976,66,273,0.900990099009901
"8962",203085,"HEIDELBERG COLLEGE",1,0,1997,264,114,150,127,58,69,0.605,0.481,0.387,15594,17.874275,65,249,0.943181818181818
"8963",203085,"HEIDELBERG COLLEGE",1,0,1998,290,138,152,130,54,76,0.551,0.448,0.355,16100,19.071604,71,274,0.944827586206897
"8964",203085,"HEIDELBERG COLLEGE",1,0,1999,259,98,161,124,61,63,0.643,0.479,0.379,16422,19.493955,70,246,0.94980694980695
"8965",203085,"HEIDELBERG COLLEGE",1,0,2000,277,137,140,121,39,82,0.599,0.437,0.279,16998,20.107683,71.5,255,0.92057761732852
"8966",203085,"HEIDELBERG COLLEGE",1,0,2001,262,119,143,113,38,75,0.63,0.431,0.266,17848,21.871967,73,228,0.870229007633588
"8967",203085,"HEIDELBERG COLLEGE",1,0,2002,278,160,118,103,34,69,0.431,0.371,0.288,12850,21.96894,72,252,0.906474820143885
"8968",203085,"HEIDELBERG COLLEGE",1,0,2003,298,142,156,116,43,73,0.514,0.389,0.276,13620,22.434477,62,264,0.885906040268456
"8969",203085,"HEIDELBERG COLLEGE",1,0,2004,354,159,195,132,47,85,0.535,0.373,0.241,14574,22.801973,64,318,0.898305084745763
"8970",203085,"Heidelberg College",1,0,2005,324,135,189,174,85,89,0.659,0.537,0.45,15740,25.387721,60,283,0.873456790123457
"8971",203085,"Heidelberg College",1,0,2006,267,131,136,105,38,67,0.511,0.393,0.279,17000,27.395647,58,214,0.801498127340824
"8972",203085,"Heidelberg College",1,0,2007,369,149,220,130,64,66,0.443,0.352,0.291,18190,25.729547,60,297,0.804878048780488
"8973",203085,"Heidelberg University",1,0,2008,402,177,225,142,61,81,0.458,0.353,0.271,19464,27.721929,62,313,0.778606965174129
"8974",203085,"Heidelberg University",1,0,2009,375,168,207,118,48,70,0.417,0.315,0.232,20826,28.32879,65,279,0.744
"8975",203085,"Heidelberg University",1,0,2010,334,158,176,137,57,80,0.506,0.41,0.324,22242,28.270597,65,258,0.772455089820359
"8976",203128,"HIRAM COLLEGE",0,1,1991,287,148,139,159,69,90,0.608,0.554,0.496,11950,21.657528,80,255,0.888501742160279
"8977",203128,"HIRAM COLLEGE",0,1,1992,277,134,143,116,116,0,0,0.419,0.811,12897,23.514741,79,253,0.913357400722022
"8978",203128,"HIRAM COLLEGE",0,1,1993,263,127,136,134,64,70,0.551,0.51,0.471,13665,25.476797,81,231,0.878326996197719
"8979",203128,"HIRAM COLLEGE",0,1,1995,217,119,98,124,47,77,0.647,0.571,0.48,15270,26.178795,69,180,0.829493087557604
"8980",203128,"HIRAM COLLEGE",1,0,1996,232,129,103,144,60,84,0.651,0.621,0.583,15600,27.372476,68,194,0.836206896551724
"8981",203128,"HIRAM COLLEGE",1,0,1997,240,123,117,136,54,82,0.667,0.567,0.462,16224,20.958958,68,199,0.829166666666667
"8982",203128,"HIRAM COLLEGE",1,0,1998,231,106,125,137,63,74,0.698,0.593,0.504,17010,27.90189,68,200,0.865800865800866
"8983",203128,"HIRAM COLLEGE",1,0,1999,279,143,136,153,64,89,0.622,0.548,0.471,17230,29.6567,65,241,0.863799283154122
"8984",203128,"HIRAM COLLEGE",1,0,2000,244,139,105,128,54,74,0.532,0.525,0.514,17870,24.528704,69,214,0.877049180327869
"8985",203128,"HIRAM COLLEGE",1,0,2001,269,157,112,149,52,97,0.618,0.554,0.464,18720,24.707126,73,221,0.821561338289963
"8986",203128,"HIRAM COLLEGE",1,0,2002,233,126,107,132,52,80,0.635,0.567,0.486,19650,26.315148,75,191,0.819742489270386
"8987",203128,"HIRAM COLLEGE",1,0,2003,236,127,109,151,59,92,0.724,0.64,0.541,20440,27.490416,72,194,0.822033898305085
"8988",203128,"HIRAM COLLEGE",1,0,2004,220,106,114,137,62,75,0.708,0.623,0.544,21533,27.936993,74,154,0.7
"8989",203128,"Hiram College",1,0,2005,208,101,107,125,57,68,0.673,0.601,0.533,23510,27.037615,64,161,0.774038461538462
"8990",203128,"Hiram College",1,0,2006,298,143,155,174,80,94,0.657,0.584,0.516,23510,26.354671,60,176,0.590604026845638
"8991",203128,"Hiram College",1,0,2007,333,184,149,199,77,122,0.663,0.598,0.517,24215,29.442872,68,229,0.687687687687688
"8992",203128,"Hiram College",1,0,2008,331,164,167,189,82,107,0.652,0.571,0.491,24940,32.977497,74,230,0.694864048338369
"8993",203128,"Hiram College",1,0,2009,293,143,150,154,74,80,0.559,0.526,0.493,26435,34.928089,79,223,0.761092150170648
"8994",203128,"Hiram College",1,0,2010,295,157,138,160,65,95,0.605,0.542,0.471,26435,34.201104,78,215,0.728813559322034
"8995",203368,"JOHN CARROLL UNIVERSITY",1,0,1991,765,386,379,465,212,253,0.655,0.608,0.559,9600,50.561079,201,692,0.904575163398693
"8996",203368,"JOHN CARROLL UNIVERSITY",1,0,1992,748,395,353,452,184,268,0.678,0.604,0.521,10440,56.883175,199,685,0.915775401069519
"8997",203368,"JOHN CARROLL UNIVERSITY",1,0,1993,813,422,391,487,216,271,0.642,0.599,0.552,11060,58.673433,203,746,0.917589175891759
"8998",203368,"JOHN CARROLL UNIVERSITY",1,0,1995,844,424,420,587,257,330,0.778,0.695,0.612,12390,64.423106,223,784,0.928909952606635
"8999",203368,"JOHN CARROLL UNIVERSITY",1,0,1996,775,425,350,483,201,282,0.663,0.623,0.574,13122,71.673132,225,712,0.918709677419355
"9000",203368,"JOHN CARROLL UNIVERSITY",1,0,1997,790,408,382,495,217,278,0.681,0.627,0.568,13883,54.191108,222,728,0.921518987341772
"9001",203368,"JOHN CARROLL UNIVERSITY",1,0,1998,854,433,421,532,241,291,0.672,0.623,0.572,14670,57.038946,218,772,0.903981264637002
"9002",203368,"JOHN CARROLL UNIVERSITY",1,0,1999,833,451,382,539,204,335,0.743,0.647,0.534,15424,61.701434,221,756,0.907563025210084
"9003",203368,"JOHN CARROLL UNIVERSITY",1,0,2000,830,467,363,543,214,329,0.705,0.654,0.59,16334,62.549053,227.5,750,0.903614457831325
"9004",203368,"JOHN CARROLL UNIVERSITY",1,0,2001,789,442,347,515,219,296,0.67,0.653,0.631,17478,66.643259,234,711,0.901140684410646
"9005",203368,"JOHN CARROLL UNIVERSITY",1,0,2002,843,456,387,599,256,343,0.752,0.711,0.661,18832,75.846246,239,763,0.905100830367734
"9006",203368,"JOHN CARROLL UNIVERSITY",1,0,2003,859,453,406,543,226,317,0.7,0.632,0.557,20566,79.141032,237,760,0.884749708963911
"9007",203368,"JOHN CARROLL UNIVERSITY",1,0,2004,734,383,351,466,207,259,0.676,0.635,0.59,22108,85.779373,226,641,0.873297002724796
"9008",203368,"John Carroll University",1,0,2005,786,401,385,504,217,287,0.716,0.641,0.564,23380,85.587749,222,663,0.843511450381679
"9009",203368,"John Carroll University",1,0,2006,712,385,327,469,205,264,0.686,0.659,0.627,24782,87.923854,209,604,0.848314606741573
"9010",203368,"John Carroll University",1,0,2007,720,358,362,471,216,255,0.712,0.654,0.597,26144,88.314974,207,561,0.779166666666667
"9011",203368,"John Carroll University",1,0,2008,789,393,396,473,209,264,0.672,0.599,0.528,27190,87.602274,200,580,0.73510773130545
"9012",203368,"John Carroll University",1,0,2009,660,335,325,373,163,210,0.627,0.565,0.502,27940,86.213719,206,561,0.85
"9013",203368,"John Carroll University",1,0,2010,703,380,323,460,189,271,0.713,0.654,0.585,29250,82.475659,199,553,0.786628733997155
"9014",203517,"KENT STATE UNIVERSITY MAIN CAMPUS",1,0,1991,2692,1609,1083,579,168,411,0.255,0.215,0.155,3300,222.56641,721,2415,0.897102526002972
"9015",203517,"KENT STATE UNIVERSITY MAIN CAMPUS",1,0,1992,2581,1580,1001,508,135,373,0.236,0.197,0.135,3596,232.61076,727,2302,0.891902363425029
"9016",203517,"KENT STATE UNIVERSITY-MAIN CAMPUS",1,0,1993,2371,1476,895,540,163,377,0.255,0.228,0.182,3740,223.922499,682,2093,0.882749894559258
"9017",203517,"KENT STATE UNIVERSITY-MAIN CAMPUS",1,0,1995,2623,1580,1043,353,85,268,0.17,0.135,0.081,4084,229.005329,641,2319,0.884102173084255
"9018",203517,"KENT STATE UNIVERSITY-MAIN CAMPUS",1,0,1996,2600,1516,1084,448,150,298,0.197,0.172,0.138,4288,243.70468,637,2307,0.887307692307692
"9019",203517,"KENT STATE UNIVERSITY-MAIN CAMPUS",1,0,1997,2573,1524,1049,508,173,335,0.22,0.197,0.165,4460,250.16862,663,2252,0.87524290711232
"9020",203517,"KENT STATE UNIVERSITY-MAIN CAMPUS",1,0,1998,3019,1867,1152,491,154,337,0.181,0.163,0.134,4660,256.226797,689,2622,0.868499503146737
"9021",203517,"KENT STATE UNIVERSITY-MAIN CAMPUS",1,0,1999,3476,2160,1316,668,187,481,0.223,0.192,0.142,4011,271.345697,654,2974,0.855581127733026
"9022",203517,"KENT STATE UNIVERSITY-MAIN CAMPUS",1,0,2000,3556,2184,1372,748,226,522,0.239,0.21,0.165,4234,287.979731,664,3054,0.858830146231721
"9023",203517,"KENT STATE UNIVERSITY-MAIN CAMPUS",1,0,2001,3588,2202,1386,556,158,398,0.181,0.155,0.114,4490,307.953095,674,3137,0.874303232998885
"9024",203517,"KENT STATE UNIVERSITY-MAIN CAMPUS",1,0,2002,3640,2232,1408,892,283,609,0.273,0.245,0.201,6374,328.094253,763,3148,0.864835164835165
"9025",203517,"KENT STATE UNIVERSITY-MAIN CAMPUS",1,0,2003,3746,2293,1453,895,266,629,0.274,0.239,0.183,6882,358.492161,823,3153,0.841697810998398
"9026",203517,"KENT STATE UNIVERSITY-MAIN CAMPUS",1,0,2004,3841,2428,1413,969,271,698,0.288,0.252,0.192,7504,363.656051,792,3278,0.853423587607394
"9027",203517,"Kent State University-Kent Campus",1,0,2005,3727,2325,1402,970,294,676,0.291,0.26,0.21,7954,366.668959,841,3089,0.828816742688489
"9028",203517,"Kent State University-Kent Campus",1,0,2006,3610,2214,1396,977,295,682,0.308,0.271,0.211,8430,392.976,856,2921,0.809141274238227
"9029",203517,"Kent State University-Kent Campus",1,0,2007,3729,2300,1429,1031,308,723,0.314,0.276,0.216,8430,402.740936,877,2984,0.800214534727809
"9030",203517,"Kent State University Kent Campus",1,0,2008,3684,2261,1423,1135,325,810,0.358,0.308,0.228,8430,450.252602,901,3039,0.824918566775244
"9031",203517,"Kent State University Kent Campus",1,0,2009,4003,2437,1566,1298,400,898,0.368,0.324,0.255,8726,475.696188,886,3238,0.808893330002498
"9032",203517,"Kent State University at Kent",1,0,2010,3887,2325,1562,1243,396,847,0.364,0.32,0.254,9030,600.698,885,2931,0.754051968098791
"9033",203535,"KENYON COLLEGE",1,0,1991,420,218,202,347,167,180,0.826,0.826,0.827,16050,36.114286,125,367,0.873809523809524
"9034",203535,"KENYON COLLEGE",1,0,1992,413,218,195,319,147,172,0.789,0.772,0.754,17060,37.904443,123,363,0.878934624697337
"9035",203535,"KENYON COLLEGE",1,0,1993,408,231,177,316,129,187,0.809,0.775,0.729,18140,40.469438,131,348,0.852941176470588
"9036",203535,"KENYON COLLEGE",1,0,1995,438,223,215,350,161,189,0.848,0.799,0.749,20270,46.032921,122,380,0.867579908675799
"9037",203535,"KENYON COLLEGE",1,0,1996,423,238,185,338,147,191,0.802,0.799,0.795,21370,47.464688,140,375,0.886524822695035
"9038",203535,"KENYON COLLEGE",1,0,1997,441,255,186,349,143,206,0.808,0.791,0.769,22200,39.637349,127,394,0.893424036281179
"9039",203535,"KENYON COLLEGE",1,0,1998,451,252,199,369,156,213,0.845,0.818,0.784,22990,41.213893,131,397,0.880266075388027
"9040",203535,"KENYON COLLEGE",1,0,1999,459,255,204,367,166,201,0.788,0.8,0.814,23900,44.52169,141,403,0.877995642701525
"9041",203535,"KENYON COLLEGE",1,0,2000,436,227,209,371,168,203,0.894,0.851,0.804,25370,48.524044,141.5,351,0.805045871559633
"9042",203535,"KENYON COLLEGE",1,0,2001,424,243,181,344,149,195,0.802,0.811,0.823,26800,53.822308,142,347,0.818396226415094
"9043",203535,"KENYON COLLEGE",1,0,2002,440,246,194,376,158,218,0.886,0.855,0.814,27900,57.746688,148,381,0.865909090909091
"9044",203535,"KENYON COLLEGE",1,0,2003,453,247,206,386,176,210,0.85,0.852,0.854,29500,61.13251,151,387,0.854304635761589
"9045",203535,"KENYON COLLEGE",1,0,2004,467,237,230,396,189,207,0.873,0.848,0.822,31260,63.140196,146,375,0.802997858672377
"9046",203535,"Kenyon College",1,0,2005,439,239,200,364,165,199,0.833,0.829,0.825,32980,63.834866,151,372,0.847380410022779
"9047",203535,"Kenyon College",1,0,2006,457,226,231,397,190,207,0.916,0.869,0.823,34990,75.924818,153,370,0.809628008752735
"9048",203535,"Kenyon College",1,0,2007,458,249,209,395,175,220,0.883,0.862,0.837,37030,78.13954,152,366,0.799126637554585
"9049",203535,"Kenyon College",1,0,2008,455,237,218,404,192,212,0.895,0.888,0.881,39080,82.499636,159,360,0.791208791208791
"9050",203535,"Kenyon College",1,0,2009,468,248,220,393,176,217,0.875,0.84,0.8,39810,84.769192,156,355,0.758547008547009
"9051",203535,"Kenyon College",1,0,2010,483,265,218,429,191,238,0.898,0.888,0.876,39420,85.218598,159,395,0.817805383022774
"9052",203580,"LAKE ERIE COLLEGE",1,0,1991,61,49,12,18,3,15,0.306,0.295,0.25,8480,7.349585,27,59,0.967213114754098
"9053",203580,"LAKE ERIE COLLEGE",1,0,1992,36,29,7,14,1,13,0.448,0.389,0.143,8960,8.18,30,35,0.972222222222222
"9054",203580,"LAKE ERIE COLLEGE",1,0,1993,51,39,12,12,1,11,0.282,0.235,0.083,9600,6.884,29,47,0.92156862745098
"9055",203580,"LAKE ERIE COLLEGE",1,0,1995,66,50,16,26,5,21,0.42,0.394,0.312,12320,8.396,32,61,0.924242424242424
"9056",203580,"LAKE ERIE COLLEGE",1,0,1996,61,44,17,32,10,22,0.5,0.525,0.588,12950,8.553,29,56,0.918032786885246
"9057",203580,"LAKE ERIE COLLEGE",1,0,1997,70,47,23,29,13,16,0.34,0.414,0.565,13750,7.045488,27,64,0.914285714285714
"9058",203580,"LAKE ERIE COLLEGE",1,0,1998,68,62,6,32,3,29,0.468,0.471,0.5,14298,8.067466,27,65,0.955882352941177
"9059",203580,"LAKE ERIE COLLEGE",1,0,1999,103,70,33,36,8,28,0.4,0.35,0.242,14280,8.416791,28,87,0.844660194174757
"9060",203580,"LAKE ERIE COLLEGE",1,0,2000,86,63,23,26,6,20,0.318,0.302,0.261,15140,9.108464,30,79,0.918604651162791
"9061",203580,"LAKE ERIE COLLEGE",1,0,2001,127,98,29,46,7,39,0.398,0.362,0.241,15750,10.160394,32,103,0.811023622047244
"9062",203580,"LAKE ERIE COLLEGE",1,0,2002,133,102,31,38,4,34,0.333,0.286,0.129,16370,11.507228,37,113,0.849624060150376
"9063",203580,"LAKE ERIE COLLEGE",1,0,2003,120,86,34,41,13,28,0.326,0.342,0.382,16880,12.262836,35,95,0.791666666666667
"9064",203580,"LAKE ERIE COLLEGE",1,0,2004,141,104,37,48,10,38,0.365,0.34,0.27,17724,12.506951,37,115,0.815602836879433
"9065",203580,"Lake Erie College",1,0,2005,116,88,28,49,8,41,0.466,0.422,0.286,20500,13.920016,32,94,0.810344827586207
"9066",203580,"Lake Erie College",1,0,2006,131,89,42,48,13,35,0.393,0.366,0.31,21936,14.327006,36,112,0.854961832061069
"9067",203580,"Lake Erie College",1,0,2007,237,108,129,66,21,45,0.417,0.278,0.163,22814,16.732008,36,194,0.818565400843882
"9068",203580,"Lake Erie College",1,0,2008,249,131,118,91,29,62,0.473,0.365,0.246,23950,19.931577,45,206,0.827309236947791
"9069",203580,"Lake Erie College",1,0,2009,263,127,136,95,44,51,0.402,0.361,0.324,23950,24.082135,45,201,0.76425855513308
"9070",203580,"Lake Erie College",1,0,2010,256,123,133,78,28,50,0.406,0.305,0.211,24308,23.359666,46,204,0.796875
"9071",203775,"MALONE COLLEGE",1,0,1991,312,206,106,89,21,68,0.33,0.285,0.198,7860,13.327146,68,297,0.951923076923077
"9072",203775,"MALONE COLLEGE",1,0,1992,363,236,127,114,33,81,0.343,0.314,0.26,8490,15.846216,69,352,0.96969696969697
"9073",203775,"MALONE COLLEGE",1,0,1993,427,218,209,110,34,76,0.349,0.258,0.163,9172,17.342333,70,392,0.918032786885246
"9074",203775,"MALONE COLLEGE",1,0,1995,408,261,147,131,39,92,0.352,0.321,0.265,10345,21.74768,83,390,0.955882352941177
"9075",203775,"MALONE COLLEGE",1,0,1996,400,234,166,141,41,100,0.427,0.352,0.247,10765,26.695728,85,384,0.96
"9076",203775,"MALONE COLLEGE",1,0,1997,464,293,171,208,73,135,0.461,0.448,0.427,11280,14.698843,89,446,0.961206896551724
"9077",203775,"MALONE COLLEGE",1,0,1998,398,235,163,153,56,97,0.413,0.384,0.344,11795,19.202775,93,378,0.949748743718593
"9078",203775,"MALONE COLLEGE",1,0,1999,406,248,158,160,47,113,0.456,0.394,0.297,12150,21.068317,99,388,0.955665024630542
"9079",203775,"MALONE COLLEGE",1,0,2000,388,240,148,157,49,108,0.45,0.405,0.331,12800,23.037292,101,371,0.956185567010309
"9080",203775,"MALONE COLLEGE",1,0,2001,355,214,141,145,46,99,0.463,0.408,0.326,13310,23.897171,103,335,0.943661971830986
"9081",203775,"MALONE COLLEGE",1,0,2002,348,219,129,148,54,94,0.429,0.425,0.419,13910,25.507162,100,329,0.945402298850575
"9082",203775,"MALONE COLLEGE",1,0,2003,389,238,151,173,48,125,0.525,0.445,0.318,14745,25.965578,99,369,0.948586118251928
"9083",203775,"MALONE COLLEGE",1,0,2004,400,239,161,181,53,128,0.536,0.452,0.329,15630,27.025013,104,379,0.9475
"9084",203775,"Malone College",1,0,2005,357,199,158,165,61,104,0.523,0.462,0.386,16530,28.865687,105,323,0.904761904761905
"9085",203775,"Malone College",1,0,2006,341,208,133,159,58,101,0.486,0.466,0.436,17520,30.792719,108,315,0.92375366568915
"9086",203775,"Malone College",1,0,2007,387,235,152,177,58,119,0.506,0.457,0.382,18600,32.998553,108,365,0.943152454780362
"9087",203775,"Malone University",1,0,2008,389,233,156,147,44,103,0.442,0.378,0.282,19740,35.395562,110,364,0.93573264781491
"9088",203775,"Malone University",1,0,2009,477,275,202,230,80,150,0.545,0.482,0.396,20730,38.197102,110,432,0.905660377358491
"9089",203775,"Malone University",1,0,2010,375,196,179,167,68,99,0.505,0.445,0.38,21954,39.131812,107,330,0.88
"9090",203845,"MARIETTA COLLEGE",1,0,1991,215,108,107,102,41,61,0.565,0.474,0.383,11800,20.074519,73,206,0.958139534883721
"9091",203845,"MARIETTA COLLEGE",1,0,1992,370,150,220,165,82,83,0.553,0.446,0.373,12370,21.779082,72,360,0.972972972972973
"9092",203845,"MARIETTA COLLEGE",1,0,1993,342,145,197,174,84,90,0.621,0.509,0.426,13170,21.287665,69,324,0.947368421052632
"9093",203845,"MARIETTA COLLEGE",1,0,1995,292,120,172,124,51,73,0.608,0.425,0.297,14850,25.206353,71,231,0.791095890410959
"9094",203845,"MARIETTA COLLEGE",1,0,1996,271,111,160,110,50,60,0.54,0.406,0.312,15490,25.738121,71,239,0.881918819188192
"9095",203845,"MARIETTA COLLEGE",1,0,1997,331,163,168,157,72,85,0.521,0.474,0.429,15950,22.07927,71,284,0.858006042296072
"9096",203845,"MARIETTA COLLEGE",1,0,1998,338,177,161,146,46,100,0.565,0.432,0.286,16790,22.981899,73,294,0.869822485207101
"9097",203845,"MARIETTA COLLEGE",1,0,1999,302,136,166,149,70,79,0.581,0.493,0.422,17310,23.876858,75,244,0.80794701986755
"9098",203845,"MARIETTA COLLEGE",1,0,2000,303,141,162,154,75,79,0.56,0.508,0.463,18010,24.638029,76,262,0.864686468646865
"9099",203845,"MARIETTA COLLEGE",1,0,2001,362,151,211,164,77,87,0.576,0.453,0.365,18838,25.556049,77,300,0.828729281767956
"9100",203845,"MARIETTA COLLEGE",1,0,2002,263,129,134,120,49,71,0.55,0.456,0.366,19762,26.963981,76,231,0.878326996197719
"9101",203845,"MARIETTA COLLEGE",1,0,2003,376,168,208,160,70,90,0.536,0.426,0.337,20356,28.22678,78,328,0.872340425531915
"9102",203845,"MARIETTA COLLEGE",1,0,2004,439,215,224,200,78,122,0.567,0.456,0.348,21170,29.897823,94,365,0.831435079726651
"9103",203845,"Marietta College",1,0,2005,387,179,208,162,68,94,0.525,0.419,0.327,22070,31.905607,96,309,0.798449612403101
"9104",203845,"Marietta College",1,0,2006,385,191,194,206,83,123,0.644,0.535,0.428,23200,33.939295,94,315,0.818181818181818
"9105",203845,"Marietta College",1,0,2007,415,201,214,182,75,107,0.532,0.439,0.35,24220,36.53662,97,308,0.742168674698795
"9106",203845,"Marietta College",1,0,2008,385,178,207,201,95,106,0.596,0.522,0.459,25430,39.105535,103,308,0.8
"9107",203845,"Marietta College",1,0,2009,386,178,208,218,109,109,0.612,0.565,0.524,26386,42.377923,104,290,0.751295336787565
"9108",203845,"Marietta College",1,0,2010,387,191,196,199,85,114,0.597,0.514,0.434,27640,41.597312,108,276,0.713178294573643
"9109",204024,"MIAMI UNIVERSITY OXFORD CAMPUS",1,0,1991,3241,1858,1383,2040,736,1304,0.702,0.629,0.532,3692,185.866635,769,3053,0.941993211971614
"9110",204024,"MIAMI UNIVERSITY OXFORD CAMPUS",1,0,1992,2985,1653,1332,1815,700,1115,0.674,0.608,0.526,4024,198.405828,750,2779,0.930988274706868
"9111",204024,"MIAMI UNIVERSITY-OXFORD",1,0,1993,3264,1782,1482,1948,739,1209,0.678,0.597,0.499,4226,200.940949,763,3021,0.925551470588235
"9112",204024,"MIAMI UNIVERSITY-OXFORD",1,0,1995,3211,1817,1394,1990,750,1240,0.682,0.62,0.538,4810,216.603573,766,2896,0.901899719713485
"9113",204024,"MIAMI UNIVERSITY-OXFORD",1,0,1996,3342,1935,1407,2180,798,1382,0.714,0.652,0.567,5158,233.67457,756,2984,0.892878515858767
"9114",204024,"MIAMI UNIVERSITY-OXFORD",1,0,1997,3379,1914,1465,2180,855,1325,0.692,0.645,0.584,5466,249.479193,750,3039,0.899378514353359
"9115",204024,"MIAMI UNIVERSITY-OXFORD",1,0,1998,3332,1904,1428,2182,856,1326,0.696,0.655,0.599,5786,266.171757,767,2983,0.895258103241297
"9116",204024,"MIAMI UNIVERSITY-OXFORD",1,0,1999,3588,2030,1558,2351,922,1429,0.704,0.655,0.592,5052,276.516992,772,3185,0.88768115942029
"9117",204024,"MIAMI UNIVERSITY-OXFORD",1,0,2000,3359,1947,1412,2271,870,1401,0.72,0.676,0.616,5358,302.333377,793,2973,0.88508484668056
"9118",204024,"MIAMI UNIVERSITY-OXFORD",1,0,2001,3440,1922,1518,2305,905,1400,0.728,0.67,0.596,5796,326.584451,814,3005,0.873546511627907
"9119",204024,"MIAMI UNIVERSITY-OXFORD",1,0,2002,3614,1998,1616,2461,1008,1453,0.727,0.681,0.624,6386,348.796873,807,3168,0.876591034864416
"9120",204024,"MIAMI UNIVERSITY-OXFORD",1,0,2003,3362,1844,1518,2371,1002,1369,0.742,0.705,0.66,7019,369.639274,825,2927,0.870612730517549
"9121",204024,"MIAMI UNIVERSITY-OXFORD",1,0,2004,3475,1950,1525,2354,961,1393,0.714,0.677,0.63,18236,393.407718,849,2900,0.834532374100719
"9122",204024,"Miami University-Oxford",1,0,2005,3150,1708,1442,2198,902,1296,0.759,0.698,0.626,19877,421.399202,832,2679,0.85047619047619
"9123",204024,"Miami University-Oxford",1,0,2006,3630,2017,1613,2472,1010,1462,0.725,0.681,0.626,20991,451.402651,813,3155,0.869146005509642
"9124",204024,"Miami University-Oxford",1,0,2007,3456,1902,1554,2359,968,1391,0.731,0.683,0.623,8443,481.273761,828,2985,0.863715277777778
"9125",204024,"Miami University-Oxford",1,0,2008,3598,1955,1643,2357,959,1398,0.715,0.655,0.584,8178,459.923777,867,3052,0.848249027237354
"9126",204024,"Miami University-Oxford",1,0,2009,3219,1745,1474,2104,855,1249,0.716,0.654,0.58,10122,479.890319,827,2686,0.834420627524076
"9127",204024,"Miami University-Oxford",1,0,2010,3574,1944,1630,2368,969,1399,0.72,0.663,0.594,10427,509.61079,850,3029,0.847509792949077
"9128",204185,"MOUNT UNION COLLEGE",1,0,1991,417,194,223,189,80,109,0.562,0.453,0.359,11320,23.470421,79,374,0.896882494004796
"9129",204185,"MOUNT UNION COLLEGE",1,0,1992,380,178,202,170,73,97,0.545,0.447,0.361,11200,23.909799,79,340,0.894736842105263
"9130",204185,"MOUNT UNION COLLEGE",1,0,1993,396,194,202,197,89,108,0.557,0.497,0.441,12320,24.891769,78,370,0.934343434343434
"9131",204185,"MOUNT UNION COLLEGE",1,0,1995,478,229,249,248,107,141,0.616,0.519,0.43,13480,29.148048,85,445,0.930962343096234
"9132",204185,"MOUNT UNION COLLEGE",1,0,1996,483,217,266,254,113,141,0.65,0.526,0.425,13880,31.711685,90,451,0.933747412008282
"9133",204185,"MOUNT UNION COLLEGE",1,0,1997,540,297,243,306,113,193,0.65,0.567,0.465,14290,24.872686,98,517,0.957407407407407
"9134",204185,"MOUNT UNION COLLEGE",1,0,1998,568,289,279,318,116,202,0.699,0.56,0.416,14480,26.059414,105,533,0.938380281690141
"9135",204185,"MOUNT UNION COLLEGE",1,0,1999,601,323,278,292,86,206,0.638,0.486,0.309,14080,28.418511,111,545,0.906821963394343
"9136",204185,"MOUNT UNION COLLEGE",1,0,2000,555,315,240,277,93,184,0.584,0.499,0.388,14720,30.149081,115.5,516,0.92972972972973
"9137",204185,"MOUNT UNION COLLEGE",1,0,2001,591,329,262,298,89,209,0.635,0.504,0.34,15440,33.738107,120,548,0.927241962774958
"9138",204185,"MOUNT UNION COLLEGE",1,0,2002,579,299,280,299,115,184,0.615,0.516,0.411,16240,34.727948,126,511,0.882556131260794
"9139",204185,"MOUNT UNION COLLEGE",1,0,2003,579,276,303,287,114,173,0.627,0.496,0.376,16900,37.732891,128,548,0.946459412780656
"9140",204185,"MOUNT UNION COLLEGE",1,0,2004,547,256,291,292,128,164,0.641,0.534,0.44,18560,40.426061,128,486,0.888482632541133
"9141",204185,"Mount Union College",1,0,2005,503,260,243,274,104,170,0.654,0.545,0.428,19600,43.36226,123,458,0.910536779324056
"9142",204185,"Mount Union College",1,0,2006,636,284,352,343,149,194,0.683,0.539,0.423,20720,41.895264,124,548,0.861635220125786
"9143",204185,"Mount Union College",1,0,2007,593,282,311,316,130,186,0.66,0.533,0.418,21800,43.390522,125,502,0.846543001686341
"9144",204185,"Mount Union College",1,0,2008,663,321,342,336,126,210,0.654,0.507,0.368,22870,44.263843,125,539,0.812971342383107
"9145",204185,"Mount Union College",1,0,2009,578,286,292,315,124,191,0.668,0.545,0.425,23630,47.949536,124,464,0.802768166089965
"9146",204185,"University of Mount Union",1,0,2010,630,261,369,333,151,182,0.697,0.529,0.409,24500,48.993982,126,523,0.83015873015873
"9147",204194,"MOUNT VERNON NAZARENE COLLEGE",1,0,1991,231,145,86,82,31,51,0.352,0.355,0.36,5750,11.606392,57,222,0.961038961038961
"9148",204194,"MOUNT VERNON NAZARENE COLLEGE",1,0,1992,283,168,115,86,36,50,0.298,0.304,0.313,6230,12.690462,55,274,0.968197879858657
"9149",204194,"MOUNT VERNON NAZARENE COLLEGE",1,0,1993,335,201,134,108,35,73,0.363,0.322,0.261,7190,14.036023,51,330,0.985074626865672
"9150",204194,"MOUNT VERNON NAZARENE COLLEGE",1,0,1995,379,228,151,121,51,70,0.307,0.319,0.338,8590,18.251949,61,366,0.965699208443272
"9151",204194,"MOUNT VERNON NAZARENE COLLEGE",1,0,1996,407,252,155,154,43,111,0.44,0.378,0.277,9240,21.350696,67,388,0.953316953316953
"9152",204194,"MOUNT VERNON NAZARENE COLLEGE",1,0,1997,333,195,138,119,45,74,0.38,0.357,0.326,9430,20.274893,66,325,0.975975975975976
"9153",204194,"MOUNT VERNON NAZARENE COLLEGE",1,0,1998,345,205,140,141,44,97,0.473,0.409,0.314,10124,21.00088,66,335,0.971014492753623
"9154",204194,"MOUNT VERNON NAZARENE COLLEGE",1,0,1999,393,231,162,145,49,96,0.416,0.369,0.302,10792,22.495438,74,375,0.954198473282443
"9155",204194,"MOUNT VERNON NAZARENE COLLEGE",1,0,2000,365,228,137,139,39,100,0.439,0.381,0.285,11468,24.389932,72.5,343,0.93972602739726
"9156",204194,"MOUNT VERNON NAZARENE COLLEGE",1,0,2001,321,176,145,110,34,76,0.432,0.343,0.234,12122,27.162993,71,310,0.965732087227414
"9157",204194,"MOUNT VERNON NAZARENE UNIVERSITY",1,0,2002,332,203,129,129,48,81,0.399,0.389,0.372,12810,28.568318,72,315,0.948795180722892
"9158",204194,"MOUNT VERNON NAZARENE UNIVERSITY",1,0,2003,373,221,152,137,51,86,0.389,0.367,0.336,13794,30.455076,87,357,0.957104557640751
"9159",204194,"MOUNT VERNON NAZARENE UNIVERSITY",1,0,2004,303,184,119,130,44,86,0.467,0.429,0.37,14482,32.165633,90,292,0.963696369636964
"9160",204194,"Mount Vernon Nazarene University",1,0,2005,380,241,139,149,49,100,0.415,0.392,0.353,15384,34.499998,101,355,0.934210526315789
"9161",204194,"Mount Vernon Nazarene University",1,0,2006,346,201,145,160,66,94,0.468,0.462,0.455,16366,37.111769,112,324,0.936416184971098
"9162",204194,"Mount Vernon Nazarene University",1,0,2007,350,210,140,171,56,115,0.548,0.489,0.4,17544,38.172918,116,334,0.954285714285714
"9163",204194,"Mount Vernon Nazarene University",1,0,2008,368,234,134,183,66,117,0.5,0.497,0.493,18770,36.765004,119,348,0.945652173913043
"9164",204194,"Mount Vernon Nazarene University",1,0,2009,300,190,110,172,61,111,0.584,0.573,0.555,19730,38.989901,108,278,0.926666666666667
"9165",204194,"Mount Vernon Nazarene University",1,0,2010,388,240,148,217,83,134,0.558,0.559,0.561,20700,38.556466,106,355,0.914948453608247
"9166",204617,"OHIO DOMINICAN COLLEGE",1,0,1991,205,108,97,54,24,30,0.278,0.263,0.247,7020,11.239344,52,132,0.64390243902439
"9167",204617,"OHIO DOMINICAN COLLEGE",1,0,1992,208,121,87,56,19,37,0.306,0.269,0.218,7370,12.820227,53,141,0.677884615384615
"9168",204617,"OHIO DOMINICAN COLLEGE",1,0,1993,225,123,102,61,16,45,0.366,0.271,0.157,7730,13.858256,53,153,0.68
"9169",204617,"OHIO DOMINICAN COLLEGE",1,0,1995,172,110,62,46,12,34,0.309,0.267,0.194,8490,16.462636,57,119,0.691860465116279
"9170",204617,"OHIO DOMINICAN COLLEGE",1,0,1996,180,113,67,52,11,41,0.363,0.289,0.164,8910,15.397779,56,135,0.75
"9171",204617,"OHIO DOMINICAN COLLEGE",1,0,1997,180,101,79,65,18,47,0.465,0.361,0.228,9350,14.984692,54,143,0.794444444444444
"9172",204617,"OHIO DOMINICAN COLLEGE",1,0,1998,184,118,66,73,18,55,0.466,0.397,0.273,9790,15.774291,57,142,0.771739130434783
"9173",204617,"OHIO DOMINICAN COLLEGE",1,0,1999,186,120,66,68,16,52,0.433,0.366,0.242,10250,16.992874,55,129,0.693548387096774
"9174",204617,"OHIO DOMINICAN COLLEGE",1,0,2000,179,118,61,48,15,33,0.28,0.268,0.246,10710,19.700807,57.5,120,0.670391061452514
"9175",204617,"OHIO DOMINICAN COLLEGE",1,0,2001,174,116,58,51,18,33,0.284,0.293,0.31,12530,21.209939,60,133,0.764367816091954
"9176",204617,"OHIO DOMINICAN UNIVERSITY",1,0,2002,251,163,88,94,34,60,0.368,0.375,0.386,16200,23.624202,61,199,0.792828685258964
"9177",204617,"OHIO DOMINICAN UNIVERSITY",1,0,2003,296,191,105,88,27,61,0.319,0.297,0.257,17200,25.709814,60,221,0.746621621621622
"9178",204617,"OHIO DOMINICAN UNIVERSITY",1,0,2004,415,202,213,143,57,86,0.426,0.345,0.268,18000,25.696196,64,349,0.840963855421687
"9179",204617,"Ohio Dominican University",1,0,2005,372,172,200,129,65,64,0.372,0.347,0.325,19400,27.358204,66,298,0.801075268817204
"9180",204617,"Ohio Dominican University",1,0,2006,354,177,177,107,51,56,0.316,0.302,0.288,20500,29.836325,70,258,0.728813559322034
"9181",204617,"Ohio Dominican University",1,0,2007,391,207,184,112,48,64,0.309,0.286,0.261,21720,30.749572,68,307,0.785166240409207
"9182",204617,"Ohio Dominican University",1,0,2008,356,194,162,113,49,64,0.33,0.317,0.302,22990,32.878649,72,266,0.747191011235955
"9183",204617,"Ohio Dominican University",1,0,2009,274,143,131,98,40,58,0.406,0.358,0.305,24116,34.862668,75,201,0.733576642335766
"9184",204617,"Ohio Dominican University",1,0,2010,272,146,126,78,30,48,0.329,0.287,0.238,24780,37.458282,74,163,0.599264705882353
"9185",204796,"OHIO STATE UNIVERSITY-MAIN CAMPUS",0,1,1991,5502,2705,2797,1061,375,686,0.254,0.193,0.134,2568,1182.441182,1960,4641,0.843511450381679
"9186",204796,"OHIO STATE UNIVERSITY-MAIN CAMPUS",0,1,1992,5389,2625,2764,1024,351,673,0.256,0.19,0.127,2799,1310.605399,1925,4458,0.827240675449991
"9187",204796,"OHIO STATE UNIVERSITY-MAIN CAMPUS",0,1,1993,5283,2710,2573,1074,371,703,0.259,0.203,0.144,2940,1291.432401,1922,4340,0.82150293393905
"9188",204796,"OHIO STATE UNIVERSITY-MAIN CAMPUS",0,1,1995,5788,2951,2837,1354,478,876,0.297,0.234,0.168,3273,1475.886784,1794,4696,0.811333794056669
"9189",204796,"OHIO STATE UNIVERSITY-MAIN CAMPUS",0,1,1996,6027,3018,3009,1526,565,961,0.318,0.253,0.188,3468,1449.156679,1853,4920,0.816326530612245
"9190",204796,"OHIO STATE UNIVERSITY-MAIN CAMPUS",0,1,1997,5897,3081,2816,1719,555,1164,0.378,0.292,0.197,3687,1488.25369,1979,4671,0.792097676784806
"9191",204796,"OHIO STATE UNIVERSITY-MAIN CAMPUS",0,1,1998,6151,3177,2974,1886,610,1276,0.402,0.307,0.205,3906,1634.147441,1946,4950,0.804747195577955
"9192",204796,"OHIO STATE UNIVERSITY-MAIN CAMPUS",0,1,1999,6067,3029,3038,2120,777,1343,0.443,0.349,0.256,3780,1720.01204,2075,4806,0.792154277237514
"9193",204796,"OHIO STATE UNIVERSITY-MAIN CAMPUS",0,1,2000,5831,3008,2823,2282,851,1431,0.476,0.391,0.301,4005,1953.264579,2044.5,4584,0.786143028640027
"9194",204796,"OHIO STATE UNIVERSITY-MAIN CAMPUS",0,1,2001,5955,2935,3020,2381,906,1475,0.503,0.4,0.3,4410,2060.759969,2014,4568,0.767086481947943
"9195",204796,"OHIO STATE UNIVERSITY-MAIN CAMPUS",0,1,2002,5936,2945,2991,2511,989,1522,0.517,0.423,0.331,5304,2240.293807,2006,4606,0.775943396226415
"9196",204796,"OHIO STATE UNIVERSITY-MAIN CAMPUS",0,1,2003,6347,3201,3146,2938,1132,1806,0.564,0.463,0.36,6228,2428.951409,2181,5067,0.798329919647077
"9197",204796,"OHIO STATE UNIVERSITY-MAIN CAMPUS",0,1,2004,6031,2891,3140,2930,1241,1689,0.584,0.486,0.395,7077,2722.321327,2178,4917,0.815287680318355
"9198",204796,"Ohio State University-Main Campus",0,1,2005,5929,3005,2924,3032,1219,1813,0.603,0.511,0.417,7509,3003.00159,2072,4783,0.806712767751729
"9199",204796,"Ohio State University-Main Campus",0,1,2006,6262,3104,3158,3295,1373,1922,0.619,0.526,0.435,7983,3285.884749,2158,5059,0.807888853401469
"9200",204796,"Ohio State University-Main Campus",0,1,2007,6155,3039,3116,3602,1534,2068,0.68,0.585,0.492,7983,3578.71934,2173,4978,0.808773354995938
"9201",204796,"Ohio State University-Main Campus",0,1,2008,6151,3068,3083,3780,1643,2137,0.697,0.615,0.533,7983,3827.289168,2167,4905,0.797431311981792
"9202",204796,"Ohio State University-Main Campus",0,1,2009,6724,3237,3487,3935,1699,2236,0.691,0.585,0.487,7983,3990.319458,2160,5297,0.787775133848899
"9203",204796,"Ohio State University-Main Campus",0,1,2010,6651,3319,3332,3907,1657,2250,0.678,0.587,0.497,8541,4240.565511,2133,4981,0.748909938355135
"9204",204857,"OHIO UNIVERSITY MAIN CAMPUS",0,1,1991,3187,1819,1368,1308,448,860,0.473,0.41,0.327,2967,213.892042,693,2927,0.918418575462818
"9205",204857,"OHIO UNIVERSITY MAIN CAMPUS",0,1,1992,3235,1952,1283,1396,427,969,0.496,0.432,0.333,3234,223.997468,680,2985,0.922720247295209
"9206",204857,"OHIO UNIVERSITY MAIN CAMPUS",0,1,1993,3148,1782,1366,1297,433,864,0.485,0.412,0.317,3384,229.869156,687,2940,0.933926302414231
"9207",204857,"OHIO UNIVERSITY MAIN CAMPUS",0,1,1995,3358,1939,1419,1459,479,980,0.505,0.434,0.338,3666,272.36418,718,3114,0.927337701012507
"9208",204857,"OHIO UNIVERSITY MAIN CAMPUS",0,1,1996,3123,1832,1291,1390,446,944,0.515,0.445,0.345,4080,291.182964,739,2922,0.935638808837656
"9209",204857,"OHIO UNIVERSITY-MAIN CAMPUS",0,1,1997,3255,1913,1342,1401,427,974,0.509,0.43,0.318,4275,305.973667,723,3045,0.935483870967742
"9210",204857,"OHIO UNIVERSITY-MAIN CAMPUS",0,1,1998,3369,1988,1381,1489,480,1009,0.508,0.442,0.348,4530,326.294182,695,3123,0.926981300089047
"9211",204857,"OHIO UNIVERSITY-MAIN CAMPUS",0,1,1999,3389,1977,1412,1553,490,1063,0.538,0.458,0.347,4800,349.252929,697,3201,0.944526408970198
"9212",204857,"OHIO UNIVERSITY-MAIN CAMPUS",0,1,2000,3586,2041,1545,1693,588,1105,0.541,0.472,0.381,5085,367.76493,697.5,3359,0.936698271054099
"9213",204857,"OHIO UNIVERSITY-MAIN CAMPUS",0,1,2001,3697,2200,1497,1778,594,1184,0.538,0.481,0.397,5493,384.940928,698,3490,0.944008655666757
"9214",204857,"OHIO UNIVERSITY-MAIN CAMPUS",0,1,2002,3628,2068,1560,1832,670,1162,0.562,0.505,0.429,6336,372.944404,724,3406,0.938809261300992
"9215",204857,"OHIO UNIVERSITY-MAIN CAMPUS",0,1,2003,3587,2026,1561,1722,638,1084,0.535,0.48,0.409,7128,385.017363,746,3359,0.936437134095344
"9216",204857,"OHIO UNIVERSITY-MAIN CAMPUS",0,1,2004,3734,2050,1684,1703,616,1087,0.53,0.456,0.366,7770,397.251899,737,3498,0.936797000535619
"9217",204857,"Ohio University-Main Campus",0,1,2005,4078,2148,1930,1788,697,1091,0.508,0.438,0.361,8235,422.214569,869,3744,0.918097106424718
"9218",204857,"Ohio University-Main Campus",0,1,2006,4009,2063,1946,1766,693,1073,0.52,0.441,0.356,8727,430.61779,873,3668,0.914941381890746
"9219",204857,"Ohio University-Main Campus",0,1,2007,3970,2059,1911,1902,781,1121,0.544,0.479,0.409,8907,462.914373,854,3571,0.899496221662469
"9220",204857,"Ohio University-Main Campus",0,1,2008,3908,2114,1794,1910,769,1141,0.54,0.489,0.429,8907,465.069029,881,3457,0.884595701125896
"9221",204857,"Ohio University-Main Campus",0,1,2009,4052,2217,1835,1954,702,1252,0.565,0.482,0.383,8973,498.346521,907,3591,0.886229022704837
"9222",204857,"Ohio University-Main Campus",0,1,2010,3949,2129,1820,1799,689,1110,0.521,0.456,0.379,9603,574.716179,898,3476,0.880222841225627
"9223",206330,"URBANA UNIVERSITY",1,0,1991,188,66,122,16,9,7,0.106,0.085,0.074,7155,9.643245,33,122,0.648936170212766
"9224",206330,"URBANA UNIVERSITY",1,0,1992,148,48,100,15,7,8,0.167,0.101,0.07,8075,10.371839,34,95,0.641891891891892
"9225",206330,"URBANA UNIVERSITY",1,0,1993,200,61,139,33,15,18,0.295,0.165,0.108,9025,11.394986,37,131,0.655
"9226",206330,"URBANA UNIVERSITY",1,0,1995,213,87,126,28,12,16,0.184,0.131,0.095,9454,12.407485,36,140,0.657276995305164
"9227",206330,"URBANA UNIVERSITY",1,0,1996,235,94,141,31,12,19,0.202,0.132,0.085,9824,13.844677,36,166,0.706382978723404
"9228",206330,"URBANA UNIVERSITY",1,0,1997,96,40,56,12,4,8,0.2,0.125,0.071,10172,7.152293,32,75,0.78125
"9229",206330,"URBANA UNIVERSITY",1,0,1998,143,68,75,37,13,24,0.353,0.259,0.173,10530,6.8131,34,109,0.762237762237762
"9230",206330,"URBANA UNIVERSITY",1,0,1999,121,40,81,45,20,25,0.625,0.372,0.247,10846,7.413615,38,104,0.859504132231405
"9231",206330,"URBANA UNIVERSITY",1,0,2000,215,84,131,38,19,19,0.226,0.177,0.145,11388,8.22537,40.5,165,0.767441860465116
"9232",206330,"URBANA UNIVERSITY",1,0,2001,202,67,135,42,19,23,0.343,0.208,0.141,11844,9.455549,43,142,0.702970297029703
"9233",206330,"URBANA UNIVERSITY",1,0,2002,150,51,99,22,11,11,0.216,0.147,0.111,12820,9.893068,47,114,0.76
"9234",206330,"URBANA UNIVERSITY",1,0,2003,216,72,144,27,6,21,0.292,0.125,0.042,13540,11.842468,50,161,0.74537037037037
"9235",206330,"URBANA UNIVERSITY",1,0,2004,177,70,107,38,18,20,0.286,0.215,0.168,14220,13.680889,50,151,0.853107344632768
"9236",206330,"Urbana University",1,0,2005,240,74,166,51,27,24,0.324,0.212,0.163,15050,14.180573,52,204,0.85
"9237",206330,"Urbana University",1,0,2006,238,91,147,61,19,42,0.462,0.256,0.129,16254,14.610324,53,199,0.836134453781513
"9238",206330,"Urbana University",1,0,2007,240,101,139,57,29,28,0.277,0.238,0.209,17544,15.72361,52,171,0.7125
"9239",206330,"Urbana University",1,0,2008,226,72,154,67,32,35,0.486,0.296,0.208,18960,16.872316,52,128,0.566371681415929
"9240",206330,"Urbana University",1,0,2009,182,75,107,28,10,18,0.24,0.154,0.093,19600,16.763186,55,132,0.725274725274725
"9241",206330,"Urbana University",1,0,2010,145,68,77,36,17,19,0.279,0.248,0.221,20188,16.589764,55,86,0.593103448275862
"9242",206589,"COLLEGE OF WOOSTER",1,0,1991,466,219,247,290,135,155,0.708,0.622,0.547,13410,45.679929,131,385,0.82618025751073
"9243",206589,"COLLEGE OF WOOSTER",1,0,1992,459,240,219,273,118,155,0.646,0.595,0.539,14380,47.185408,127,377,0.821350762527233
"9244",206589,"COLLEGE OF WOOSTER",1,0,1993,548,291,257,346,139,207,0.711,0.631,0.541,15425,48.266982,122,454,0.828467153284672
"9245",206589,"COLLEGE OF WOOSTER",1,0,1995,433,228,205,347,147,200,0.877,0.801,0.717,17600,51.45569,123,381,0.879907621247113
"9246",206589,"COLLEGE OF WOOSTER",1,0,1996,516,255,261,302,136,166,0.651,0.585,0.521,18380,56.665532,127,429,0.831395348837209
"9247",206589,"COLLEGE OF WOOSTER",1,0,1997,538,289,249,328,130,198,0.685,0.61,0.522,19230,47.241808,128,448,0.83271375464684
"9248",206589,"COLLEGE OF WOOSTER",1,0,1998,504,259,245,335,147,188,0.726,0.665,0.6,19940,49.065521,127,436,0.865079365079365
"9249",206589,"COLLEGE OF WOOSTER",1,0,1999,513,265,248,372,164,208,0.785,0.725,0.661,25950,53.009736,130,432,0.842105263157895
"9250",206589,"COLLEGE OF WOOSTER",1,0,2000,501,258,243,331,137,194,0.752,0.661,0.564,21520,55.812133,132,416,0.830339321357285
"9251",206589,"COLLEGE OF WOOSTER",1,0,2001,532,282,250,342,143,199,0.706,0.643,0.572,22282,60.921684,134,438,0.823308270676692
"9252",206589,"COLLEGE OF WOOSTER",1,0,2002,514,281,233,354,140,214,0.762,0.689,0.601,23687,65.939353,141,380,0.739299610894942
"9253",206589,"COLLEGE OF WOOSTER",1,0,2003,552,281,271,373,169,204,0.726,0.676,0.624,24885,65.826349,140,416,0.753623188405797
"9254",206589,"COLLEGE OF WOOSTER",1,0,2004,478,239,239,334,147,187,0.782,0.699,0.615,26380,70.60663,145,361,0.755230125523013
"9255",206589,"The College of Wooster",1,0,2005,536,267,269,362,158,204,0.764,0.675,0.587,28030,68.211726,133,431,0.80410447761194
"9256",206589,"The College of Wooster",1,0,2006,494,242,252,345,163,182,0.752,0.698,0.647,29840,71.643104,137,358,0.724696356275304
"9257",206589,"The College of Wooster",1,0,2007,545,287,258,384,159,225,0.784,0.705,0.616,31630,74.587078,167,395,0.724770642201835
"9258",206589,"The College of Wooster",1,0,2008,518,267,251,364,160,204,0.764,0.703,0.637,33520,76.070428,160,351,0.677606177606178
"9259",206589,"The College of Wooster",1,0,2009,479,264,215,371,154,217,0.822,0.775,0.716,34690,72.728223,164,327,0.682672233820459
"9260",206589,"The College of Wooster",1,0,2010,617,332,285,436,180,256,0.771,0.707,0.632,36320,72.966328,167,432,0.700162074554295
"9261",206604,"WRIGHT STATE UNIVERSITY MAIN CAMPUS",0,1,1991,2111,1061,1050,199,66,133,0.125,0.094,0.063,2674,154.045968,495,1860,0.881099005210801
"9262",206604,"WRIGHT STATE UNIVERSITY MAIN CAMPUS",0,1,1992,1941,1028,913,159,42,117,0.114,0.082,0.046,2934,156.090186,493,1672,0.861411643482741
"9263",206604,"WRIGHT STATE UNIVERSITY-MAIN CAMPUS",0,1,1993,2002,1045,957,190,73,117,0.112,0.095,0.076,3084,158.300309,493,1658,0.828171828171828
"9264",206604,"WRIGHT STATE UNIVERSITY-MAIN CAMPUS",0,1,1995,1910,1033,877,214,68,146,0.141,0.112,0.078,3429,174.241561,480,1586,0.830366492146597
"9265",206604,"WRIGHT STATE UNIVERSITY-MAIN CAMPUS",0,1,1996,1859,995,864,281,78,203,0.204,0.151,0.09,3600,185.29337,489,1514,0.814416352877891
"9266",206604,"WRIGHT STATE UNIVERSITY-MAIN CAMPUS",0,1,1997,2025,1103,922,336,126,210,0.19,0.166,0.137,3708,192.172317,482,1605,0.792592592592593
"9267",206604,"WRIGHT STATE UNIVERSITY-MAIN CAMPUS",0,1,1998,2101,1178,923,354,109,245,0.208,0.168,0.118,3930,202.90718,481,1638,0.779628748215136
"9268",206604,"WRIGHT STATE UNIVERSITY-MAIN CAMPUS",0,1,1999,2127,1202,925,352,99,253,0.211,0.165,0.107,4128,217.798248,445,1617,0.760225669957687
"9269",206604,"WRIGHT STATE UNIVERSITY-MAIN CAMPUS",0,1,2000,2124,1217,907,403,117,286,0.235,0.19,0.129,4335,231.448176,465,1709,0.804613935969868
"9270",206604,"WRIGHT STATE UNIVERSITY-MAIN CAMPUS",0,1,2001,2117,1165,952,373,129,244,0.209,0.176,0.136,4596,239.823917,485,1709,0.807274444969296
"9271",206604,"WRIGHT STATE UNIVERSITY-MAIN CAMPUS",0,1,2002,2169,1225,944,407,128,279,0.228,0.188,0.136,5262,243.011984,530,1732,0.798524665744583
"9272",206604,"WRIGHT STATE UNIVERSITY-MAIN CAMPUS",0,1,2003,2272,1312,960,78,16,62,0.047,0.034,0.017,5682,262.390831,528,1739,0.765404929577465
"9273",206604,"WRIGHT STATE UNIVERSITY-MAIN CAMPUS",0,1,2004,2289,1302,987,418,156,262,0.201,0.183,0.158,6245,279.689037,595,1665,0.727391874180865
"9274",206604,"Wright State University-Main Campus",0,1,2005,2302,1331,971,413,141,272,0.204,0.179,0.145,6619,301.183606,597,1717,0.745873153779322
"9275",206604,"Wright State University-Main Campus",0,1,2006,2178,1211,967,422,155,267,0.22,0.194,0.16,7018,313.426879,625,1629,0.747933884297521
"9276",206604,"Wright State University-Main Campus",0,1,2007,2371,1339,1032,447,160,287,0.214,0.189,0.155,7018,344.335415,649,1726,0.727962884858709
"9277",206604,"Wright State University-Main Campus",0,1,2008,2596,1496,1100,556,193,363,0.243,0.214,0.175,7018,360.572579,665,1866,0.718798151001541
"9278",206604,"Wright State University-Main Campus",0,1,2009,2463,1378,1085,515,196,319,0.231,0.209,0.181,7263,374.112762,665,1790,0.72675598863175
"9279",206604,"Wright State University-Main Campus",0,1,2010,2739,1586,1153,527,197,330,0.208,0.192,0.171,7518,397.063459,657,1877,0.685286600949252
"9280",206622,"XAVIER UNIVERSITY",1,0,1991,719,380,339,383,193,190,0.5,0.533,0.569,9700,54.053612,229,634,0.881780250347705
"9281",206622,"XAVIER UNIVERSITY",1,0,1992,672,331,341,345,166,179,0.541,0.513,0.487,10450,59.264195,231,592,0.880952380952381
"9282",206622,"XAVIER UNIVERSITY",1,0,1993,696,381,315,368,170,198,0.52,0.529,0.54,10970,63.819631,230,623,0.895114942528736
"9283",206622,"XAVIER UNIVERSITY",1,0,1995,698,396,302,394,177,217,0.548,0.564,0.586,12270,71.600906,221,628,0.899713467048711
"9284",206622,"XAVIER UNIVERSITY",1,0,1996,778,461,317,458,184,274,0.594,0.589,0.58,12950,76.739334,231,697,0.895886889460154
"9285",206622,"XAVIER UNIVERSITY",1,0,1997,757,439,318,512,220,292,0.665,0.676,0.692,13650,64.579493,229,675,0.891677675033025
"9286",206622,"XAVIER UNIVERSITY",1,0,1998,831,483,348,541,227,314,0.65,0.651,0.652,14400,69.347613,223,755,0.908543922984356
"9287",206622,"XAVIER UNIVERSITY",1,0,1999,771,464,307,540,213,327,0.705,0.7,0.694,14950,72.958926,230,681,0.883268482490272
"9288",206622,"XAVIER UNIVERSITY",1,0,2000,776,436,340,515,223,292,0.67,0.664,0.656,15680,77.417919,228.5,678,0.873711340206186
"9289",206622,"XAVIER UNIVERSITY",1,0,2001,795,426,369,555,249,306,0.718,0.698,0.675,16540,89.83761,227,708,0.890566037735849
"9290",206622,"XAVIER UNIVERSITY",1,0,2002,757,424,333,518,224,294,0.693,0.684,0.673,17780,95.523392,268,659,0.870541611624835
"9291",206622,"XAVIER UNIVERSITY",1,0,2003,786,428,358,526,230,296,0.692,0.669,0.642,18850,102.526841,278,672,0.854961832061069
"9292",206622,"XAVIER UNIVERSITY",1,0,2004,878,470,408,611,268,343,0.73,0.696,0.657,20100,110.642002,282,725,0.825740318906606
"9293",206622,"Xavier University",1,0,2005,765,430,335,523,206,317,0.737,0.684,0.615,21850,113.241532,294,607,0.793464052287582
"9294",206622,"Xavier University",1,0,2006,812,459,353,574,244,330,0.719,0.707,0.691,23270,119.824316,298,654,0.805418719211823
"9295",206622,"Xavier University",1,0,2007,858,447,411,572,268,304,0.68,0.667,0.652,23990,124.357032,309,706,0.822843822843823
"9296",206622,"Xavier University",1,0,2008,859,436,423,542,244,298,0.683,0.631,0.577,26250,130.392696,309,686,0.79860302677532
"9297",206622,"Xavier University",1,0,2009,1178,637,541,779,352,427,0.67,0.661,0.651,27900,136.877748,313,1019,0.865025466893039
"9298",206622,"Xavier University",1,0,2010,1042,554,488,641,298,343,0.619,0.615,0.611,29300,144.450304,330,836,0.802303262955854
"9299",206695,"YOUNGSTOWN STATE UNIVERSITY",0,1,1991,1904,981,923,88,31,57,0.058,0.046,0.034,2415,103.473403,475,1665,0.874474789915966
"9300",206695,"YOUNGSTOWN STATE UNIVERSITY",0,1,1992,1908,962,946,129,59,70,0.073,0.068,0.062,2640,106.029814,465,1649,0.864255765199161
"9301",206695,"YOUNGSTOWN STATE UNIVERSITY",0,1,1993,1967,1005,962,180,78,102,0.102,0.092,0.081,2772,105.717233,459,1708,0.868327402135231
"9302",206695,"YOUNGSTOWN STATE UNIVERSITY",0,1,1995,1905,1004,901,208,85,123,0.122,0.109,0.094,3084,125.826217,453,1661,0.871916010498688
"9303",206695,"YOUNGSTOWN STATE UNIVERSITY",0,1,1996,1685,859,826,212,88,124,0.144,0.126,0.107,3336,107.573682,421,1429,0.848071216617211
"9304",206695,"YOUNGSTOWN STATE UNIVERSITY",0,1,1997,1764,924,840,231,85,146,0.158,0.131,0.101,3558,106.605649,418,1480,0.839002267573696
"9305",206695,"YOUNGSTOWN STATE UNIVERSITY",0,1,1998,1839,954,885,250,81,169,0.177,0.136,0.092,3762,112.274935,412,1553,0.844480696030451
"9306",206695,"YOUNGSTOWN STATE UNIVERSITY",0,1,1999,1911,954,957,241,89,152,0.159,0.126,0.093,3783,120.326142,402,1580,0.826792255363684
"9307",206695,"YOUNGSTOWN STATE UNIVERSITY",1,0,2000,1853,943,910,220,95,125,0.133,0.119,0.104,3876,129.650055,394.5,1563,0.843497031840259
"9308",206695,"YOUNGSTOWN STATE UNIVERSITY",1,0,2001,1951,1041,910,243,81,162,0.156,0.125,0.089,4083,146.658652,387,1566,0.802665299846233
"9309",206695,"YOUNGSTOWN STATE UNIVERSITY",1,0,2002,1944,1058,886,234,76,158,0.149,0.12,0.086,4868,137.674553,402,1548,0.796296296296296
"9310",206695,"YOUNGSTOWN STATE UNIVERSITY",1,0,2003,1976,1048,928,207,73,134,0.128,0.105,0.079,4320,151.463192,407,1574,0.796558704453441
"9311",206695,"YOUNGSTOWN STATE UNIVERSITY",1,0,2004,2025,1081,944,247,91,156,0.144,0.122,0.096,4647,155.239012,422,1561,0.770864197530864
"9312",206695,"Youngstown State University",1,0,2005,2012,1029,983,177,61,116,0.113,0.088,0.062,5000,164.887394,427,1503,0.747017892644135
"9313",206695,"Youngstown State University",1,0,2006,2169,1095,1074,187,74,113,0.103,0.086,0.069,5364,171.084695,426,1589,0.732595666205625
"9314",206695,"Youngstown State University",1,0,2007,2140,1101,1039,168,70,98,0.089,0.079,0.067,5364,176.030151,429,1487,0.694859813084112
"9315",206695,"Youngstown State University",1,0,2008,2189,1090,1099,199,74,125,0.115,0.091,0.067,5364,185.90762,440,1579,0.72133394243947
"9316",206695,"Youngstown State University",1,0,2009,2564,1306,1258,240,111,129,0.099,0.094,0.088,6727,194.250251,447,1755,0.684477379095164
"9317",206695,"Youngstown State University",1,0,2010,2633,1330,1303,250,122,128,0.096,0.095,0.094,6970,209.997945,456,1803,0.684770224078997
"9318",206914,"CAMERON UNIVERSITY",1,0,1991,466,220,246,23,9,14,0.064,0.049,0.037,1377,24.854263,186,329,0.706008583690987
"9319",206914,"CAMERON UNIVERSITY",1,0,1992,577,323,254,27,6,21,0.065,0.047,0.024,1377,27.689414,185,394,0.682842287694974
"9320",206914,"CAMERON UNIVERSITY",1,0,1993,626,350,276,54,26,28,0.08,0.086,0.094,1510,28.042075,177,447,0.71405750798722
"9321",206914,"CAMERON UNIVERSITY",1,0,1995,620,358,262,61,26,35,0.098,0.098,0.099,1362,27.299934,175,435,0.701612903225806
"9322",206914,"CAMERON UNIVERSITY",1,0,1996,616,353,263,63,25,38,0.108,0.102,0.095,1759,28.886842,165,441,0.715909090909091
"9323",206914,"CAMERON UNIVERSITY",1,0,1997,615,322,293,50,21,29,0.09,0.081,0.072,1872,32.188752,171,424,0.689430894308943
"9324",206914,"CAMERON UNIVERSITY",1,0,1998,590,327,263,35,13,22,0.067,0.059,0.049,1895,32.94733,168,406,0.688135593220339
"9325",206914,"CAMERON UNIVERSITY",1,0,1999,673,355,318,54,16,38,0.107,0.08,0.05,1470,35.6465,180,430,0.638930163447251
"9326",206914,"CAMERON UNIVERSITY",1,0,2000,620,339,281,68,24,44,0.13,0.11,0.085,1470,36.406959,185,367,0.591935483870968
"9327",206914,"CAMERON UNIVERSITY",1,0,2001,673,355,318,55,16,39,0.11,0.082,0.05,1572,36.924559,190,430,0.638930163447251
"9328",206914,"CAMERON UNIVERSITY",1,0,2002,583,330,253,39,17,22,0.067,0.067,0.067,1682,38.884499,190,372,0.638078902229846
"9329",206914,"CAMERON UNIVERSITY",1,0,2003,667,375,292,34,15,19,0.051,0.051,0.051,1950,39.431025,178,385,0.577211394302849
"9330",206914,"CAMERON UNIVERSITY",1,0,2004,762,409,353,31,10,21,0.051,0.041,0.028,2100,41.467715,180,466,0.611548556430446
"9331",206914,"Cameron University",1,0,2005,714,430,284,37,22,15,0.035,0.052,0.077,2220,46.716701,184,396,0.554621848739496
"9332",206914,"Cameron University",1,0,2006,686,402,284,40,16,24,0.06,0.058,0.056,2352,49.827142,172,376,0.548104956268222
"9333",206914,"Cameron University",1,0,2007,716,382,334,50,22,28,0.073,0.07,0.066,2571,52.962379,175,379,0.529329608938548
"9334",206914,"Cameron University",1,0,2008,817,457,360,66,22,44,0.096,0.081,0.061,2805,56.620532,167,389,0.476132190942472
"9335",206914,"Cameron University",1,0,2009,855,489,366,73,28,45,0.092,0.085,0.077,2805,60.099956,183,410,0.47953216374269
"9336",206914,"Cameron University",1,0,2010,892,520,372,43,21,22,0.042,0.048,0.056,2963,62.604126,184,378,0.423766816143498
"9337",207209,"LANGSTON UNIVERSITY",1,0,1991,525,295,230,19,2,17,0.058,0.036,0.009,1347,21.087955,70,53,0.100952380952381
"9338",207209,"LANGSTON UNIVERSITY",1,0,1992,411,215,196,23,4,19,0.088,0.056,0.02,1360,25.40991,69,55,0.1338199513382
"9339",207209,"LANGSTON UNIVERSITY",1,0,1993,479,253,226,28,10,18,0.071,0.058,0.044,1441,24.383527,110,36,0.0751565762004175
"9340",207209,"LANGSTON UNIVERSITY",1,0,1995,485,220,265,24,7,17,0.077,0.049,0.026,1707,26.101961,103,29,0.0597938144329897
"9341",207209,"LANGSTON UNIVERSITY",1,0,1996,518,259,259,33,8,25,0.096,0.064,0.031,1707,28.106617,112,29,0.055984555984556
"9342",207209,"LANGSTON UNIVERSITY",1,0,1997,566,304,262,34,3,31,0.102,0.06,0.011,1893,32.386364,110,18,0.0318021201413428
"9343",207209,"LANGSTON UNIVERSITY",1,0,1998,517,262,255,22,3,19,0.072,0.043,0.012,1896,31.055206,130,9,0.0174081237911025
"9344",207209,"LANGSTON UNIVERSITY",1,0,1999,446,232,214,17,4,13,0.056,0.038,0.019,1410,34.968543,126,9,0.0201793721973094
"9345",207209,"LANGSTON UNIVERSITY",1,0,2000,690,328,362,40,14,26,0.079,0.058,0.039,1485,26.696678,126.5,19,0.027536231884058
"9346",207209,"LANGSTON UNIVERSITY",1,0,2001,446,232,214,18,5,13,0.056,0.04,0.023,635,31.667948,127,9,0.0201793721973094
"9347",207209,"LANGSTON UNIVERSITY",1,0,2002,492,248,244,31,8,23,0.093,0.063,0.033,1635,33.490998,142,23,0.0467479674796748
"9348",207209,"LANGSTON UNIVERSITY",1,0,2003,553,256,297,23,9,14,0.055,0.042,0.03,1818,47.760274,143,23,0.0415913200723327
"9349",207209,"LANGSTON UNIVERSITY",1,0,2004,530,245,285,16,6,10,0.041,0.03,0.021,1909,48.25616,149,14,0.0264150943396226
"9350",207209,"Langston University",1,0,2005,670,316,354,31,3,28,0.089,0.046,0.008,1946,51.465273,109,14,0.0208955223880597
"9351",207209,"Langston University",1,0,2006,533,271,262,32,8,24,0.089,0.06,0.031,2190,51.488429,155,18,0.0337711069418387
"9352",207209,"Langston University",1,0,2007,559,270,289,48,8,40,0.148,0.086,0.028,2409,40.268052,152,21,0.037567084078712
"9353",207209,"Langston University",1,0,2008,593,281,312,19,2,17,0.06,0.032,0.006,2640,33.700296,145,10,0.0168634064080944
"9354",207209,"Langston University",1,0,2009,561,253,308,17,6,11,0.044,0.03,0.019,2640,38.196546,154,9,0.0160427807486631
"9355",207209,"Langston University",1,0,2010,469,226,243,11,2,9,0.04,0.023,0.008,2772,60.282405,139,17,0.0362473347547974
"9356",207306,"NORTHWESTERN OKLAHOMA STATE UNIVERSITY",1,0,1991,356,176,180,43,18,25,0.142,0.121,0.1,1423,10.782536,79,323,0.907303370786517
"9357",207306,"NORTHWESTERN OKLAHOMA STATE UNIVERSITY",1,0,1992,317,164,153,36,13,23,0.14,0.114,0.085,1423,11.783202,81,296,0.933753943217666
"9358",207306,"NORTHWESTERN OKLAHOMA STATE UNIVERSITY",1,0,1993,228,119,109,33,12,21,0.176,0.145,0.11,1423,13.237628,77,211,0.925438596491228
"9359",207306,"NORTHWESTERN OKLAHOMA STATE UNIVERSITY",1,0,1995,240,127,113,39,11,28,0.22,0.162,0.097,1718,12.52655,78,226,0.941666666666667
"9360",207306,"NORTHWESTERN OKLAHOMA STATE UNIVERSITY",1,0,1996,234,110,124,22,11,11,0.1,0.094,0.089,1748,12.816145,78,204,0.871794871794872
"9361",207306,"NORTHWESTERN OKLAHOMA STATE UNIVERSITY",1,0,1997,293,148,145,35,11,24,0.162,0.119,0.076,1834,16.335172,81,259,0.883959044368601
"9362",207306,"NORTHWESTERN OKLAHOMA STATE UNIVERSITY",1,0,1998,290,147,143,35,15,20,0.136,0.121,0.105,1874,18.030099,81,258,0.889655172413793
"9363",207306,"NORTHWESTERN OKLAHOMA STATE UNIVERSITY",1,0,1999,310,138,172,36,16,20,0.145,0.116,0.093,1584,16.492992,85,276,0.890322580645161
"9364",207306,"NORTHWESTERN OKLAHOMA STATE UNIVERSITY",1,0,2000,329,159,170,46,15,31,0.195,0.14,0.088,1584,15.644029,89,297,0.90273556231003
"9365",207306,"NORTHWESTERN OKLAHOMA STATE UNIVERSITY",1,0,2001,310,138,172,36,16,20,0.145,0.116,0.093,1641,18.271013,93,276,0.890322580645161
"9366",207306,"NORTHWESTERN OKLAHOMA STATE UNIVERSITY",1,0,2002,298,164,134,56,19,37,0.226,0.188,0.142,1756,18.21318,80,253,0.848993288590604
"9367",207306,"NORTHWESTERN OKLAHOMA STATE UNIVERSITY",1,0,2003,308,139,169,45,20,25,0.18,0.146,0.118,2015,18.563929,85,271,0.87987012987013
"9368",207306,"NORTHWESTERN OKLAHOMA STATE UNIVERSITY",1,0,2004,292,156,136,40,12,28,0.18,0.137,0.088,2263,19.346449,83,248,0.849315068493151
"9369",207306,"Northwestern Oklahoma State University",1,0,2005,279,150,129,37,10,27,0.18,0.133,0.078,2604,19.813068,86,229,0.82078853046595
"9370",207306,"Northwestern Oklahoma State University",1,0,2006,243,121,122,29,9,20,0.165,0.119,0.074,2922,20.98747,85,192,0.790123456790123
"9371",207306,"Northwestern Oklahoma State University",1,0,2007,328,173,155,43,13,30,0.173,0.131,0.084,3232,21.754412,87,272,0.829268292682927
"9372",207306,"Northwestern Oklahoma State University",1,0,2008,317,162,155,47,14,33,0.204,0.148,0.09,3604,23.934689,88,258,0.813880126182965
"9373",207306,"Northwestern Oklahoma State University",1,0,2009,402,199,203,32,8,24,0.121,0.08,0.039,3604,26.010932,87,280,0.696517412935323
"9374",207306,"Northwestern Oklahoma State University",1,0,2010,382,182,200,51,16,35,0.192,0.134,0.08,3836,26.224857,91,262,0.68586387434555
"9375",207324,"OKLAHOMA CHRISTIAN UNIVERSITY OF SCIENCE AND ARTS",0,1,1991,304,160,144,76,37,39,0.244,0.25,0.257,4840,17.222404,73,233,0.766447368421053
"9376",207324,"OKLAHOMA CHRISTIAN UNIVERSITY OF SCIENCE AND ARTS",0,1,1992,355,183,172,97,41,56,0.306,0.273,0.238,5280,18.44017,67,309,0.870422535211268
"9377",207324,"OKLAHOMA CHRISTIAN UNIVERSITY OF SCIENCE AND ARTS",0,1,1993,291,157,134,56,31,25,0.159,0.192,0.231,5780,18.088245,80,251,0.862542955326461
"9378",207324,"OKLAHOMA CHRISTIAN UNIVERSITY OF SCIENCE AND ARTS",0,1,1995,320,158,162,78,28,50,0.316,0.244,0.173,7160,23.133141,79,281,0.878125
"9379",207324,"OKLAHOMA CHRISTIAN UNIVERSITY OF SCIENCE AND ARTS",0,1,1996,464,234,230,106,41,65,0.278,0.228,0.178,7500,30.396485,69,409,0.881465517241379
"9380",207324,"OKLAHOMA CHRISTIAN UNIVERSITY OF SCIENCE AND ARTS",0,1,1997,453,222,231,73,32,41,0.185,0.161,0.139,7600,19.480304,70,390,0.860927152317881
"9381",207324,"OKLAHOMA CHRISTIAN UNIVERSITY OF SCIENCE AND ARTS",0,1,1998,468,277,191,93,33,60,0.217,0.199,0.173,8200,31.375603,81,400,0.854700854700855
"9382",207324,"OKLAHOMA CHRISTIAN UNIVERSITY OF SCIENCE AND ARTS",0,1,1999,391,219,172,123,44,79,0.361,0.315,0.256,8110,33.729428,80,346,0.884910485933504
"9383",207324,"OKLAHOMA CHRISTIAN UNIVERSITY",1,0,2000,449,226,223,100,45,55,0.243,0.223,0.202,9700,34.406091,83.5,402,0.89532293986637
"9384",207324,"OKLAHOMA CHRISTIAN UNIVERSITY",1,0,2001,465,234,231,107,42,65,0.278,0.23,0.182,10500,37.124255,87,409,0.879569892473118
"9385",207324,"OKLAHOMA CHRISTIAN UNIVERSITY",1,0,2002,405,215,190,93,43,50,0.233,0.23,0.226,11100,36.402658,108,343,0.846913580246914
"9386",207324,"OKLAHOMA CHRISTIAN UNIVERSITY",1,0,2003,356,199,157,99,38,61,0.306,0.278,0.242,11490,38.016834,87,306,0.859550561797753
"9387",207324,"OKLAHOMA CHRISTIAN UNIVERSITY",1,0,2004,545,291,254,117,50,67,0.23,0.215,0.197,11780,33.588227,84,469,0.860550458715596
"9388",207324,"Oklahoma Christian University",1,0,2005,523,270,253,144,57,87,0.322,0.275,0.225,12486,38.293764,89,461,0.881453154875717
"9389",207324,"Oklahoma Christian University",1,0,2006,512,260,252,166,76,90,0.346,0.324,0.302,13422,44.188622,102,443,0.865234375
"9390",207324,"Oklahoma Christian University",1,0,2007,521,269,252,148,63,85,0.316,0.284,0.25,14020,47.501215,104,431,0.82725527831094
"9391",207324,"Oklahoma Christian University",1,0,2008,430,206,224,113,50,63,0.306,0.263,0.223,14690,51.334639,106,347,0.806976744186046
"9392",207324,"Oklahoma Christian University",1,0,2009,471,218,253,148,67,81,0.372,0.314,0.265,14690,50.162152,110,375,0.796178343949045
"9393",207324,"Oklahoma Christian University",1,0,2010,497,247,250,166,77,89,0.36,0.334,0.308,15600,50.123364,110,379,0.762575452716298
"9394",207388,"OKLAHOMA STATE UNIVERSITY MAIN CAMPUS",1,0,1991,2092,1038,1054,399,144,255,0.246,0.191,0.137,1758,252.672887,843,1732,0.82791586998088
"9395",207388,"OKLAHOMA STATE UNIVERSITY MAIN CAMPUS",1,0,1992,2148,1116,1032,400,130,270,0.242,0.186,0.126,1758,276.391645,855,1746,0.812849162011173
"9396",207388,"OKLAHOMA STATE UNIVERSITY-MAIN CAMPUS",1,0,1993,2050,999,1051,377,130,247,0.247,0.184,0.124,1882,277.373494,810,1685,0.821951219512195
"9397",207388,"OKLAHOMA STATE UNIVERSITY-MAIN CAMPUS",1,0,1995,2362,1185,1177,475,186,289,0.244,0.201,0.158,2148,292.244595,824,1953,0.8268416596105
"9398",207388,"OKLAHOMA STATE UNIVERSITY-MAIN CAMPUS",1,0,1996,2336,1223,1113,488,155,333,0.272,0.209,0.139,2161,300.487583,927,1905,0.815496575342466
"9399",207388,"OKLAHOMA STATE UNIVERSITY-MAIN CAMPUS",1,0,1997,2321,1214,1107,565,194,371,0.306,0.243,0.175,2356,335.675206,913,1920,0.827229642395519
"9400",207388,"OKLAHOMA STATE UNIVERSITY-MAIN CAMPUS",1,0,1998,2584,1301,1283,624,226,398,0.306,0.241,0.176,2356,370.754956,844,2141,0.828560371517028
"9401",207388,"OKLAHOMA STATE UNIVERSITY-MAIN CAMPUS",1,0,1999,2795,1491,1304,705,206,499,0.335,0.252,0.158,1890,398.083551,845,2304,0.82432915921288
"9402",207388,"OKLAHOMA STATE UNIVERSITY-MAIN CAMPUS",1,0,2000,2953,1615,1338,802,272,530,0.328,0.272,0.203,1890,430.75453,843,2440,0.826278360988825
"9403",207388,"OKLAHOMA STATE UNIVERSITY-MAIN CAMPUS",1,0,2001,3111,1594,1517,834,285,549,0.344,0.268,0.188,2022,445.732843,841,2499,0.80327868852459
"9404",207388,"OKLAHOMA STATE UNIVERSITY-MAIN CAMPUS",1,0,2002,3206,1698,1508,939,327,612,0.36,0.293,0.217,2163,453.15848,848,2641,0.823767935121647
"9405",207388,"OKLAHOMA STATE UNIVERSITY-MAIN CAMPUS",1,0,2003,3128,1666,1462,958,336,622,0.373,0.306,0.23,2596,488.086621,835,2576,0.823529411764706
"9406",207388,"OKLAHOMA STATE UNIVERSITY-MAIN CAMPUS",1,0,2004,3126,1601,1525,991,360,631,0.394,0.317,0.236,2910,507.409579,908,2560,0.818937939859245
"9407",207388,"Oklahoma State University-Main Campus",1,0,2005,3221,1662,1559,1106,436,670,0.403,0.343,0.28,3099,520.983329,1023,2630,0.816516609748525
"9408",207388,"Oklahoma State University-Main Campus",1,0,2006,3132,1658,1474,1068,383,685,0.413,0.341,0.26,3263,554.403087,1058,2567,0.819604086845466
"9409",207388,"Oklahoma State University-Main Campus",1,0,2007,3111,1599,1512,1013,399,614,0.384,0.326,0.264,3585,596.638391,1039,2450,0.7875281260045
"9410",207388,"Oklahoma State University-Main Campus",1,0,2008,2946,1501,1445,992,361,631,0.42,0.337,0.25,3941,634.408414,1052,2333,0.791921249151392
"9411",207388,"Oklahoma State University-Main Campus",1,0,2009,2973,1544,1429,997,365,632,0.409,0.335,0.255,3941,684.681298,1064,2248,0.756138580558359
"9412",207388,"Oklahoma State University-Main Campus",1,0,2010,3403,1761,1642,1320,497,823,0.467,0.388,0.303,4103,706.838394,1068,2519,0.740229209521011
"9413",207500,"UNIVERSITY OF OKLAHOMA NORMAN CAMPUS",1,0,1991,2249,1082,1167,277,101,176,0.163,0.123,0.087,1722,237.569,785,1686,0.749666518452646
"9414",207500,"UNIVERSITY OF OKLAHOMA NORMAN CAMPUS",1,0,1992,2376,1164,1212,264,110,154,0.132,0.111,0.091,1768,264.968,801,1705,0.717592592592593
"9415",207500,"UNIVERSITY OF OKLAHOMA NORMAN CAMPUS",1,0,1993,2235,1072,1163,337,139,198,0.185,0.151,0.12,1901,261.361,778,1671,0.747651006711409
"9416",207500,"UNIVERSITY OF OKLAHOMA NORMAN CAMPUS",1,0,1995,2712,1321,1391,519,191,328,0.248,0.191,0.137,2024,277.592,801,1960,0.722713864306785
"9417",207500,"UNIVERSITY OF OKLAHOMA NORMAN CAMPUS",1,0,1996,2605,1264,1341,525,200,325,0.257,0.202,0.149,2178,298.585,809,1896,0.727831094049904
"9418",207500,"UNIVERSITY OF OKLAHOMA NORMAN CAMPUS",1,0,1997,2895,1523,1372,552,195,357,0.234,0.191,0.142,2309,315.953,834,2083,0.719516407599309
"9419",207500,"UNIVERSITY OF OKLAHOMA NORMAN CAMPUS",1,0,1998,3148,1618,1530,641,214,427,0.264,0.204,0.14,2313,357.154,876,2293,0.728398983481576
"9420",207500,"UNIVERSITY OF OKLAHOMA NORMAN CAMPUS",1,0,1999,3206,1603,1603,619,237,382,0.238,0.193,0.148,1890,379.715,918,2326,0.725514660012477
"9421",207500,"UNIVERSITY OF OKLAHOMA NORMAN CAMPUS",1,0,2000,3326,1760,1566,791,268,523,0.297,0.238,0.171,1890,410.942,927.5,2480,0.745640408899579
"9422",207500,"UNIVERSITY OF OKLAHOMA NORMAN CAMPUS",1,0,2001,3629,1908,1721,897,332,565,0.296,0.247,0.193,2022,447.77,937,2782,0.766602369798843
"9423",207500,"UNIVERSITY OF OKLAHOMA NORMAN CAMPUS",1,0,2002,3749,1940,1809,973,350,623,0.321,0.26,0.193,2163,472.778,963,2940,0.784209122432649
"9424",207500,"UNIVERSITY OF OKLAHOMA NORMAN CAMPUS",1,0,2003,3729,1921,1808,1100,406,694,0.361,0.295,0.225,2541,488.725,971,2907,0.779565567176187
"9425",207500,"UNIVERSITY OF OKLAHOMA NORMAN CAMPUS",1,0,2004,3537,1876,1661,1122,397,725,0.386,0.317,0.239,2778,494.116,976,2778,0.785411365564037
"9426",207500,"University of Oklahoma Norman Campus",1,0,2005,3189,1695,1494,1107,418,689,0.406,0.347,0.28,2862,543.273,1003,2448,0.76763875823142
"9427",207500,"University of Oklahoma Norman Campus",1,0,2006,3285,1732,1553,1190,457,733,0.423,0.362,0.294,3006,596.519,1059,2445,0.744292237442922
"9428",207500,"University of Oklahoma Norman Campus",1,0,2007,3824,2043,1781,1331,452,879,0.43,0.348,0.254,3261,650.783,1113,2858,0.747384937238494
"9429",207500,"University of Oklahoma Norman Campus",1,0,2008,3750,2058,1692,1394,525,869,0.422,0.372,0.31,3537,711.341,1131,2913,0.7768
"9430",207500,"University of Oklahoma Norman Campus",1,0,2009,3700,1917,1783,1411,555,856,0.446,0.381,0.311,3537,749.23,1142,2695,0.728378378378378
"9431",207500,"University of Oklahoma Norman Campus",1,0,2010,3669,1945,1724,1455,549,906,0.466,0.397,0.318,3678,750.785,1135,2117,0.576996456800218
"9432",207722,"UNIVERSITY OF SCIENCE AND ARTS OF OKLAHOMA",0,1,1991,203,143,60,16,2,14,0.098,0.079,0.033,1316,8.525152,54,174,0.857142857142857
"9433",207722,"UNIVERSITY OF SCIENCE AND ARTS OF OKLAHOMA",0,1,1992,219,151,68,33,10,23,0.152,0.151,0.147,1316,9.622918,54,192,0.876712328767123
"9434",207722,"UNIVERSITY OF SCIENCE AND ARTS OF OKLAHOMA",0,1,1993,207,128,79,21,6,15,0.117,0.101,0.076,1408,9.53276,53,180,0.869565217391304
"9435",207722,"UNIVERSITY OF SCIENCE AND ARTS OF OKLAHOMA",0,1,1995,259,164,95,33,6,27,0.165,0.127,0.063,1538,10.214084,52,209,0.806949806949807
"9436",207722,"UNIVERSITY OF SCIENCE AND ARTS OF OKLAHOMA",0,1,1996,261,138,123,26,11,15,0.109,0.1,0.089,1568,10.032125,52,203,0.777777777777778
"9437",207722,"UNIVERSITY OF SCIENCE AND ARTS OF OKLAHOMA",0,1,1997,222,133,89,32,9,23,0.173,0.144,0.101,1725,10.640073,55,184,0.828828828828829
"9438",207722,"UNIVERSITY OF SCIENCE AND ARTS OF OKLAHOMA",0,1,1998,279,159,120,48,19,29,0.182,0.172,0.158,1740,11.202434,55,231,0.827956989247312
"9439",207722,"UNIVERSITY OF SCIENCE AND ARTS OF OKLAHOMA",0,1,1999,229,133,96,32,12,20,0.15,0.14,0.125,1470,11.569701,55,179,0.781659388646288
"9440",207722,"UNIVERSITY OF SCIENCE AND ARTS OF OKLAHOMA",0,1,2000,206,135,71,29,6,23,0.17,0.141,0.085,1176,12.307457,53.5,149,0.723300970873786
"9441",207722,"UNIVERSITY OF SCIENCE AND ARTS OF OKLAHOMA",0,1,2001,261,138,123,26,11,15,0.109,0.1,0.089,1699,12.884392,52,203,0.777777777777778
"9442",207722,"UNIVERSITY OF SCIENCE AND ARTS OF OKLAHOMA",0,1,2002,280,186,94,44,11,33,0.177,0.157,0.117,1699,13.716936,54,216,0.771428571428571
"9443",207722,"UNIVERSITY OF SCIENCE AND ARTS OF OKLAHOMA",0,1,2003,282,172,110,54,11,43,0.25,0.191,0.1,1680,13.547454,49,216,0.765957446808511
"9444",207722,"UNIVERSITY OF SCIENCE AND ARTS OF OKLAHOMA",0,1,2004,244,148,96,45,13,32,0.216,0.184,0.135,1824,13.213707,49,187,0.766393442622951
"9445",207722,"University of Science and Arts of Oklahoma",0,1,2005,233,122,111,61,30,31,0.254,0.262,0.27,1992,14.927518,51,182,0.781115879828326
"9446",207722,"University of Science and Arts of Oklahoma",0,1,2006,208,139,69,58,16,42,0.302,0.279,0.232,2112,15.940272,56,156,0.75
"9447",207722,"University of Science and Arts of Oklahoma",0,1,2007,198,123,75,51,13,38,0.309,0.258,0.173,2304,17.411899,58,150,0.757575757575758
"9448",207722,"University of Science and Arts of Oklahoma",0,1,2008,203,126,77,88,28,60,0.476,0.433,0.364,2616,17.46157,56,142,0.699507389162562
"9449",207722,"University of Science and Arts of Oklahoma",0,1,2009,166,113,53,49,12,37,0.327,0.295,0.226,2616,18.6898,58,121,0.728915662650602
"9450",207722,"University of Science and Arts of Oklahoma",0,1,2010,199,129,70,54,13,41,0.318,0.271,0.186,2808,19.437661,57,143,0.718592964824121
"9451",207847,"SOUTHEASTERN OKLAHOMA STATE UNIVERSITY",1,0,1991,537,291,246,55,21,34,0.117,0.102,0.085,1340,26.0099,146,323,0.601489757914339
"9452",207847,"SOUTHEASTERN OKLAHOMA STATE UNIVERSITY",1,0,1992,503,287,216,60,19,41,0.143,0.119,0.088,1350,28.12039,151,298,0.592445328031809
"9453",207847,"SOUTHEASTERN OKLAHOMA STATE UNIVERSITY",1,0,1993,541,295,246,77,31,46,0.156,0.142,0.126,1494,29.80127,148,336,0.621072088724584
"9454",207847,"SOUTHEASTERN OKLAHOMA STATE UNIVERSITY",1,0,1995,570,282,288,91,48,43,0.152,0.16,0.167,1665,30.95411,148,347,0.608771929824561
"9455",207847,"SOUTHEASTERN OKLAHOMA STATE UNIVERSITY",1,0,1996,579,266,313,78,41,37,0.139,0.135,0.131,1687,30.545483,147,361,0.623488773747841
"9456",207847,"SOUTHEASTERN OKLAHOMA STATE UNIVERSITY",1,0,1997,578,314,264,89,33,56,0.178,0.154,0.125,1879,31.399941,148,339,0.586505190311419
"9457",207847,"SOUTHEASTERN OKLAHOMA STATE UNIVERSITY",1,0,1998,499,260,239,59,21,38,0.146,0.118,0.088,1889,32.515849,155,316,0.633266533066132
"9458",207847,"SOUTHEASTERN OKLAHOMA STATE UNIVERSITY",1,0,1999,572,307,265,67,26,41,0.134,0.117,0.098,1485,34.382026,149,316,0.552447552447552
"9459",207847,"SOUTHEASTERN OKLAHOMA STATE UNIVERSITY",1,0,2000,509,261,248,54,21,33,0.126,0.106,0.085,1372,34.557653,145.5,307,0.603143418467583
"9460",207847,"SOUTHEASTERN OKLAHOMA STATE UNIVERSITY",1,0,2001,579,266,313,75,40,35,0.132,0.13,0.128,1467,39.585643,142,361,0.623488773747841
"9461",207847,"SOUTHEASTERN OKLAHOMA STATE UNIVERSITY",1,0,2002,577,287,290,64,29,35,0.122,0.111,0.1,1569,39.535768,145,392,0.679376083188908
"9462",207847,"SOUTHEASTERN OKLAHOMA STATE UNIVERSITY",1,0,2003,651,339,312,70,27,43,0.127,0.108,0.087,1950,39.955724,139,395,0.606758832565284
"9463",207847,"SOUTHEASTERN OKLAHOMA STATE UNIVERSITY",1,0,2004,609,310,299,59,29,30,0.097,0.097,0.097,2126,42.4767,134,360,0.591133004926108
"9464",207847,"Southeastern Oklahoma State University",1,0,2005,587,298,289,62,22,40,0.134,0.106,0.076,2195,42.284682,135,352,0.599659284497445
"9465",207847,"Southeastern Oklahoma State University",1,0,2006,586,313,273,67,26,41,0.131,0.114,0.095,2897,47.604112,140,337,0.575085324232082
"9466",207847,"Southeastern Oklahoma State University",1,0,2007,631,326,305,82,33,49,0.15,0.13,0.108,3249,51.687783,141,376,0.595879556259905
"9467",207847,"Southeastern Oklahoma State University",1,0,2008,583,296,287,68,29,39,0.132,0.117,0.101,3639,51.239503,141,321,0.550600343053173
"9468",207847,"Southeastern Oklahoma State University",1,0,2009,639,313,326,84,38,46,0.147,0.131,0.117,3639,53.808331,142,355,0.555555555555556
"9469",207847,"Southeastern Oklahoma State University",1,0,2010,651,344,307,55,20,35,0.102,0.084,0.065,3875,54.494473,141,350,0.537634408602151
"9470",207865,"SOUTHWESTERN OKLAHOMA STATE UNIVERSITY",1,0,1991,867,502,365,70,24,46,0.092,0.081,0.066,1295,29.47737,221,767,0.884659746251442
"9471",207865,"SOUTHWESTERN OKLAHOMA STATE UNIVERSITY",1,0,1992,945,534,411,79,21,58,0.109,0.084,0.051,1310,31.03076,222,855,0.904761904761905
"9472",207865,"SOUTHWESTERN OKLAHOMA STATE UNIVERSITY",1,0,1993,791,409,382,68,19,49,0.12,0.086,0.05,1392,30.936353,214,704,0.890012642225032
"9473",207865,"SOUTHWESTERN OKLAHOMA STATE UNIVERSITY",1,0,1995,769,470,299,123,34,89,0.189,0.16,0.114,1599,35.466941,215,671,0.872561768530559
"9474",207865,"SOUTHWESTERN OKLAHOMA STATE UNIVERSITY",1,0,1996,737,386,351,92,34,58,0.15,0.125,0.097,1599,34.505528,210,671,0.91044776119403
"9475",207865,"SOUTHWESTERN OKLAHOMA STATE UNIVERSITY",1,0,1997,717,386,331,107,28,79,0.205,0.149,0.085,1798,36.431061,206,632,0.881450488145049
"9476",207865,"SOUTHWESTERN OKLAHOMA STATE UNIVERSITY",1,0,1998,866,453,413,136,38,98,0.216,0.157,0.092,1798,38.366936,198,752,0.868360277136259
"9477",207865,"SOUTHWESTERN OKLAHOMA STATE UNIVERSITY",1,0,1999,779,448,331,116,35,81,0.181,0.149,0.106,1485,41.677747,200,681,0.874197689345314
"9478",207865,"SOUTHWESTERN OKLAHOMA STATE UNIVERSITY",1,0,2000,815,464,351,135,27,108,0.233,0.166,0.077,1485,42.603868,198,688,0.844171779141104
"9479",207865,"SOUTHWESTERN OKLAHOMA STATE UNIVERSITY",1,0,2001,853,481,372,128,45,83,0.173,0.15,0.121,1589,44.072267,196,708,0.830011723329426
"9480",207865,"SOUTHWESTERN OKLAHOMA STATE UNIVERSITY",1,0,2002,926,486,440,121,46,75,0.154,0.131,0.105,1700,45.614803,200,771,0.832613390928726
"9481",207865,"SOUTHWESTERN OKLAHOMA STATE UNIVERSITY",1,0,2003,980,492,488,119,38,81,0.165,0.121,0.078,1950,45.580127,194,758,0.773469387755102
"9482",207865,"SOUTHWESTERN OKLAHOMA STATE UNIVERSITY",1,0,2004,941,493,448,130,41,89,0.181,0.138,0.092,2100,46.971796,193,744,0.790648246546227
"9483",207865,"Southwestern Oklahoma State University",1,0,2005,766,403,363,127,43,84,0.208,0.166,0.118,2490,49.121284,197,592,0.772845953002611
"9484",207865,"Southwestern Oklahoma State University",1,0,2006,844,485,359,129,31,98,0.202,0.153,0.086,2700,51.704337,194,640,0.758293838862559
"9485",207865,"Southwestern Oklahoma State University",1,0,2007,896,552,344,116,32,84,0.152,0.129,0.093,3000,54.629136,195,690,0.770089285714286
"9486",207865,"Southwestern Oklahoma State University",1,0,2008,920,511,409,124,41,83,0.162,0.135,0.1,3360,57.986431,198,724,0.78695652173913
"9487",207865,"Southwestern Oklahoma State University",1,0,2009,900,481,419,105,30,75,0.156,0.117,0.072,3360,61.454768,211,662,0.735555555555556
"9488",207865,"Southwestern Oklahoma State University",1,0,2010,977,529,448,123,44,79,0.149,0.126,0.098,3405,65.294353,215,697,0.713408393039918
"9489",208822,"GEORGE FOX COLLEGE",1,0,1991,258,154,104,91,33,58,0.377,0.353,0.317,9114,12.312239,59,239,0.926356589147287
"9490",208822,"GEORGE FOX COLLEGE",1,0,1992,282,176,106,134,52,82,0.466,0.475,0.491,10040,14.93866,68,264,0.936170212765957
"9491",208822,"GEORGE FOX COLLEGE",1,0,1993,343,198,145,159,62,97,0.49,0.464,0.428,11740,18.458183,77,313,0.912536443148688
"9492",208822,"GEORGE FOX UNIVERSITY",1,0,1995,347,232,115,162,54,108,0.465,0.467,0.47,13690,25.376278,92,312,0.899135446685879
"9493",208822,"GEORGE FOX UNIVERSITY",1,0,1996,386,250,136,200,71,129,0.516,0.518,0.522,14520,28.05693,105,356,0.922279792746114
"9494",208822,"GEORGE FOX UNIVERSITY",1,0,1997,345,225,120,212,70,142,0.631,0.614,0.583,15520,25.893166,108,277,0.802898550724638
"9495",208822,"GEORGE FOX UNIVERSITY",1,0,1998,361,240,121,208,73,135,0.562,0.576,0.603,15950,27.831485,116,223,0.617728531855956
"9496",208822,"GEORGE FOX UNIVERSITY",1,0,1999,282,163,119,145,48,97,0.595,0.514,0.403,16600,29.152207,121,265,0.939716312056738
"9497",208822,"GEORGE FOX UNIVERSITY",1,0,2000,352,205,147,209,81,128,0.624,0.594,0.551,17300,32.123432,115.5,295,0.838068181818182
"9498",208822,"GEORGE FOX UNIVERSITY",1,0,2001,301,180,121,172,64,108,0.6,0.571,0.529,18000,34.402779,110,268,0.890365448504983
"9499",208822,"GEORGE FOX UNIVERSITY",1,0,2002,319,204,115,171,60,111,0.544,0.536,0.522,18575,35.067836,127,286,0.896551724137931
"9500",208822,"GEORGE FOX UNIVERSITY",1,0,2003,336,203,133,177,73,104,0.512,0.527,0.549,19500,37.604578,135,293,0.87202380952381
"9501",208822,"GEORGE FOX UNIVERSITY",1,0,2004,397,259,138,235,79,156,0.602,0.592,0.572,20280,41.000794,133,339,0.853904282115869
"9502",208822,"George Fox University",1,0,2005,460,287,173,241,86,155,0.54,0.524,0.497,21400,44.198284,144,379,0.823913043478261
"9503",208822,"George Fox University",1,0,2006,415,262,153,223,81,142,0.542,0.537,0.529,22250,48.552774,156,325,0.783132530120482
"9504",208822,"George Fox University",1,0,2007,435,279,156,225,61,164,0.588,0.517,0.391,23470,53.040576,167,338,0.777011494252874
"9505",208822,"George Fox University",1,0,2008,401,245,156,204,74,130,0.531,0.509,0.474,24870,56.402305,156,291,0.72568578553616
"9506",208822,"George Fox University",1,0,2009,411,239,172,249,102,147,0.615,0.606,0.593,25860,56.71071,168,329,0.800486618004866
"9507",208822,"George Fox University",1,0,2010,488,287,201,275,119,156,0.544,0.564,0.592,27640,59.337102,170,342,0.700819672131147
"9508",209056,"LEWIS AND CLARK COLLEGE",0,1,1991,357,213,144,191,72,119,0.559,0.535,0.5,13470,46.832345,175,309,0.865546218487395
"9509",209056,"LEWIS AND CLARK COLLEGE",0,1,1992,395,235,160,221,78,143,0.609,0.559,0.488,14265,48.378465,182,341,0.863291139240506
"9510",209056,"LEWIS AND CLARK COLLEGE",0,1,1993,469,274,195,259,113,146,0.533,0.552,0.579,15051,50.513743,174,396,0.844349680170576
"9511",209056,"LEWIS AND CLARK COLLEGE",1,0,1995,455,280,175,228,85,143,0.511,0.501,0.486,16820,58.122766,177,333,0.731868131868132
"9512",209056,"LEWIS AND CLARK COLLEGE",1,0,1996,443,262,181,249,91,158,0.603,0.562,0.503,17740,62.505602,179,318,0.717832957110609
"9513",209056,"LEWIS AND CLARK COLLEGE",1,0,1997,463,272,191,289,121,168,0.618,0.624,0.634,18530,48.453675,181,298,0.643628509719222
"9514",209056,"LEWIS AND CLARK COLLEGE",1,0,1998,424,253,171,249,94,155,0.613,0.587,0.55,19356,55.635811,179,295,0.695754716981132
"9515",209056,"LEWIS AND CLARK COLLEGE",1,0,1999,510,307,203,330,127,203,0.661,0.647,0.626,20136,59.146216,190,325,0.637254901960784
"9516",209056,"LEWIS AND CLARK COLLEGE",1,0,2000,426,263,163,251,91,160,0.608,0.589,0.558,21330,62.974217,193,291,0.683098591549296
"9517",209056,"LEWIS & CLARK COLLEGE",1,0,2001,415,240,175,277,109,168,0.7,0.667,0.623,22410,67.028759,196,283,0.681927710843373
"9518",209056,"LEWIS & CLARK COLLEGE",1,0,2002,503,309,194,339,123,216,0.699,0.674,0.634,23530,72.004744,213,303,0.602385685884692
"9519",209056,"LEWIS & CLARK COLLEGE",1,0,2003,493,308,185,352,127,225,0.731,0.714,0.686,24486,75.758712,202,351,0.711967545638945
"9520",209056,"LEWIS & CLARK COLLEGE",1,0,2004,537,329,208,366,143,223,0.678,0.682,0.688,25938,81.975942,212,364,0.677839851024209
"9521",209056,"Lewis & Clark College",1,0,2005,490,294,196,324,125,199,0.677,0.661,0.638,27494,87.30022,205,339,0.691836734693878
"9522",209056,"Lewis & Clark College",1,0,2006,508,318,190,349,129,220,0.692,0.687,0.679,29556,92.010913,214,307,0.604330708661417
"9523",209056,"Lewis & Clark College",1,0,2007,506,322,184,338,108,230,0.714,0.668,0.587,31624,97.40178,221,312,0.616600790513834
"9524",209056,"Lewis & Clark College",1,0,2008,534,323,211,381,135,246,0.762,0.713,0.64,33490,103.026393,222,295,0.552434456928839
"9525",209056,"Lewis & Clark College",1,0,2009,494,298,196,327,122,205,0.688,0.662,0.622,34995,109.84305,231,266,0.538461538461538
"9526",209056,"Lewis & Clark College",1,0,2010,491,306,185,364,125,239,0.781,0.741,0.676,36394,107.516621,230,311,0.633401221995927
"9527",209065,"LINFIELD COLLEGE",1,0,1991,429,242,187,234,89,145,0.599,0.545,0.476,11150,25.274588,122,371,0.864801864801865
"9528",209065,"LINFIELD COLLEGE",1,0,1992,428,265,163,234,68,166,0.626,0.547,0.417,11870,30.756341,126,380,0.88785046728972
"9529",209065,"LINFIELD COLLEGE",1,0,1993,436,235,201,254,110,144,0.613,0.583,0.547,12700,33.140718,129,382,0.876146788990826
"9530",209065,"LINFIELD COLLEGE",1,0,1995,438,260,178,276,105,171,0.658,0.63,0.59,14300,37.299435,128,377,0.860730593607306
"9531",209065,"LINFIELD COLLEGE",1,0,1996,445,238,207,272,109,163,0.685,0.611,0.527,15096,39.289459,129,393,0.88314606741573
"9532",209065,"LINFIELD COLLEGE",1,0,1997,410,235,175,244,91,153,0.651,0.595,0.52,15994,30.674428,134,352,0.858536585365854
"9533",209065,"LINFIELD COLLEGE",1,0,1998,415,232,183,238,81,157,0.677,0.573,0.443,16960,32.137334,125,356,0.857831325301205
"9534",209065,"LINFIELD COLLEGE",1,0,1999,397,227,170,227,74,153,0.674,0.572,0.435,17590,35.355129,94,314,0.790931989924433
"9535",209065,"LINFIELD COLLEGE",1,0,2000,434,228,206,281,113,168,0.737,0.647,0.549,18450,29.885919,95,338,0.778801843317972
"9536",209065,"LINFIELD COLLEGE",1,0,2001,422,232,190,250,89,161,0.694,0.592,0.468,19380,32.638333,96,363,0.860189573459716
"9537",209065,"LINFIELD COLLEGE",1,0,2002,425,245,180,258,92,166,0.678,0.607,0.511,20160,33.447778,100,361,0.849411764705882
"9538",209065,"LINFIELD COLLEGE",1,0,2003,448,243,205,286,101,185,0.761,0.638,0.493,20770,34.990722,104,372,0.830357142857143
"9539",209065,"LINFIELD COLLEGE",1,0,2004,432,222,210,249,106,143,0.644,0.576,0.505,21800,36.487379,103,333,0.770833333333333
"9540",209065,"Linfield College",1,0,2005,481,260,221,293,113,180,0.692,0.609,0.511,22790,46.515187,105,399,0.82952182952183
"9541",209065,"Linfield College",1,0,2006,445,243,202,265,104,161,0.663,0.596,0.515,23930,49.719138,103,346,0.77752808988764
"9542",209065,"Linfield College",1,0,2007,476,276,200,281,96,185,0.67,0.59,0.48,25390,52.510423,107,310,0.651260504201681
"9543",209065,"Linfield College",1,0,2008,474,274,200,290,106,184,0.672,0.612,0.53,27150,54.114903,108,314,0.662447257383966
"9544",209065,"Linfield College",1,0,2009,420,252,168,226,76,150,0.595,0.538,0.452,28760,55.359807,107,294,0.7
"9545",209065,"Linfield College",1,0,2010,528,310,218,302,117,185,0.597,0.572,0.537,30300,57.006898,110,369,0.698863636363636
"9546",209542,"OREGON STATE UNIVERSITY",0,1,1991,1543,696,847,403,184,219,0.315,0.261,0.217,2505,290.438069,618,1224,0.793259883344135
"9547",209542,"OREGON STATE UNIVERSITY",0,1,1992,1703,771,932,442,179,263,0.341,0.26,0.192,2691,302.137369,607,1385,0.813270698766882
"9548",209542,"OREGON STATE UNIVERSITY",0,1,1993,1625,705,920,395,169,226,0.321,0.243,0.184,2877,319.76315,622,1269,0.780923076923077
"9549",209542,"OREGON STATE UNIVERSITY",0,1,1995,2018,965,1053,561,194,367,0.38,0.278,0.184,3312,342.211959,603,1615,0.800297324083251
"9550",209542,"OREGON STATE UNIVERSITY",0,1,1996,1833,883,950,492,181,311,0.352,0.268,0.191,3447,366.327438,597,1450,0.791052918712493
"9551",209542,"OREGON STATE UNIVERSITY",0,1,1997,1869,860,1009,525,212,313,0.364,0.281,0.21,3510,375.999794,592,1516,0.811128945960407
"9552",209542,"OREGON STATE UNIVERSITY",0,1,1998,2229,1105,1124,615,210,405,0.366,0.276,0.187,3549,370.254,601,1756,0.787797218483625
"9553",209542,"OREGON STATE UNIVERSITY",0,1,1999,2772,1319,1453,847,333,514,0.39,0.306,0.229,3561,392.011519,594,2188,0.789321789321789
"9554",209542,"OREGON STATE UNIVERSITY",0,1,2000,2652,1250,1402,770,311,459,0.367,0.29,0.222,2694,425.607755,613.5,2080,0.784313725490196
"9555",209542,"OREGON STATE UNIVERSITY",0,1,2001,2982,1467,1515,885,356,529,0.361,0.297,0.235,2802,457.112527,633,2374,0.796109993293092
"9556",209542,"OREGON STATE UNIVERSITY",0,1,2002,2864,1437,1427,906,319,587,0.409,0.316,0.224,2886,500.799352,639,2249,0.785265363128492
"9557",209542,"OREGON STATE UNIVERSITY",0,1,2003,2862,1371,1491,811,321,490,0.357,0.283,0.215,3642,494.074464,591,2228,0.778476589797344
"9558",209542,"OREGON STATE UNIVERSITY",0,1,2004,2803,1367,1436,860,320,540,0.395,0.307,0.223,4113,510.101617,634,2199,0.784516589368534
"9559",209542,"Oregon State University",0,1,2005,2817,1385,1432,819,306,513,0.37,0.291,0.214,4176,558.279453,676,2120,0.752573659921903
"9560",209542,"Oregon State University",0,1,2006,2898,1413,1485,872,341,531,0.376,0.301,0.23,4320,609.299545,685,2085,0.719461697722567
"9561",209542,"Oregon State University",0,1,2007,2974,1436,1538,879,333,546,0.38,0.296,0.217,4464,625.688474,689,2072,0.69670477471419
"9562",209542,"Oregon State University",0,1,2008,3006,1422,1584,922,373,549,0.386,0.307,0.235,4608,650.912044,699,2058,0.684630738522954
"9563",209542,"Oregon State University",0,1,2009,3314,1620,1694,1072,400,672,0.415,0.323,0.236,5436,704.933093,713,2330,0.703077851538926
"9564",209542,"Oregon State University",0,1,2010,3480,1677,1803,1145,447,698,0.416,0.329,0.248,5760,698.912446,738,2467,0.708908045977012
"9565",209551,"UNIVERSITY OF OREGON",0,1,1991,1919,1068,851,683,238,445,0.417,0.356,0.28,2598,205.291419,657,1540,0.802501302761855
"9566",209551,"UNIVERSITY OF OREGON",0,1,1992,2279,1179,1100,808,315,493,0.418,0.355,0.286,2721,218.517654,643,1724,0.75647213690215
"9567",209551,"UNIVERSITY OF OREGON",0,1,1993,2513,1422,1091,951,346,605,0.426,0.378,0.317,2916,231.155304,671,1978,0.787107043374453
"9568",209551,"UNIVERSITY OF OREGON",0,1,1995,2583,1429,1154,950,329,621,0.435,0.368,0.285,3381,259.224207,680,2012,0.778939217963608
"9569",209551,"UNIVERSITY OF OREGON",0,1,1996,2580,1444,1136,958,349,609,0.422,0.371,0.307,3540,274.587867,620,2001,0.775581395348837
"9570",209551,"UNIVERSITY OF OREGON",0,1,1997,2384,1307,1077,856,314,542,0.415,0.359,0.292,3648,294.758607,686,1835,0.769714765100671
"9571",209551,"UNIVERSITY OF OREGON",0,1,1998,2304,1289,1015,839,280,559,0.434,0.364,0.276,3771,293.019126,636,1720,0.746527777777778
"9572",209551,"UNIVERSITY OF OREGON",0,1,1999,2453,1393,1060,931,314,617,0.443,0.38,0.296,2694,306.628438,668,1844,0.751732572360375
"9573",209551,"UNIVERSITY OF OREGON",0,1,2000,2809,1527,1282,1089,384,705,0.462,0.388,0.3,2694,326.523465,665,2171,0.772872908508366
"9574",209551,"UNIVERSITY OF OREGON",0,1,2001,3049,1687,1362,1244,464,780,0.462,0.408,0.341,2802,345.653505,662,2386,0.782551656280748
"9575",209551,"UNIVERSITY OF OREGON",0,1,2002,3272,1834,1438,1353,500,853,0.465,0.414,0.348,2907,389.440286,704,2565,0.783924205378973
"9576",209551,"UNIVERSITY OF OREGON",0,1,2003,2826,1594,1232,1300,519,781,0.49,0.46,0.421,3543,404.908979,706,2158,0.763623496107573
"9577",209551,"UNIVERSITY OF OREGON",0,1,2004,3138,1734,1404,1377,539,838,0.483,0.439,0.384,4077,430.660847,703,2466,0.78585086042065
"9578",209551,"University of Oregon",0,1,2005,3138,1721,1417,1282,506,776,0.451,0.409,0.357,4164,437.477773,734,2457,0.782982791586998
"9579",209551,"University of Oregon",0,1,2006,3349,1821,1528,1468,575,893,0.49,0.438,0.376,4341,489.163056,713,2555,0.762914302776948
"9580",209551,"University of Oregon",0,1,2007,3505,1839,1666,1528,629,899,0.489,0.436,0.378,4494,513.742655,750,2622,0.748074179743224
"9581",209551,"University of Oregon",0,1,2008,4191,2129,2062,1903,824,1079,0.507,0.454,0.4,5202,557.786807,761,3198,0.763063707945598
"9582",209551,"University of Oregon",0,1,2009,3788,2027,1761,1900,778,1122,0.553,0.502,0.442,6180,610.945331,782,2814,0.742872228088701
"9583",209551,"University of Oregon",0,1,2010,3911,2065,1846,1953,790,1163,0.563,0.499,0.428,6930,651.350814,836,2808,0.717974942469957
"9584",209612,"PACIFIC UNIVERSITY",1,0,1991,261,154,107,93,38,55,0.357,0.356,0.355,11200,23.782608,101,220,0.842911877394636
"9585",209612,"PACIFIC UNIVERSITY",1,0,1992,226,142,84,103,39,64,0.451,0.456,0.464,12320,25.677355,101,170,0.752212389380531
"9586",209612,"PACIFIC UNIVERSITY",1,0,1993,280,164,116,126,47,79,0.482,0.45,0.405,13470,28.203176,108,195,0.696428571428571
"9587",209612,"PACIFIC UNIVERSITY",1,0,1995,242,153,89,108,33,75,0.49,0.446,0.371,14920,32.335903,123,182,0.752066115702479
"9588",209612,"PACIFIC UNIVERSITY",1,0,1996,268,179,89,117,36,81,0.452,0.437,0.404,15654,34.036336,131,200,0.746268656716418
"9589",209612,"PACIFIC UNIVERSITY",1,0,1997,261,175,86,129,39,90,0.514,0.494,0.453,16220,30.430065,126,208,0.796934865900383
"9590",209612,"PACIFIC UNIVERSITY",1,0,1998,246,157,89,133,39,94,0.599,0.541,0.438,16694,31.077363,139,175,0.711382113821138
"9591",209612,"PACIFIC UNIVERSITY",1,0,1999,292,175,117,164,70,94,0.537,0.562,0.598,16800,32.334891,163,190,0.650684931506849
"9592",209612,"PACIFIC UNIVERSITY",1,0,2000,303,198,105,158,58,100,0.505,0.521,0.552,17305,37.571583,157,229,0.755775577557756
"9593",209612,"PACIFIC UNIVERSITY",1,0,2001,310,206,104,171,47,124,0.602,0.552,0.452,18000,41.014474,151,224,0.72258064516129
"9594",209612,"PACIFIC UNIVERSITY",1,0,2002,275,166,109,171,64,107,0.645,0.622,0.587,18766,42.259736,179,201,0.730909090909091
"9595",209612,"PACIFIC UNIVERSITY",1,0,2003,303,174,129,158,58,100,0.575,0.521,0.45,19330,42.992161,174,212,0.6996699669967
"9596",209612,"PACIFIC UNIVERSITY",1,0,2004,294,181,113,164,62,102,0.564,0.558,0.549,20104,44.541561,173,184,0.625850340136054
"9597",209612,"Pacific University",1,0,2005,324,204,120,165,52,113,0.554,0.509,0.433,20908,46.777169,175,223,0.688271604938272
"9598",209612,"Pacific University",1,0,2006,360,206,154,194,72,122,0.592,0.539,0.468,21954,54.365067,196,202,0.561111111111111
"9599",209612,"Pacific University",1,0,2007,372,242,130,194,59,135,0.558,0.522,0.454,25830,58.708951,201,233,0.626344086021505
"9600",209612,"Pacific University",1,0,2008,345,227,118,174,60,114,0.502,0.504,0.508,27604,68.314396,205,207,0.6
"9601",209612,"Pacific University",1,0,2009,333,204,129,213,82,131,0.642,0.64,0.636,29290,77.237459,208,199,0.597597597597598
"9602",209612,"Pacific University",1,0,2010,474,231,243,229,109,120,0.52,0.483,0.449,30990,78.972576,216,259,0.546413502109705
"9603",209807,"PORTLAND STATE UNIVERSITY",0,1,1991,670,330,340,86,34,52,0.158,0.128,0.1,2538,99.591883,423,411,0.613432835820895
"9604",209807,"PORTLAND STATE UNIVERSITY",0,1,1992,651,343,308,94,42,52,0.152,0.144,0.136,2658,106.172077,441,417,0.640552995391705
"9605",209807,"PORTLAND STATE UNIVERSITY",0,1,1993,684,330,354,74,31,43,0.13,0.108,0.088,2826,112.152691,411,430,0.628654970760234
"9606",209807,"PORTLAND STATE UNIVERSITY",0,1,1995,682,358,324,82,29,53,0.148,0.12,0.09,3183,127.223032,450,463,0.678885630498534
"9607",209807,"PORTLAND STATE UNIVERSITY",0,1,1996,726,351,375,97,34,63,0.18,0.134,0.091,3342,135.686015,473,436,0.600550964187328
"9608",209807,"PORTLAND STATE UNIVERSITY",0,1,1997,743,368,375,96,37,59,0.16,0.129,0.099,3357,143.840258,468,481,0.647375504710633
"9609",209807,"PORTLAND STATE UNIVERSITY",0,1,1998,800,419,381,101,28,73,0.174,0.126,0.073,3438,152.736256,469,511,0.63875
"9610",209807,"PORTLAND STATE UNIVERSITY",0,1,1999,896,496,400,118,39,79,0.159,0.132,0.098,2694,163.524622,462,581,0.6484375
"9611",209807,"PORTLAND STATE UNIVERSITY",0,1,2000,915,480,435,133,50,83,0.173,0.145,0.115,2694,185.502569,509.5,564,0.616393442622951
"9612",209807,"PORTLAND STATE UNIVERSITY",0,1,2001,1020,548,472,129,42,87,0.159,0.126,0.089,2808,196.656614,557,622,0.609803921568628
"9613",209807,"PORTLAND STATE UNIVERSITY",0,1,2002,1177,632,545,153,43,110,0.174,0.13,0.079,2892,215.92142,581,787,0.668649107901444
"9614",209807,"PORTLAND STATE UNIVERSITY",0,1,2003,1264,668,596,159,55,104,0.156,0.126,0.092,3240,226.159015,518,799,0.632120253164557
"9615",209807,"PORTLAND STATE UNIVERSITY",0,1,2004,1173,627,546,167,51,116,0.185,0.142,0.093,3690,242.441717,551,778,0.663256606990622
"9616",209807,"Portland State University",0,1,2005,1200,636,564,172,66,106,0.167,0.143,0.117,3810,263.196305,583,734,0.611666666666667
"9617",209807,"Portland State University",0,1,2006,1283,695,588,200,67,133,0.191,0.156,0.114,3930,294.805442,627,828,0.645362431800468
"9618",209807,"Portland State University",0,1,2007,1427,759,668,252,93,159,0.21,0.177,0.139,4314,305.119957,644,904,0.633496846531184
"9619",209807,"Portland State University",0,1,2008,1567,839,728,264,105,159,0.19,0.168,0.144,4905,336.600912,687,982,0.626675175494576
"9620",209807,"Portland State University",0,1,2009,1551,800,751,296,109,187,0.234,0.191,0.145,5321,385.628548,680,957,0.617021276595745
"9621",209807,"Portland State University",0,1,2010,1366,733,633,288,123,165,0.225,0.211,0.194,5648,397.947537,711,783,0.573206442166911
"9622",209922,"REED COLLEGE",1,0,1991,292,146,146,139,71,68,0.466,0.476,0.486,16700,23.666794,113,226,0.773972602739726
"9623",209922,"REED COLLEGE",1,0,1992,310,173,137,148,58,90,0.52,0.477,0.423,18190,29.049486,109,218,0.703225806451613
"9624",209922,"REED COLLEGE",1,0,1993,328,171,157,148,80,68,0.398,0.451,0.51,19250,28.997688,96,251,0.765243902439024
"9625",209922,"REED COLLEGE",1,0,1995,352,188,164,166,78,88,0.468,0.472,0.476,20760,32.433654,111,249,0.707386363636364
"9626",209922,"REED COLLEGE",1,0,1996,357,200,157,159,59,100,0.5,0.445,0.376,21490,41.234334,108,252,0.705882352941177
"9627",209922,"REED COLLEGE",1,0,1997,315,176,139,146,59,87,0.494,0.463,0.424,22340,34.892359,104,212,0.673015873015873
"9628",209922,"REED COLLEGE",1,0,1998,338,164,174,165,86,79,0.482,0.488,0.494,23120,39.365754,111,220,0.650887573964497
"9629",209922,"REED COLLEGE",1,0,1999,331,182,149,172,78,94,0.516,0.52,0.523,23880,39.883738,111,254,0.767371601208459
"9630",209922,"REED COLLEGE",1,0,2000,358,202,156,204,79,125,0.619,0.57,0.506,24820,47.100528,116.5,234,0.653631284916201
"9631",209922,"REED COLLEGE",1,0,2001,349,198,151,203,84,119,0.601,0.582,0.556,26060,46.455805,122,229,0.656160458452722
"9632",209922,"REED COLLEGE",1,0,2002,307,160,147,182,79,103,0.644,0.593,0.537,27360,55.141428,122,207,0.674267100977199
"9633",209922,"REED COLLEGE",1,0,2003,297,153,144,169,74,95,0.621,0.569,0.514,29000,61.213552,137,195,0.656565656565657
"9634",209922,"REED COLLEGE",1,0,2004,333,186,147,199,78,121,0.65,0.598,0.531,30670,59.348643,122,192,0.576576576576577
"9635",209922,"Reed College",1,0,2005,348,197,151,204,80,124,0.629,0.586,0.53,32360,61.497745,135,222,0.637931034482759
"9636",209922,"Reed College",1,0,2006,371,207,164,222,91,131,0.633,0.598,0.555,34300,58.652791,140,229,0.617250673854447
"9637",209922,"Reed College",1,0,2007,337,187,150,236,99,137,0.733,0.7,0.66,36190,65.580304,149,189,0.560830860534125
"9638",209922,"Reed College",1,0,2008,329,194,135,219,88,131,0.675,0.666,0.652,37960,69.553401,155,164,0.498480243161094
"9639",209922,"Reed College",1,0,2009,367,192,175,253,122,131,0.682,0.689,0.697,39440,71.715586,145,193,0.525885558583106
"9640",209922,"Reed College",1,0,2010,373,212,161,247,105,142,0.67,0.662,0.652,40940,72.588624,141,246,0.659517426273458
"9641",210146,"SOUTHERN OREGON STATE COLLEGE",0,1,1991,553,303,250,66,26,40,0.132,0.119,0.104,2415,40.539347,176,491,0.887884267631103
"9642",210146,"SOUTHERN OREGON STATE COLLEGE",0,1,1992,588,301,287,63,24,39,0.13,0.107,0.084,2487,41.984363,171,510,0.86734693877551
"9643",210146,"SOUTHERN OREGON STATE COLLEGE",0,1,1993,601,324,277,75,19,56,0.173,0.125,0.069,2667,44.496484,161,523,0.870216306156406
"9644",210146,"SOUTHERN OREGON STATE COLLEGE",0,1,1995,661,362,299,89,33,56,0.155,0.135,0.11,2949,45.797588,164,554,0.838124054462935
"9645",210146,"SOUTHERN OREGON STATE COLLEGE",0,1,1996,701,388,313,111,48,63,0.162,0.158,0.153,3147,50.818268,182,605,0.863052781740371
"9646",210146,"SOUTHERN OREGON UNIVERSITY",0,1,1997,759,426,333,142,47,95,0.223,0.187,0.141,3204,50.976969,170,631,0.831357048748353
"9647",210146,"SOUTHERN OREGON UNIVERSITY",0,1,1998,670,403,267,124,40,84,0.208,0.185,0.15,3198,52.670135,165,554,0.826865671641791
"9648",210146,"SOUTHERN OREGON UNIVERSITY",0,1,1999,754,431,323,136,46,90,0.209,0.18,0.142,2520,57.178674,175,611,0.810344827586207
"9649",210146,"SOUTHERN OREGON UNIVERSITY",0,1,2000,681,390,291,130,45,85,0.218,0.191,0.155,2520,61.758442,182.5,565,0.829662261380323
"9650",210146,"SOUTHERN OREGON UNIVERSITY",0,1,2001,759,436,323,149,47,102,0.234,0.196,0.146,2628,64.302823,190,618,0.814229249011858
"9651",210146,"SOUTHERN OREGON UNIVERSITY",0,1,2002,787,412,375,166,56,110,0.267,0.211,0.149,2706,65.529489,190,646,0.820838627700127
"9652",210146,"SOUTHERN OREGON UNIVERSITY",0,1,2003,896,497,399,158,51,107,0.215,0.176,0.128,3138,64.873874,182,734,0.819196428571429
"9653",210146,"SOUTHERN OREGON UNIVERSITY",0,1,2004,744,409,335,100,30,70,0.171,0.134,0.09,3609,70.206909,185,599,0.80510752688172
"9654",210146,"Southern Oregon University",0,1,2005,707,417,290,110,30,80,0.192,0.156,0.103,3720,67.341554,190,598,0.845827439886846
"9655",210146,"Southern Oregon University",0,1,2006,707,401,306,110,31,79,0.197,0.156,0.101,3831,73.819315,194,568,0.803394625176803
"9656",210146,"Southern Oregon University",0,1,2007,703,405,298,127,37,90,0.222,0.181,0.124,3960,76.012157,185,571,0.812233285917496
"9657",210146,"Southern Oregon University",0,1,2008,675,407,268,147,46,101,0.248,0.218,0.172,4326,79.605748,185,517,0.765925925925926
"9658",210146,"Southern Oregon University",0,1,2009,652,378,274,131,37,94,0.249,0.201,0.135,4788,83.96418,196,516,0.791411042944785
"9659",210146,"Southern Oregon University",0,1,2010,735,435,300,176,55,121,0.278,0.239,0.183,4914,82.111778,196,557,0.757823129251701
"9660",210401,"WILLAMETTE UNIVERSITY",1,0,1991,390,221,169,253,99,154,0.697,0.649,0.586,12480,36.96,145,304,0.779487179487179
"9661",210401,"WILLAMETTE UNIVERSITY",1,0,1992,385,231,154,256,103,153,0.662,0.665,0.669,13030,39.995,154,308,0.8
"9662",210401,"WILLAMETTE UNIVERSITY",1,0,1993,381,218,163,249,101,148,0.679,0.654,0.62,13665,43.281,145,297,0.779527559055118
"9663",210401,"WILLAMETTE UNIVERSITY",1,0,1995,432,248,184,330,132,198,0.798,0.764,0.717,16400,50.011,164,349,0.80787037037037
"9664",210401,"WILLAMETTE UNIVERSITY",1,0,1996,419,241,178,304,115,189,0.784,0.726,0.646,18300,51.826715,153,321,0.766109785202864
"9665",210401,"WILLAMETTE UNIVERSITY",1,0,1997,410,224,186,299,131,168,0.75,0.729,0.704,20200,44.175,168,295,0.719512195121951
"9666",210401,"WILLAMETTE UNIVERSITY",1,0,1998,406,236,170,263,105,158,0.67,0.648,0.618,21000,46.057796,170,293,0.721674876847291
"9667",210401,"WILLAMETTE UNIVERSITY",1,0,1999,363,190,173,242,100,142,0.747,0.667,0.578,21700,47.724214,172,224,0.617079889807163
"9668",210401,"WILLAMETTE UNIVERSITY",1,0,2000,506,292,214,336,124,212,0.726,0.664,0.579,22700,49.857007,165,312,0.616600790513834
"9669",210401,"WILLAMETTE UNIVERSITY",1,0,2001,476,261,215,345,143,202,0.774,0.725,0.665,23150,54.182,158,328,0.689075630252101
"9670",210401,"WILLAMETTE UNIVERSITY",1,0,2002,353,181,172,210,92,118,0.652,0.595,0.535,24050,58.172,176,207,0.586402266288952
"9671",210401,"WILLAMETTE UNIVERSITY",1,0,2003,541,312,229,383,143,240,0.769,0.708,0.624,25300,58.483,185,330,0.609981515711645
"9672",210401,"WILLAMETTE UNIVERSITY",1,0,2004,510,284,226,361,155,206,0.725,0.708,0.686,26690,63.145,193,315,0.617647058823529
"9673",210401,"Willamette University",1,0,2005,440,240,200,307,130,177,0.738,0.698,0.65,28250,66.125,210,270,0.613636363636364
"9674",210401,"Willamette University",1,0,2006,482,260,222,333,139,194,0.746,0.691,0.626,29850,70.757,215,286,0.593360995850622
"9675",210401,"Willamette University",1,0,2007,444,238,206,315,130,185,0.777,0.709,0.631,31760,76.15,200,271,0.61036036036036
"9676",210401,"Willamette University",1,0,2008,482,278,204,333,129,204,0.734,0.691,0.632,33750,81.675,203,307,0.636929460580913
"9677",210401,"Willamette University",1,0,2009,541,294,247,384,165,219,0.745,0.71,0.668,35400,85.241,214,358,0.66173752310536
"9678",210401,"Willamette University",1,0,2010,427,235,192,301,119,182,0.775,0.705,0.62,37150,88.634,226,300,0.702576112412178
"9679",210429,"WESTERN OREGON STATE COLLEGE",0,1,1991,576,367,209,98,22,76,0.207,0.17,0.105,2406,37.881271,146,519,0.901041666666667
"9680",210429,"WESTERN OREGON STATE COLLEGE",0,1,1992,626,394,232,112,36,76,0.193,0.179,0.155,2481,38.995502,155,569,0.908945686900958
"9681",210429,"WESTERN OREGON STATE COLLEGE",0,1,1993,675,404,271,133,31,102,0.252,0.197,0.114,2637,41.232888,155,599,0.887407407407407
"9682",210429,"WESTERN OREGON STATE COLLEGE",0,1,1995,641,380,261,95,22,73,0.192,0.148,0.084,2985,43.838863,148,563,0.878315132605304
"9683",210429,"WESTERN OREGON STATE COLLEGE",0,1,1996,742,448,294,107,33,74,0.165,0.144,0.112,3099,45.212526,160,640,0.862533692722372
"9684",210429,"WESTERN OREGON UNIVERSITY",0,1,1997,759,481,278,103,35,68,0.141,0.136,0.126,3153,46.360049,161,645,0.849802371541502
"9685",210429,"WESTERN OREGON UNIVERSITY",0,1,1998,700,425,275,116,26,90,0.212,0.166,0.095,3198,47.739252,158,609,0.87
"9686",210429,"WESTERN OREGON UNIVERSITY",0,1,1999,770,460,310,141,45,96,0.209,0.183,0.145,2520,49.10405,159,664,0.862337662337662
"9687",210429,"WESTERN OREGON UNIVERSITY",0,1,2000,825,524,301,176,55,121,0.231,0.213,0.183,2520,53.496735,158.5,692,0.838787878787879
"9688",210429,"WESTERN OREGON UNIVERSITY",0,1,2001,811,536,275,144,25,119,0.222,0.178,0.091,2622,57.553903,158,653,0.80517879161529
"9689",210429,"WESTERN OREGON UNIVERSITY",0,1,2002,769,466,303,142,36,106,0.228,0.185,0.119,2700,58.558125,162,649,0.843953185955787
"9690",210429,"WESTERN OREGON UNIVERSITY",0,1,2003,903,555,348,144,37,107,0.193,0.159,0.106,3240,62.35002,156,771,0.853820598006645
"9691",210429,"WESTERN OREGON UNIVERSITY",0,1,2004,795,447,348,138,55,83,0.186,0.174,0.158,3240,63.827472,164,635,0.79874213836478
"9692",210429,"Western Oregon University",0,1,2005,849,511,338,132,36,96,0.188,0.155,0.107,3366,69.378177,175,658,0.775029446407538
"9693",210429,"Western Oregon University",0,1,2006,750,485,265,150,40,110,0.227,0.2,0.151,3510,70.509927,162,557,0.742666666666667
"9694",210429,"Western Oregon University",0,1,2007,916,527,389,184,54,130,0.247,0.201,0.139,4500,70.646969,176,679,0.741266375545852
"9695",210429,"Western Oregon University",0,1,2008,882,524,358,197,58,139,0.265,0.223,0.162,5175,82.790303,189,658,0.746031746031746
"9696",210429,"Western Oregon University",0,1,2009,933,553,380,192,39,153,0.277,0.206,0.103,5640,87.111407,195,691,0.740621650589496
"9697",210429,"Western Oregon University",0,1,2010,1039,636,403,204,45,159,0.25,0.196,0.112,6135,88.126802,190,722,0.694898941289702
"9698",210571,"ALBRIGHT COLLEGE",1,0,1991,236,120,116,143,58,85,0.708,0.606,0.5,13560,25.439109,89,199,0.843220338983051
"9699",210571,"ALBRIGHT COLLEGE",1,0,1992,310,135,175,160,81,79,0.585,0.516,0.463,13960,26.543247,85,267,0.861290322580645
"9700",210571,"ALBRIGHT COLLEGE",1,0,1993,227,140,87,147,50,97,0.693,0.648,0.575,15010,27.616215,79,204,0.898678414096916
"9701",210571,"ALBRIGHT COLLEGE",1,0,1995,312,153,159,169,66,103,0.673,0.542,0.415,16575,25.658668,60,260,0.833333333333333
"9702",210571,"ALBRIGHT COLLEGE",1,0,1996,354,190,164,215,77,138,0.726,0.607,0.47,17395,28.796805,63,310,0.875706214689266
"9703",210571,"ALBRIGHT COLLEGE",1,0,1997,295,137,158,176,83,93,0.679,0.597,0.525,18310,23.41853,67,248,0.840677966101695
"9704",210571,"ALBRIGHT COLLEGE",1,0,1998,355,187,168,176,71,105,0.561,0.496,0.423,18890,25.094981,71,301,0.847887323943662
"9705",210571,"ALBRIGHT COLLEGE",1,0,1999,392,242,150,203,61,142,0.587,0.518,0.407,18910,27.508666,73,311,0.793367346938776
"9706",210571,"ALBRIGHT COLLEGE",1,0,2000,407,231,176,207,84,123,0.532,0.509,0.477,19760,30.531344,82,319,0.783783783783784
"9707",210571,"ALBRIGHT COLLEGE",1,0,2001,402,243,159,215,75,140,0.576,0.535,0.472,20750,33.50108,91,323,0.803482587064677
"9708",210571,"ALBRIGHT COLLEGE",1,0,2002,453,250,203,254,104,150,0.6,0.561,0.512,21790,35.571753,104,352,0.777041942604856
"9709",210571,"ALBRIGHT COLLEGE",1,0,2003,456,259,197,252,96,156,0.602,0.553,0.487,22880,39.083084,109,363,0.796052631578947
"9710",210571,"ALBRIGHT COLLEGE",1,0,2004,505,319,186,268,86,182,0.571,0.531,0.462,24030,42.142403,115,389,0.77029702970297
"9711",210571,"Albright College",1,0,2005,450,254,196,234,85,149,0.587,0.52,0.434,25232,43.134832,113,350,0.777777777777778
"9712",210571,"Albright College",1,0,2006,458,233,225,210,87,123,0.528,0.459,0.387,26620,44.266076,118,347,0.75764192139738
"9713",210571,"Albright College",1,0,2007,512,307,205,247,90,157,0.511,0.482,0.439,28084,44.903314,114,412,0.8046875
"9714",210571,"Albright College",1,0,2008,505,260,245,224,86,138,0.531,0.444,0.351,29770,46.491275,125,347,0.687128712871287
"9715",210571,"Albright College",1,0,2009,541,317,224,268,83,185,0.584,0.495,0.371,30800,48.460602,121,376,0.695009242144177
"9716",210571,"Albright College",1,0,2010,485,255,230,230,90,140,0.549,0.474,0.391,31940,49.294231,124,325,0.670103092783505
"9717",210669,"ALLEGHENY COLLEGE",1,0,1991,606,289,317,354,173,181,0.626,0.584,0.546,14850,41.167828,139,545,0.899339933993399
"9718",210669,"ALLEGHENY COLLEGE",1,0,1992,471,251,220,295,114,181,0.721,0.626,0.518,15750,44.944225,137,428,0.908704883227176
"9719",210669,"ALLEGHENY COLLEGE",1,0,1993,481,247,234,301,126,175,0.708,0.626,0.538,16700,43.045117,144,446,0.927234927234927
"9720",210669,"ALLEGHENY COLLEGE",1,0,1995,564,284,280,353,162,191,0.672,0.626,0.579,18020,49.883995,141,516,0.914893617021277
"9721",210669,"ALLEGHENY COLLEGE",1,0,1996,523,311,212,346,125,221,0.711,0.662,0.59,18720,50.497422,142,505,0.965583173996176
"9722",210669,"ALLEGHENY COLLEGE",1,0,1997,541,289,252,328,139,189,0.654,0.606,0.552,19360,38.764089,133,510,0.942698706099815
"9723",210669,"ALLEGHENY COLLEGE",1,0,1998,545,272,273,321,144,177,0.651,0.589,0.527,20020,41.880797,128,487,0.893577981651376
"9724",210669,"ALLEGHENY COLLEGE",1,0,1999,562,284,278,374,167,207,0.729,0.665,0.601,20410,42.441535,131,521,0.927046263345196
"9725",210669,"ALLEGHENY COLLEGE",1,0,2000,561,291,270,393,175,218,0.749,0.701,0.648,21290,42.500346,133,538,0.959001782531194
"9726",210669,"ALLEGHENY COLLEGE",1,0,2001,486,271,215,312,128,184,0.679,0.642,0.595,22210,44.964829,135,443,0.911522633744856
"9727",210669,"ALLEGHENY COLLEGE",1,0,2002,536,271,265,374,165,209,0.771,0.698,0.623,23100,49.257628,137,500,0.932835820895522
"9728",210669,"ALLEGHENY COLLEGE",1,0,2003,478,234,244,317,143,174,0.744,0.663,0.586,24100,52.294981,139,434,0.907949790794979
"9729",210669,"ALLEGHENY COLLEGE",1,0,2004,647,341,306,465,206,259,0.76,0.719,0.673,25250,52.081504,145,604,0.933539412673879
"9730",210669,"Allegheny College",1,0,2005,561,311,250,424,181,243,0.781,0.756,0.724,26650,54.080233,143,515,0.918003565062389
"9731",210669,"Allegheny College",1,0,2006,570,322,248,398,159,239,0.742,0.698,0.641,28000,56.033467,149,528,0.926315789473684
"9732",210669,"Allegheny College",1,0,2007,581,351,230,431,159,272,0.775,0.742,0.691,29680,59.654849,157,517,0.889845094664372
"9733",210669,"Allegheny College",1,0,2008,562,306,256,412,179,233,0.761,0.733,0.699,31680,63.532193,163,481,0.855871886120996
"9734",210669,"Allegheny College",1,0,2009,580,299,281,395,177,218,0.729,0.681,0.63,33240,65.426963,160,493,0.85
"9735",210669,"Allegheny College",1,0,2010,594,332,262,415,173,242,0.729,0.699,0.66,34490,70.25703,166,489,0.823232323232323
"9736",210775,"ALVERNIA COLLEGE",1,0,1991,194,128,66,56,16,40,0.312,0.289,0.242,6935,7.537156,51,188,0.969072164948454
"9737",210775,"ALVERNIA COLLEGE",1,0,1992,182,103,79,26,7,19,0.184,0.143,0.089,7995,9.219578,57,172,0.945054945054945
"9738",210775,"ALVERNIA COLLEGE",1,0,1993,157,103,54,48,14,34,0.33,0.306,0.259,8419,11.115922,60,152,0.968152866242038
"9739",210775,"ALVERNIA COLLEGE",1,0,1995,150,76,74,46,14,32,0.421,0.307,0.189,9850,13.03452,62,133,0.886666666666667
"9740",210775,"ALVERNIA COLLEGE",1,0,1996,143,73,70,44,16,28,0.384,0.308,0.229,10700,14.27687,57,137,0.958041958041958
"9741",210775,"ALVERNIA COLLEGE",1,0,1997,155,95,60,64,26,38,0.4,0.413,0.433,11320,11.956881,54,145,0.935483870967742
"9742",210775,"ALVERNIA COLLEGE",1,0,1998,168,93,75,56,16,40,0.43,0.333,0.213,11680,12.377633,51,149,0.886904761904762
"9743",210775,"ALVERNIA COLLEGE",1,0,1999,204,101,103,79,34,45,0.446,0.387,0.33,11730,13.55882,52,169,0.82843137254902
"9744",210775,"ALVERNIA COLLEGE",1,0,2000,236,149,87,70,22,48,0.322,0.297,0.253,12950,15.228517,55,197,0.834745762711864
"9745",210775,"ALVERNIA COLLEGE",1,0,2001,248,159,89,90,28,62,0.39,0.363,0.315,14000,17.732927,58,213,0.858870967741935
"9746",210775,"ALVERNIA COLLEGE",1,0,2002,242,153,89,89,29,60,0.392,0.368,0.326,15000,18.754978,58,197,0.814049586776859
"9747",210775,"ALVERNIA COLLEGE",1,0,2003,278,165,113,99,32,67,0.406,0.356,0.283,16200,22.916348,65,240,0.863309352517986
"9748",210775,"ALVERNIA COLLEGE",1,0,2004,310,197,113,123,29,94,0.477,0.397,0.257,17500,24.675033,69,242,0.780645161290323
"9749",210775,"Alvernia College",1,0,2005,262,149,113,100,35,65,0.436,0.382,0.31,18900,28.071997,74,213,0.812977099236641
"9750",210775,"Alvernia College",1,0,2006,300,188,112,114,43,71,0.378,0.38,0.384,20220,31.81719,75,237,0.79
"9751",210775,"Alvernia College",1,0,2007,302,165,137,107,48,59,0.358,0.354,0.35,21400,35.320036,81,268,0.887417218543046
"9752",210775,"Alvernia College",1,0,2008,383,233,150,148,44,104,0.446,0.386,0.293,22800,36.959797,85,329,0.859007832898172
"9753",210775,"Alvernia University",1,0,2009,328,188,140,124,53,71,0.378,0.378,0.379,23900,40.942323,85,264,0.804878048780488
"9754",210775,"Alvernia University",1,0,2010,388,268,120,142,39,103,0.384,0.366,0.325,24980,41.517205,89,322,0.829896907216495
"9755",211088,"BEAVER COLLEGE",1,0,1991,140,110,30,92,13,79,0.718,0.657,0.433,10960,27.696513,72,117,0.835714285714286
"9756",211088,"BEAVER COLLEGE",1,0,1992,163,120,43,81,15,66,0.55,0.497,0.349,11710,30.139573,66,140,0.858895705521472
"9757",211088,"BEAVER COLLEGE",1,0,1993,227,166,61,131,35,96,0.578,0.577,0.574,12510,30.297524,68,187,0.823788546255507
"9758",211088,"BEAVER COLLEGE",1,0,1995,257,186,71,145,36,109,0.586,0.564,0.507,13970,34.217332,73,213,0.828793774319066
"9759",211088,"BEAVER COLLEGE",1,0,1996,292,219,73,131,29,102,0.466,0.449,0.397,14870,37.519,83,217,0.743150684931507
"9760",211088,"BEAVER COLLEGE",1,0,1997,260,191,69,142,34,108,0.565,0.546,0.493,15840,36.616,78,203,0.780769230769231
"9761",211088,"BEAVER COLLEGE",1,0,1998,334,248,86,189,46,143,0.577,0.566,0.535,16520,39.676,88,272,0.81437125748503
"9762",211088,"BEAVER COLLEGE",1,0,1999,307,238,69,154,28,126,0.529,0.502,0.406,16880,28.845,95,262,0.853420195439739
"9763",211088,"BEAVER COLLEGE",1,0,2000,294,228,66,147,27,120,0.526,0.5,0.409,17550,32.027,91,228,0.775510204081633
"9764",211088,"ARCADIA UNIVERSITY",1,0,2001,293,203,90,158,47,111,0.547,0.539,0.522,18390,34.567,87,244,0.832764505119454
"9765",211088,"ARCADIA UNIVERSITY",1,0,2002,399,308,91,237,55,182,0.591,0.594,0.604,19660,38.234,90,327,0.819548872180451
"9766",211088,"ARCADIA UNIVERSITY",1,0,2003,489,360,129,259,77,182,0.506,0.53,0.597,20990,40.681,93,409,0.83640081799591
"9767",211088,"ARCADIA UNIVERSITY",1,0,2004,476,343,133,247,67,180,0.525,0.519,0.504,22440,45.242,107,398,0.836134453781513
"9768",211088,"Arcadia University",1,0,2005,432,315,117,232,59,173,0.549,0.537,0.504,23990,49.388,108,353,0.81712962962963
"9769",211088,"Arcadia University",1,0,2006,572,452,120,336,72,264,0.584,0.587,0.6,25650,55.383,108,470,0.821678321678322
"9770",211088,"Arcadia University",1,0,2007,476,364,112,253,53,200,0.549,0.532,0.473,27440,60.602,118,395,0.829831932773109
"9771",211088,"Arcadia University",1,0,2008,593,434,159,294,73,221,0.509,0.496,0.459,29340,64.555,125,302,0.509274873524452
"9772",211088,"Arcadia University",1,0,2009,529,381,148,257,70,187,0.491,0.486,0.473,30780,66.496,125,398,0.752362948960302
"9773",211088,"Arcadia University",1,0,2010,552,397,155,317,75,242,0.61,0.574,0.484,32140,68.903,125,404,0.731884057971015
"9774",211158,"BLOOMSBURG UNIVERSITY OF PENNSYLVANIA",1,0,1991,1080,664,416,443,132,311,0.468,0.41,0.317,2968,63.270594,339,1010,0.935185185185185
"9775",211158,"BLOOMSBURG UNIVERSITY OF PENNSYLVANIA",1,0,1992,1047,696,351,423,87,336,0.483,0.404,0.248,3068,67.237083,338,951,0.908309455587393
"9776",211158,"BLOOMSBURG UNIVERSITY OF PENNSYLVANIA",1,0,1993,1017,615,402,379,115,264,0.429,0.373,0.286,3458,69.034099,348,925,0.909537856440511
"9777",211158,"BLOOMSBURG UNIVERSITY OF PENNSYLVANIA",1,0,1995,1054,689,365,372,88,284,0.412,0.353,0.241,3915,77.504511,338,974,0.924098671726755
"9778",211158,"BLOOMSBURG UNIVERSITY OF PENNSYLVANIA",1,0,1996,1556,994,562,567,147,420,0.422,0.364,0.262,4162,85.340435,330,1469,0.944087403598972
"9779",211158,"BLOOMSBURG UNIVERSITY OF PENNSYLVANIA",1,0,1997,1355,893,462,459,125,334,0.374,0.339,0.271,4277,84.247284,337,1242,0.916605166051661
"9780",211158,"BLOOMSBURG UNIVERSITY OF PENNSYLVANIA",1,0,1998,1377,890,487,465,102,363,0.408,0.338,0.209,4277,90.873702,334,1261,0.915758896151053
"9781",211158,"BLOOMSBURG UNIVERSITY OF PENNSYLVANIA",1,0,1999,1402,891,511,527,164,363,0.407,0.376,0.321,3618,90.022184,325,1299,0.926533523537803
"9782",211158,"BLOOMSBURG UNIVERSITY OF PENNSYLVANIA",1,0,2000,1414,912,502,587,153,434,0.476,0.415,0.305,3792,100.310729,326,1325,0.937057991513437
"9783",211158,"BLOOMSBURG UNIVERSITY OF PENNSYLVANIA",1,0,2001,1684,1021,663,646,183,463,0.454,0.384,0.276,4016,99.050708,327,1564,0.92874109263658
"9784",211158,"BLOOMSBURG UNIVERSITY OF PENNSYLVANIA",1,0,2002,1478,938,540,650,169,481,0.513,0.44,0.313,4378,100.175225,350,1337,0.904600811907984
"9785",211158,"BLOOMSBURG UNIVERSITY OF PENNSYLVANIA",1,0,2003,1665,1000,665,677,201,476,0.476,0.407,0.302,4598,104.071795,352,1481,0.889489489489489
"9786",211158,"BLOOMSBURG UNIVERSITY OF PENNSYLVANIA",1,0,2004,1533,947,586,631,198,433,0.457,0.412,0.338,4810,109.929509,350,1296,0.845401174168297
"9787",211158,"Bloomsburg University of Pennsylvania",1,0,2005,1690,1050,640,693,207,486,0.463,0.41,0.323,4906,113.731592,357,1411,0.83491124260355
"9788",211158,"Bloomsburg University of Pennsylvania",1,0,2006,1630,987,643,696,221,475,0.481,0.427,0.344,5038,119.043419,366,1329,0.815337423312883
"9789",211158,"Bloomsburg University of Pennsylvania",1,0,2007,1679,969,710,710,237,473,0.488,0.423,0.334,5177,128.282483,379,1332,0.793329362715902
"9790",211158,"Bloomsburg University of Pennsylvania",1,0,2008,1805,1028,777,781,263,518,0.504,0.433,0.338,5358,136.792528,378,1432,0.793351800554017
"9791",211158,"Bloomsburg University of Pennsylvania",1,0,2009,2031,1221,810,772,252,520,0.426,0.38,0.311,5554,143.407293,397,1554,0.765140324963072
"9792",211158,"Bloomsburg University of Pennsylvania",1,0,2010,2136,1263,873,808,251,557,0.441,0.378,0.288,5804,155.090392,403,1768,0.827715355805243
"9793",211291,"BUCKNELL UNIVERSITY",1,0,1991,907,410,497,776,408,368,0.898,0.856,0.821,15650,79.155308,238,827,0.911797133406836
"9794",211291,"BUCKNELL UNIVERSITY",1,0,1992,890,426,464,739,376,363,0.852,0.83,0.81,16670,84.123199,239,835,0.938202247191011
"9795",211291,"BUCKNELL UNIVERSITY",1,0,1993,854,454,400,717,324,393,0.866,0.84,0.81,17730,88.589,243,785,0.9192037470726
"9796",211291,"BUCKNELL UNIVERSITY",1,0,1995,910,474,436,736,342,394,0.831,0.809,0.784,19470,97.093155,253,788,0.865934065934066
"9797",211291,"BUCKNELL UNIVERSITY",1,0,1996,895,440,455,761,365,396,0.9,0.85,0.802,20360,104.139384,261,798,0.891620111731844
"9798",211291,"BUCKNELL UNIVERSITY",1,0,1997,898,426,472,752,380,372,0.873,0.837,0.805,21210,89.695,261,788,0.87750556792873
"9799",211291,"BUCKNELL UNIVERSITY",1,0,1998,954,468,486,840,427,413,0.883,0.881,0.879,22005,93.223,270,829,0.868972746331237
"9800",211291,"BUCKNELL UNIVERSITY",1,0,1999,886,425,461,764,396,368,0.866,0.862,0.859,22740,99.754,280,763,0.86117381489842
"9801",211291,"BUCKNELL UNIVERSITY",1,0,2000,914,454,460,773,376,397,0.874,0.846,0.817,23698,103.44,284.5,774,0.846827133479212
"9802",211291,"BUCKNELL UNIVERSITY",1,0,2001,913,468,445,784,367,417,0.891,0.859,0.825,25144,109.98,289,787,0.861993428258488
"9803",211291,"BUCKNELL UNIVERSITY",1,0,2002,914,455,459,764,371,393,0.864,0.836,0.808,27340,116.799,323,772,0.844638949671772
"9804",211291,"BUCKNELL UNIVERSITY",1,0,2003,906,462,444,794,374,420,0.909,0.876,0.842,28764,122.964,319,752,0.830022075055188
"9805",211291,"BUCKNELL UNIVERSITY",1,0,2004,906,447,459,813,397,416,0.931,0.897,0.865,30534,127.555,313,735,0.811258278145695
"9806",211291,"Bucknell University",1,0,2005,920,504,416,804,352,452,0.897,0.874,0.846,32592,136.399,323,727,0.790217391304348
"9807",211291,"Bucknell University",1,0,2006,921,458,463,792,383,409,0.893,0.86,0.827,34731,139.972,323,736,0.799131378935939
"9808",211291,"Bucknell University",1,0,2007,887,441,446,774,373,401,0.909,0.873,0.836,37934,151.57,335,743,0.837655016910936
"9809",211291,"Bucknell University",1,0,2008,956,529,427,814,357,457,0.864,0.851,0.836,39434,166.761,369,789,0.825313807531381
"9810",211291,"Bucknell University",1,0,2009,920,466,454,780,371,409,0.878,0.848,0.817,40594,173.61,368,765,0.831521739130435
"9811",211291,"Bucknell University",1,0,2010,929,491,438,782,355,427,0.87,0.842,0.811,42112,172.663,371,741,0.797631862217438
"9812",211352,"CABRINI COLLEGE",1,0,1991,137,93,44,73,19,54,0.581,0.533,0.432,8830,13.059377,43,129,0.941605839416058
"9813",211352,"CABRINI COLLEGE",1,0,1992,161,115,46,91,24,67,0.583,0.565,0.522,9500,14.045635,43,145,0.900621118012422
"9814",211352,"CABRINI COLLEGE",1,0,1993,224,158,66,115,29,86,0.544,0.513,0.439,10232,15.697224,41,210,0.9375
"9815",211352,"CABRINI COLLEGE",1,0,1995,218,150,68,110,25,85,0.567,0.505,0.368,11600,19.243284,42,183,0.839449541284404
"9816",211352,"CABRINI COLLEGE",1,0,1996,247,186,61,114,23,91,0.489,0.462,0.377,12160,22.460002,43,205,0.82995951417004
"9817",211352,"CABRINI COLLEGE",1,0,1997,339,231,108,160,39,121,0.524,0.472,0.361,12700,17.552244,49,301,0.887905604719764
"9818",211352,"CABRINI COLLEGE",1,0,1998,304,209,95,152,35,117,0.56,0.5,0.368,14650,19.364918,54,261,0.858552631578947
"9819",211352,"CABRINI COLLEGE",1,0,1999,248,163,85,124,30,94,0.577,0.5,0.353,15250,21.641219,58,183,0.737903225806452
"9820",211352,"CABRINI COLLEGE",1,0,2000,359,221,138,161,50,111,0.502,0.448,0.362,16150,22.592412,54,298,0.83008356545961
"9821",211352,"CABRINI COLLEGE",1,0,2001,374,221,153,166,50,116,0.525,0.444,0.327,17340,25.93609,50,297,0.794117647058823
"9822",211352,"CABRINI COLLEGE",1,0,2002,408,277,131,191,53,138,0.498,0.468,0.405,18470,27.859807,59,329,0.806372549019608
"9823",211352,"CABRINI COLLEGE",1,0,2003,401,270,131,184,55,129,0.478,0.459,0.42,19670,30.144232,62,344,0.85785536159601
"9824",211352,"CABRINI COLLEGE",1,0,2004,390,257,133,155,45,110,0.428,0.397,0.338,21450,32.80822,63,303,0.776923076923077
"9825",211352,"Cabrini College",1,0,2005,526,385,141,257,60,197,0.512,0.489,0.426,23200,34.600168,64,468,0.889733840304182
"9826",211352,"Cabrini College",1,0,2006,529,337,192,232,63,169,0.501,0.439,0.328,25120,38.7541,61,449,0.848771266540643
"9827",211352,"Cabrini College",1,0,2007,513,329,184,202,66,136,0.413,0.394,0.359,27200,42.239665,65,416,0.810916179337232
"9828",211352,"Cabrini College",1,0,2008,503,341,162,210,62,148,0.434,0.417,0.383,29100,49.445622,68,405,0.805168986083499
"9829",211352,"Cabrini College",1,0,2009,357,237,120,178,57,121,0.51,0.499,0.475,30120,52.029802,70,245,0.686274509803922
"9830",211352,"Cabrini College",1,0,2010,339,222,117,174,47,127,0.572,0.513,0.402,31174,48.87155,72,259,0.76401179941003
"9831",211361,"CALIFORNIA UNIVERSITY OF PENNSYLVANIA",1,0,1991,1107,565,542,141,48,93,0.165,0.127,0.089,3128,55.624037,389,1018,0.919602529358627
"9832",211361,"CALIFORNIA UNIVERSITY OF PENNSYLVANIA",1,0,1992,962,436,526,139,45,94,0.216,0.144,0.086,3384,59.475612,325,888,0.923076923076923
"9833",211361,"CALIFORNIA UNIVERSITY OF PENNSYLVANIA",1,0,1993,951,401,550,145,55,90,0.224,0.152,0.1,3760,61.555104,309,893,0.939011566771819
"9834",211361,"CALIFORNIA UNIVERSITY OF PENNSYLVANIA",1,0,1995,892,465,427,124,45,79,0.17,0.139,0.105,4136,66.481098,317,825,0.924887892376682
"9835",211361,"CALIFORNIA UNIVERSITY OF PENNSYLVANIA",1,0,1996,805,398,407,140,47,93,0.234,0.174,0.115,4304,67.892627,291,731,0.908074534161491
"9836",211361,"CALIFORNIA UNIVERSITY OF PENNSYLVANIA",1,0,1997,942,446,496,163,64,99,0.222,0.173,0.129,4475,67.498074,298,857,0.909766454352442
"9837",211361,"CALIFORNIA UNIVERSITY OF PENNSYLVANIA",1,0,1998,931,480,451,180,68,112,0.233,0.193,0.151,4545,69.324566,302,868,0.932330827067669
"9838",211361,"CALIFORNIA UNIVERSITY OF PENNSYLVANIA",1,0,1999,924,484,440,162,48,114,0.236,0.175,0.109,3618,71.658569,278,869,0.94047619047619
"9839",211361,"CALIFORNIA UNIVERSITY OF PENNSYLVANIA",1,0,2000,840,398,442,187,83,104,0.261,0.223,0.188,3792,74.845086,279,789,0.939285714285714
"9840",211361,"CALIFORNIA UNIVERSITY OF PENNSYLVANIA",1,0,2001,817,413,404,208,84,124,0.3,0.255,0.208,4016,78.932475,280,754,0.922888616891065
"9841",211361,"CALIFORNIA UNIVERSITY OF PENNSYLVANIA",1,0,2002,893,464,429,224,95,129,0.278,0.251,0.221,4378,77.130347,259,622,0.696528555431131
"9842",211361,"CALIFORNIA UNIVERSITY OF PENNSYLVANIA",1,0,2003,982,520,462,251,105,146,0.281,0.256,0.227,4598,82.896663,255,708,0.720977596741344
"9843",211361,"CALIFORNIA UNIVERSITY OF PENNSYLVANIA",1,0,2004,1038,519,519,293,127,166,0.32,0.282,0.245,4810,83.430748,255,780,0.751445086705202
"9844",211361,"California University of Pennsylvania",1,0,2005,1247,640,607,298,119,179,0.28,0.239,0.196,4906,84.830657,263,950,0.761828388131516
"9845",211361,"California University of Pennsylvania",1,0,2006,1260,685,575,313,124,189,0.276,0.248,0.216,5038,93.502731,276,897,0.711904761904762
"9846",211361,"California University of Pennsylvania",1,0,2007,1250,622,628,281,124,157,0.252,0.225,0.197,5178,106.675551,289,946,0.7568
"9847",211361,"California University of Pennsylvania",1,0,2008,1363,748,615,355,130,225,0.301,0.26,0.211,5358,118.157497,292,1091,0.8004402054292
"9848",211361,"California University of Pennsylvania",1,0,2009,1373,679,694,323,156,167,0.246,0.235,0.225,5554,123.783111,287,1009,0.734887108521486
"9849",211361,"California University of Pennsylvania",1,0,2010,1351,711,640,332,136,196,0.276,0.246,0.212,5804,136.756928,278,1107,0.81939304219097
"9850",211431,"CARLOW COLLEGE",1,0,1991,144,138,6,59,2,57,0.413,0.41,0.333,8752,11.714147,46,129,0.895833333333333
"9851",211431,"CARLOW COLLEGE",1,0,1992,159,148,11,50,2,48,0.324,0.314,0.182,9190,12.97346,53,140,0.880503144654088
"9852",211431,"CARLOW COLLEGE",1,0,1993,169,158,11,80,3,77,0.487,0.473,0.273,9650,15.482338,53,151,0.893491124260355
"9853",211431,"CARLOW COLLEGE",1,0,1995,125,122,3,57,2,55,0.451,0.456,0.667,10588,20.32499,60,106,0.848
"9854",211431,"CARLOW COLLEGE",1,0,1996,148,145,3,65,0,65,0.448,0.439,0,11064,23.352957,68,119,0.804054054054054
"9855",211431,"CARLOW COLLEGE",1,0,1997,142,139,3,50,1,49,0.352,0.352,0.333,11708,22.666597,66,117,0.823943661971831
"9856",211431,"CARLOW COLLEGE",1,0,1998,163,157,6,43,3,40,0.255,0.264,0.5,12332,20.709812,62,118,0.723926380368098
"9857",211431,"CARLOW COLLEGE",1,0,1999,130,128,2,47,0,47,0.367,0.362,0,12450,21.987297,61,102,0.784615384615385
"9858",211431,"CARLOW COLLEGE",1,0,2000,180,178,2,85,0,85,0.478,0.472,0,12950,21.404756,60,140,0.777777777777778
"9859",211431,"CARLOW COLLEGE",1,0,2001,177,170,7,65,0,65,0.382,0.367,0,13468,22.112816,59,146,0.824858757062147
"9860",211431,"CARLOW COLLEGE",1,0,2002,238,231,7,79,0,79,0.342,0.332,0,14006,23.431614,60,179,0.752100840336134
"9861",211431,"CARLOW COLLEGE",1,0,2003,236,229,7,71,3,68,0.297,0.301,0.429,14776,24.40597,69,183,0.775423728813559
"9862",211431,"CARLOW UNIVERSITY",1,0,2004,231,226,5,87,1,86,0.38,0.377,0.2,15806,25.720132,75,187,0.80952380952381
"9863",211431,"Carlow University",1,0,2005,273,264,9,102,3,99,0.375,0.374,0.333,16754,27.469236,70,234,0.857142857142857
"9864",211431,"Carlow University",1,0,2006,262,250,12,114,3,111,0.444,0.435,0.25,17760,29.945681,77,201,0.767175572519084
"9865",211431,"Carlow University",1,0,2007,199,194,5,93,0,93,0.479,0.467,0,18736,31.659216,84,149,0.748743718592965
"9866",211431,"Carlow University",1,0,2008,226,215,11,99,2,97,0.451,0.438,0.182,19860,34.281432,93,153,0.676991150442478
"9867",211431,"Carlow University",1,0,2009,250,245,5,100,1,99,0.404,0.4,0.2,20854,35.671876,96,183,0.732
"9868",211431,"Carlow University",1,0,2010,189,181,8,76,1,75,0.414,0.402,0.125,22400,38.080915,98,103,0.544973544973545
"9869",211440,"CARNEGIE MELLON UNIVERSITY",1,0,1991,1170,335,835,657,464,193,0.576,0.562,0.556,15350,302.574,507,721,0.616239316239316
"9870",211440,"CARNEGIE MELLON UNIVERSITY",1,0,1992,1141,354,787,666,440,226,0.638,0.584,0.559,16000,317.217,518,626,0.548641542506573
"9871",211440,"CARNEGIE MELLON UNIVERSITY",1,0,1993,1189,358,831,752,510,242,0.676,0.632,0.614,16960,329.318,523,590,0.496215306980656
"9872",211440,"CARNEGIE MELLON UNIVERSITY",1,0,1995,1233,376,857,772,515,257,0.683,0.626,0.601,18600,358.864,513,605,0.490673154906732
"9873",211440,"CARNEGIE MELLON UNIVERSITY",1,0,1996,1386,472,914,903,563,340,0.72,0.652,0.616,19500,386.858,515,667,0.481240981240981
"9874",211440,"CARNEGIE MELLON UNIVERSITY",1,0,1997,1270,464,806,841,522,319,0.688,0.662,0.648,20375,382.374728,527,597,0.47007874015748
"9875",211440,"CARNEGIE MELLON UNIVERSITY",1,0,1998,1303,445,858,848,539,309,0.694,0.651,0.628,21405,405.89821,527,574,0.440521872601688
"9876",211440,"CARNEGIE MELLON UNIVERSITY",1,0,1999,1255,487,768,833,491,342,0.702,0.664,0.639,22100,429.594574,546,564,0.449402390438247
"9877",211440,"CARNEGIE MELLON UNIVERSITY",1,0,2000,1325,516,809,920,537,383,0.742,0.694,0.664,24600,465.170512,556,548,0.413584905660377
"9878",211440,"CARNEGIE MELLON UNIVERSITY",1,0,2001,1317,534,783,927,526,401,0.751,0.704,0.672,25670,505.096839,566,565,0.429005315110099
"9879",211440,"CARNEGIE MELLON UNIVERSITY",1,0,2002,1364,542,822,957,557,400,0.738,0.702,0.678,26910,574.839385,747,603,0.44208211143695
"9880",211440,"CARNEGIE MELLON UNIVERSITY",1,0,2003,1338,528,810,903,532,371,0.703,0.675,0.657,28766,560.925046,783,563,0.420777279521674
"9881",211440,"CARNEGIE MELLON UNIVERSITY",1,0,2004,1359,510,849,940,579,361,0.708,0.692,0.682,30650,622.845896,797,562,0.413539367181751
"9882",211440,"Carnegie Mellon University",1,0,2005,1408,533,875,1000,611,389,0.73,0.71,0.698,31650,684.088857,810,600,0.426136363636364
"9883",211440,"Carnegie Mellon University",1,0,2006,1421,552,869,1033,630,403,0.73,0.727,0.725,33050,744.683151,826,567,0.399014778325123
"9884",211440,"Carnegie Mellon University",1,0,2007,1407,554,853,1046,612,434,0.783,0.743,0.717,35580,762.099059,822,570,0.405117270788913
"9885",211440,"Carnegie Mellon University",1,0,2008,1462,625,837,1050,580,470,0.752,0.718,0.693,38430,822.24705,854,565,0.386456908344733
"9886",211440,"Carnegie Mellon University",1,0,2009,1423,611,812,1026,558,468,0.766,0.721,0.687,39470,867.481556,872,623,0.4378074490513
"9887",211440,"Carnegie Mellon University",1,0,2010,1484,619,865,1119,630,489,0.79,0.754,0.728,41500,890.058887,889,616,0.415094339622642
"9888",211468,"CEDAR CREST COLLEGE",1,0,1992,187,186,1,74,0,74,0.398,0.396,0,12940,13.718153,62,157,0.839572192513369
"9889",211468,"CEDAR CREST COLLEGE",1,0,1993,198,196,2,83,1,82,0.418,0.419,0.5,13720,16.883736,60,177,0.893939393939394
"9890",211468,"CEDAR CREST COLLEGE",1,0,1996,329,328,1,189,0,189,0.576,0.574,0,15210,21.34571,67,274,0.832826747720365
"9891",211468,"CEDAR CREST COLLEGE",1,0,1997,195,194,1,122,1,121,0.624,0.626,1,15920,19.229003,63,155,0.794871794871795
"9892",211468,"CEDAR CREST COLLEGE",1,0,1998,187,185,2,104,1,103,0.557,0.556,0.5,16550,19.820927,63,156,0.834224598930481
"9893",211468,"CEDAR CREST COLLEGE",1,0,2000,200,198,2,109,0,109,0.55,0.545,0,17790,19.917393,69,141,0.705
"9894",211468,"Cedar Crest College",1,0,2005,203,202,1,82,1,81,0.401,0.404,1,22712,25.405867,79,179,0.881773399014778
"9895",211468,"Cedar Crest College",1,0,2006,254,251,3,124,1,123,0.49,0.488,0.333,23848,27.194998,84,220,0.866141732283465
"9896",211468,"Cedar Crest College",1,0,2007,222,221,1,112,0,112,0.507,0.505,0,25040,29.521292,92,193,0.869369369369369
"9897",211468,"Cedar Crest College",1,0,2009,195,194,1,84,0,84,0.433,0.431,0,27735,31.50808,87,157,0.805128205128205
"9898",211468,"Cedar Crest College",1,0,2010,91,90,1,36,0,36,0.4,0.396,0,28567,31.809012,87,62,0.681318681318681
"9899",211583,"CHESTNUT HILL COLLEGE",1,0,1998,95,93,2,42,0,42,0.452,0.442,0,15198,12.013801,38,48,0.505263157894737
"9900",211583,"CHESTNUT HILL COLLEGE",1,0,1999,102,101,1,45,1,44,0.436,0.441,1,15454,14.204428,34,63,0.617647058823529
"9901",211583,"CHESTNUT HILL COLLEGE",1,0,2000,104,98,6,51,1,50,0.51,0.49,0.167,16200,15.197109,36.5,51,0.490384615384615
"9902",211583,"CHESTNUT HILL COLLEGE",1,0,2002,105,104,1,27,0,27,0.26,0.257,0,17500,16.912444,38,52,0.495238095238095
"9903",211583,"CHESTNUT HILL COLLEGE",1,0,2003,188,125,63,66,19,47,0.376,0.351,0.302,18375,18.357924,43,122,0.648936170212766
"9904",211583,"CHESTNUT HILL COLLEGE",1,0,2004,197,115,82,62,24,38,0.33,0.315,0.293,19660,20.420647,50,115,0.583756345177665
"9905",211583,"Chestnut Hill College",1,0,2005,219,150,69,73,23,50,0.333,0.333,0.333,20840,22.488228,50,124,0.5662100456621
"9906",211583,"Chestnut Hill College",1,0,2006,214,155,59,78,22,56,0.361,0.364,0.373,23600,24.4571,53,144,0.672897196261682
"9907",211583,"Chestnut Hill College",1,0,2007,234,128,106,63,24,39,0.305,0.269,0.226,24900,27.732949,52,154,0.658119658119658
"9908",211583,"Chestnut Hill College",1,0,2008,194,115,79,72,24,48,0.417,0.371,0.304,26000,30.425818,57,113,0.582474226804124
"9909",211583,"Chestnut Hill College",1,0,2009,273,164,109,101,27,74,0.451,0.37,0.248,27000,32.094712,57,155,0.567765567765568
"9910",211583,"Chestnut Hill College",1,0,2010,219,125,94,82,31,51,0.408,0.374,0.33,28100,35.435987,64,145,0.662100456621005
"9911",211608,"CHEYNEY UNIVERSITY OF PENNSYLVANIA",1,0,1991,324,139,185,33,14,19,0.137,0.102,0.076,2838,22.803845,82,7,0.0216049382716049
"9912",211608,"CHEYNEY UNIVERSITY OF PENNSYLVANIA",1,0,1992,375,184,191,19,2,17,0.092,0.051,0.01,2938,24.027665,87,2,0.00533333333333333
"9913",211608,"CHEYNEY UNIVERSITY OF PENNSYLVANIA",1,0,1993,287,128,159,23,11,12,0.094,0.08,0.069,3319,23.203009,96,2,0.00696864111498258
"9914",211608,"CHEYNEY UNIVERSITY OF PENNSYLVANIA",1,0,1995,256,131,125,20,5,15,0.114,0.078,0.04,3729,26.89955,93,1,0.00390625
"9915",211608,"CHEYNEY UNIVERSITY OF PENNSYLVANIA",1,0,1996,236,124,112,16,2,14,0.113,0.068,0.018,3922,27.093749,93,0,0
"9916",211608,"CHEYNEY UNIVERSITY OF PENNSYLVANIA",1,0,1997,236,122,114,18,4,14,0.115,0.076,0.035,4023,26.803761,86,2,0.00847457627118644
"9917",211608,"CHEYNEY UNIVERSITY OF PENNSYLVANIA",1,0,1998,235,147,88,23,3,20,0.136,0.098,0.034,4023,28.557601,90,1,0.00425531914893617
"9918",211608,"CHEYNEY UNIVERSITY OF PENNSYLVANIA",1,0,1999,254,152,102,37,9,28,0.184,0.146,0.088,3618,29.582948,92,0,0
"9919",211608,"CHEYNEY UNIVERSITY OF PENNSYLVANIA",1,0,2000,291,151,140,34,9,25,0.166,0.117,0.064,3792,33.685209,91,0,0
"9920",211608,"CHEYNEY UNIVERSITY OF PENNSYLVANIA",1,0,2001,292,146,146,32,7,25,0.171,0.11,0.048,4016,35.259155,90,0,0
"9921",211608,"CHEYNEY UNIVERSITY OF PENNSYLVANIA",1,0,2002,247,132,115,25,5,20,0.152,0.101,0.043,4378,33.11067,94,1,0.00404858299595142
"9922",211608,"CHEYNEY UNIVERSITY OF PENNSYLVANIA",1,0,2003,378,208,170,51,13,38,0.183,0.135,0.076,4598,32.548337,86,1,0.00264550264550265
"9923",211608,"CHEYNEY UNIVERSITY OF PENNSYLVANIA",1,0,2004,422,225,197,56,20,36,0.16,0.133,0.102,4810,34.3125,93,0,0
"9924",211608,"Cheyney University of Pennsylvania",1,0,2005,397,219,178,51,21,30,0.137,0.128,0.118,4906,37.29397,91,3,0.00755667506297229
"9925",211608,"Cheyney University of Pennsylvania",1,0,2006,437,238,199,47,15,32,0.134,0.108,0.075,5038,42.214141,95,1,0.0022883295194508
"9926",211608,"Cheyney University of Pennsylvania",1,0,2007,278,166,112,26,5,21,0.126,0.094,0.045,5177,42.989912,89,1,0.00359712230215827
"9927",211608,"Cheyney University of Pennsylvania",1,0,2008,280,157,123,31,6,25,0.159,0.111,0.049,5358,46.236035,78,2,0.00714285714285714
"9928",211608,"Cheyney University of Pennsylvania",1,0,2009,372,199,173,22,7,15,0.075,0.059,0.04,5554,46.359543,76,2,0.00537634408602151
"9929",211608,"Cheyney University of Pennsylvania",1,0,2010,471,258,213,25,5,20,0.078,0.053,0.023,5804,44.745793,79,7,0.0148619957537155
"9930",211644,"CLARION UNIVERSITY OF PENNSYLVANIA",1,0,1991,973,584,389,232,64,168,0.288,0.238,0.165,3147,57.66896,348,923,0.948612538540596
"9931",211644,"CLARION UNIVERSITY OF PENNSYLVANIA",1,0,1992,1093,679,414,246,60,186,0.274,0.225,0.145,3328,60.857554,336,1037,0.948764867337603
"9932",211644,"CLARION UNIVERSITY OF PENNSYLVANIA",1,0,1993,1081,650,431,246,70,176,0.271,0.228,0.162,3710,61.980938,289,1035,0.957446808510638
"9933",211644,"CLARION UNIVERSITY OF PENNSYLVANIA",1,0,1995,1241,768,473,210,46,164,0.214,0.169,0.097,4054,68.347343,290,1156,0.931506849315068
"9934",211644,"CLARION UNIVERSITY OF PENNSYLVANIA",1,0,1996,1215,711,504,284,79,205,0.288,0.234,0.157,4268,72.579769,292,1141,0.939094650205761
"9935",211644,"CLARION UNIVERSITY OF PENNSYLVANIA",1,0,1997,1220,751,469,294,84,210,0.28,0.241,0.179,4378,73.735891,293,1145,0.938524590163934
"9936",211644,"CLARION UNIVERSITY OF PENNSYLVANIA",1,0,1998,1191,717,474,250,64,186,0.259,0.21,0.135,4569,77.655159,280,1110,0.931989924433249
"9937",211644,"CLARION UNIVERSITY OF PENNSYLVANIA",1,0,1999,1286,806,480,295,80,215,0.267,0.229,0.167,3618,79.499863,280,1194,0.92846034214619
"9938",211644,"CLARION UNIVERSITY OF PENNSYLVANIA",1,0,2000,1305,813,492,330,99,231,0.284,0.253,0.201,3792,82.853325,286,1191,0.91264367816092
"9939",211644,"CLARION UNIVERSITY OF PENNSYLVANIA",1,0,2001,1286,814,472,313,82,231,0.284,0.243,0.174,4016,89.392043,292,1176,0.914463452566096
"9940",211644,"CLARION UNIVERSITY OF PENNSYLVANIA",1,0,2002,1249,745,504,367,117,250,0.336,0.294,0.232,4378,85.07957,289,1144,0.915932746196958
"9941",211644,"CLARION UNIVERSITY OF PENNSYLVANIA",1,0,2003,1219,729,490,366,113,253,0.347,0.3,0.231,4598,90.682946,290,1125,0.922887612797375
"9942",211644,"CLARION UNIVERSITY OF PENNSYLVANIA",1,0,2004,1203,683,520,296,103,193,0.283,0.246,0.198,4810,93.770353,285,1071,0.890274314214464
"9943",211644,"Clarion University of Pennsylvania",1,0,2005,1173,731,442,288,92,196,0.268,0.246,0.208,4906,92.120812,261,1066,0.908780903665814
"9944",211644,"Clarion University of Pennsylvania",1,0,2006,1295,758,537,323,110,213,0.281,0.249,0.205,5038,90.311901,253,1173,0.905791505791506
"9945",211644,"Clarion University of Pennsylvania",1,0,2007,1381,799,582,417,142,275,0.344,0.302,0.244,5176,93.863502,242,1246,0.902244750181028
"9946",211644,"Clarion University of Pennsylvania",1,0,2008,1305,747,558,355,116,239,0.32,0.272,0.208,5358,97.956279,253,1134,0.868965517241379
"9947",211644,"Clarion University of Pennsylvania",1,0,2009,1384,805,579,395,122,273,0.339,0.285,0.211,5554,105.692515,254,1195,0.863439306358382
"9948",211644,"Clarion University of Pennsylvania",1,0,2010,1309,811,498,430,127,303,0.374,0.328,0.255,5804,105.61495,255,1117,0.853323147440795
"9949",211981,"DELAWARE VALLEY COLLEGE OF SCIENCE AND AGRICULTURE",1,0,1991,332,140,192,98,43,55,0.393,0.295,0.224,10126,16.223952,66,314,0.94578313253012
"9950",211981,"DELAWARE VALLEY COLLEGE OF SCIENCE AND AGRICULTURE",1,0,1992,347,146,201,132,61,71,0.486,0.38,0.303,11090,17.959139,64,326,0.939481268011527
"9951",211981,"DELAWARE VALLEY COLLEGE OF SCIENCE AND AGRICULTURE",1,0,1993,435,212,223,142,65,77,0.363,0.326,0.291,11645,21.672266,73,413,0.949425287356322
"9952",211981,"DELAWARE VALLEY COLLEGE",1,0,1995,384,193,191,138,45,93,0.482,0.359,0.236,13208,27.694058,77,363,0.9453125
"9953",211981,"DELAWARE VALLEY COLLEGE",1,0,1996,385,177,208,149,67,82,0.463,0.387,0.322,13708,30.291545,82,353,0.916883116883117
"9954",211981,"DELAWARE VALLEY COLLEGE",1,0,1997,407,185,222,149,58,91,0.492,0.366,0.261,14256,24.210194,78,372,0.914004914004914
"9955",211981,"DELAWARE VALLEY COLLEGE",1,0,1998,400,203,197,172,70,102,0.503,0.43,0.355,14826,25.271253,77,380,0.95
"9956",211981,"DELAWARE VALLEY COLLEGE",1,0,1999,327,172,155,109,41,68,0.395,0.333,0.265,15300,26.60827,80,292,0.892966360856269
"9957",211981,"DELAWARE VALLEY COLLEGE",1,0,2000,380,188,192,160,63,97,0.516,0.421,0.328,16148,27.433997,78.5,339,0.892105263157895
"9958",211981,"DELAWARE VALLEY COLLEGE",1,0,2001,355,157,198,126,53,73,0.465,0.355,0.268,16874,28.684762,77,311,0.876056338028169
"9959",211981,"DELAWARE VALLEY COLLEGE",1,0,2002,406,204,202,159,59,100,0.49,0.392,0.292,17680,29.465653,76,366,0.901477832512315
"9960",211981,"DELAWARE VALLEY COLLEGE",1,0,2003,438,198,240,164,70,94,0.475,0.374,0.292,18654,29.530863,76,316,0.721461187214612
"9961",211981,"DELAWARE VALLEY COLLEGE",1,0,2004,450,257,193,186,48,138,0.537,0.413,0.249,19588,30.726298,79,389,0.864444444444444
"9962",211981,"Delaware Valley College",1,0,2005,448,271,177,206,54,152,0.561,0.46,0.305,20664,34.408936,78,384,0.857142857142857
"9963",211981,"Delaware Valley College",1,0,2006,447,264,183,220,68,152,0.576,0.492,0.372,21800,38.016078,81,389,0.870246085011186
"9964",211981,"Delaware Valley College",1,0,2007,475,270,205,221,79,142,0.526,0.465,0.385,23110,41.509849,83,433,0.911578947368421
"9965",211981,"Delaware Valley College",1,0,2008,429,253,176,220,78,142,0.561,0.513,0.443,24728,44.099792,84,380,0.885780885780886
"9966",211981,"Delaware Valley College",1,0,2009,452,252,200,227,74,153,0.607,0.502,0.37,25692,45.630737,82,395,0.873893805309734
"9967",211981,"Delaware Valley College",1,0,2010,490,297,193,238,66,172,0.579,0.486,0.342,27234,46.303336,82,429,0.875510204081633
"9968",212009,"DICKINSON COLLEGE",1,0,1991,557,317,240,433,184,249,0.785,0.777,0.767,15565,48.186764,143,513,0.921005385996409
"9969",212009,"DICKINSON COLLEGE",1,0,1992,569,342,227,428,178,250,0.731,0.752,0.784,16760,52.422832,145,519,0.912126537785589
"9970",212009,"DICKINSON COLLEGE",1,0,1993,482,277,205,330,124,206,0.744,0.685,0.605,17775,56.227271,144,441,0.9149377593361
"9971",212009,"DICKINSON COLLEGE",1,0,1995,520,286,234,393,174,219,0.766,0.756,0.744,19750,59.282322,147,468,0.9
"9972",212009,"DICKINSON COLLEGE",1,0,1996,491,264,227,371,168,203,0.769,0.756,0.74,20750,61.093255,137,445,0.906313645621181
"9973",212009,"DICKINSON COLLEGE",1,0,1997,563,354,209,429,148,281,0.794,0.762,0.708,21600,62.724471,149,523,0.928952042628774
"9974",212009,"DICKINSON COLLEGE",1,0,1998,541,334,207,417,155,262,0.784,0.771,0.749,22600,72.049835,147,513,0.948243992606285
"9975",212009,"DICKINSON COLLEGE",1,0,1999,620,399,221,505,178,327,0.82,0.815,0.805,23120,57.483807,156,577,0.930645161290323
"9976",212009,"DICKINSON COLLEGE",1,0,2000,594,340,254,464,188,276,0.812,0.781,0.74,24050,63.554937,158,550,0.925925925925926
"9977",212009,"DICKINSON COLLEGE",1,0,2001,611,321,290,484,218,266,0.829,0.792,0.752,25250,67.960475,160,559,0.914893617021277
"9978",212009,"DICKINSON COLLEGE",1,0,2002,572,328,244,459,185,274,0.835,0.802,0.758,26400,72.233907,176,501,0.875874125874126
"9979",212009,"DICKINSON COLLEGE",1,0,2003,624,356,268,496,205,291,0.817,0.795,0.765,28380,78.612096,188,541,0.86698717948718
"9980",212009,"DICKINSON COLLEGE",1,0,2004,605,329,276,472,197,275,0.836,0.78,0.714,30000,85.622104,196,489,0.808264462809917
"9981",212009,"Dickinson College",1,0,2005,647,359,288,530,227,303,0.844,0.819,0.788,31800,88.832986,192,511,0.789799072642968
"9982",212009,"Dickinson College",1,0,2006,617,360,257,499,199,300,0.833,0.809,0.774,33470,92.022898,202,477,0.773095623987034
"9983",212009,"Dickinson College",1,0,2007,619,319,300,515,237,278,0.872,0.832,0.79,35450,96.337296,211,483,0.780290791599354
"9984",212009,"Dickinson College",1,0,2008,613,337,276,495,204,291,0.863,0.808,0.739,37900,102.150206,209,467,0.761827079934747
"9985",212009,"Dickinson College",1,0,2009,581,340,241,472,191,281,0.827,0.812,0.793,39780,108.63755,208,462,0.795180722891566
"9986",212009,"Dickinson College",1,0,2010,657,355,302,535,240,295,0.831,0.814,0.795,41170,107.49385,210,504,0.767123287671233
"9987",212054,"DREXEL UNIVERSITY",0,1,1991,1207,364,843,115,31,84,0.231,0.095,0.037,10860,132.805346,429,823,0.681855840927921
"9988",212054,"DREXEL UNIVERSITY",0,1,1992,1054,340,714,94,30,64,0.188,0.089,0.042,11635,135.361916,361,721,0.684060721062619
"9989",212054,"DREXEL UNIVERSITY",0,1,1993,1126,383,743,86,27,59,0.154,0.076,0.036,12326,138.027167,286,709,0.629662522202487
"9990",212054,"DREXEL UNIVERSITY",0,1,1995,935,341,594,111,40,71,0.208,0.119,0.067,13844,137.142131,294,629,0.672727272727273
"9991",212054,"DREXEL UNIVERSITY",0,1,1996,1348,476,872,172,76,96,0.202,0.128,0.087,14472,146.603784,285,894,0.663204747774481
"9992",212054,"DREXEL UNIVERSITY",0,1,1997,1776,729,1047,231,73,158,0.217,0.13,0.07,14036,146.815,388,1027,0.578265765765766
"9993",212054,"DREXEL UNIVERSITY",0,1,1998,2087,792,1295,247,73,174,0.22,0.118,0.056,15574,164.662,395,1350,0.646861523718256
"9994",212054,"DREXEL UNIVERSITY",0,1,1999,1898,725,1173,269,94,175,0.241,0.142,0.08,15240,184.953,449,1257,0.662276080084299
"9995",212054,"DREXEL UNIVERSITY",0,1,2000,2125,810,1315,275,97,178,0.22,0.129,0.074,15927,198.639,467,1317,0.619764705882353
"9996",212054,"DREXEL UNIVERSITY",0,1,2001,1934,759,1175,313,124,189,0.249,0.162,0.106,16644,218.184,485,1117,0.577559462254395
"9997",212054,"DREXEL UNIVERSITY",0,1,2002,1937,709,1228,374,150,224,0.316,0.193,0.122,17393,476.129,683,1394,0.719669592152814
"9998",212054,"DREXEL UNIVERSITY",0,1,2003,1980,768,1212,486,176,310,0.404,0.245,0.145,19700,513.171,656,1433,0.723737373737374
"9999",212054,"DREXEL UNIVERSITY",0,1,2004,2069,732,1337,477,193,284,0.388,0.231,0.144,20800,535.518,689,1514,0.731754470758821
"10000",212054,"Drexel University",0,1,2005,2346,916,1430,663,274,389,0.425,0.283,0.192,21700,543.176,719,1530,0.652173913043478
"10001",212054,"Drexel University",0,1,2006,2256,930,1326,598,219,379,0.408,0.265,0.165,26000,584.131,778,1526,0.676418439716312
"10002",212054,"Drexel University",0,1,2007,2260,945,1315,640,254,386,0.409,0.283,0.193,27200,633.985,826,1461,0.64646017699115
"10003",212054,"Drexel University",0,1,2008,2402,992,1410,579,206,373,0.376,0.241,0.146,28500,687.148,870,1468,0.611157368859284
"10004",212054,"Drexel University",0,1,2009,2268,898,1370,516,209,307,0.342,0.228,0.153,29800,746.243,928,1253,0.552469135802469
"10005",212054,"Drexel University",0,1,2010,2696,1200,1496,735,275,460,0.383,0.273,0.184,30900,782.34,977,1616,0.599406528189911
"10006",212106,"DUQUESNE UNIVERSITY",1,0,1991,870,475,395,381,166,215,0.453,0.438,0.42,9750,78.305385,304,812,0.933333333333333
"10007",212106,"DUQUESNE UNIVERSITY",1,0,1992,1026,588,438,441,165,276,0.469,0.43,0.377,10470,88.429303,323,925,0.901559454191033
"10008",212106,"DUQUESNE UNIVERSITY",1,0,1993,971,547,424,418,182,236,0.431,0.43,0.429,11328,97.766243,336,848,0.873326467559217
"10009",212106,"DUQUESNE UNIVERSITY",1,0,1995,1215,703,512,523,193,330,0.469,0.43,0.377,12578,119.829677,343,1055,0.868312757201646
"10010",212106,"DUQUESNE UNIVERSITY",1,0,1996,1196,690,506,558,204,354,0.513,0.467,0.403,13396,137.387282,344,957,0.800167224080268
"10011",212106,"DUQUESNE UNIVERSITY",1,0,1997,1211,716,495,599,225,374,0.522,0.495,0.455,14066,113.970722,379,951,0.785301403798514
"10012",212106,"DUQUESNE UNIVERSITY",1,0,1998,1253,771,482,615,210,405,0.525,0.491,0.436,14699,122.726786,369,1027,0.819632881085395
"10013",212106,"DUQUESNE UNIVERSITY",1,0,1999,1211,686,525,590,216,374,0.545,0.487,0.411,14378,135.167365,376,996,0.822460776218002
"10014",212106,"DUQUESNE UNIVERSITY",1,0,2000,1257,733,524,650,243,407,0.555,0.517,0.464,15169,143.12867,383,1091,0.86793953858393
"10015",212106,"DUQUESNE UNIVERSITY",1,0,2001,1176,684,492,596,219,377,0.551,0.507,0.445,16049,148.277682,390,1038,0.88265306122449
"10016",212106,"DUQUESNE UNIVERSITY",1,0,2002,1429,875,554,748,253,495,0.566,0.523,0.457,17012,157.039213,388,1253,0.876836948915325
"10017",212106,"DUQUESNE UNIVERSITY",1,0,2003,1485,899,586,774,283,491,0.546,0.521,0.483,17837,167.378085,407,1258,0.847138047138047
"10018",212106,"DUQUESNE UNIVERSITY",1,0,2004,1208,700,508,656,251,405,0.579,0.543,0.494,18693,177.691874,428,1017,0.841887417218543
"10019",212106,"Duquesne University",1,0,2005,1325,811,514,711,244,467,0.576,0.537,0.475,19721,187.078,429,1156,0.872452830188679
"10020",212106,"Duquesne University",1,0,2006,1321,779,542,700,268,432,0.555,0.53,0.494,20855,202.593,442,1168,0.884178652535958
"10021",212106,"Duquesne University",1,0,2007,1354,785,569,796,307,489,0.623,0.588,0.54,22054,211.566,447,1204,0.889217134416544
"10022",212106,"Duquesne University",1,0,2008,1425,838,587,801,308,493,0.588,0.562,0.525,23470,224.271,463,1270,0.891228070175439
"10023",212106,"Duquesne University",1,0,2009,1425,814,611,787,296,491,0.603,0.552,0.484,24385,235.936,472,1221,0.856842105263158
"10024",212106,"Duquesne University",1,0,2010,1411,821,590,834,318,516,0.629,0.591,0.539,25336,239.43,480,1221,0.865343727852587
"10025",212115,"EAST STROUDSBURG UNIVERSITY OF PENNSYLVANIA",1,0,1991,699,382,317,129,31,98,0.256,0.185,0.098,3088,45.309173,249,636,0.909871244635193
"10026",212115,"EAST STROUDSBURG UNIVERSITY OF PENNSYLVANIA",1,0,1992,628,368,260,143,39,104,0.283,0.228,0.15,3352,48.857974,239,581,0.92515923566879
"10027",212115,"EAST STROUDSBURG UNIVERSITY OF PENNSYLVANIA",1,0,1993,799,446,353,161,39,122,0.274,0.202,0.11,3664,51.856015,234,733,0.917396745932415
"10028",212115,"EAST STROUDSBURG UNIVERSITY OF PENNSYLVANIA",1,0,1995,820,457,363,169,45,124,0.271,0.206,0.124,4016,57.68591,233,776,0.946341463414634
"10029",212115,"EAST STROUDSBURG UNIVERSITY OF PENNSYLVANIA",1,0,1996,872,499,373,198,50,148,0.297,0.227,0.134,4194,61.351417,233,808,0.926605504587156
"10030",212115,"EAST STROUDSBURG UNIVERSITY OF PENNSYLVANIA",1,0,1997,886,532,354,166,34,132,0.248,0.187,0.096,4322,62.00042,227,799,0.901805869074492
"10031",212115,"EAST STROUDSBURG UNIVERSITY OF PENNSYLVANIA",1,0,1998,856,475,381,182,53,129,0.272,0.213,0.139,4314,66.172851,235,767,0.896028037383178
"10032",212115,"EAST STROUDSBURG UNIVERSITY OF PENNSYLVANIA",1,0,1999,843,522,321,163,42,121,0.232,0.193,0.131,3618,69.024874,237,744,0.882562277580071
"10033",212115,"EAST STROUDSBURG UNIVERSITY OF PENNSYLVANIA",1,0,2000,878,522,356,193,57,136,0.26,0.22,0.16,3792,72.119515,241.5,791,0.900911161731207
"10034",212115,"EAST STROUDSBURG UNIVERSITY OF PENNSYLVANIA",1,0,2001,969,564,405,259,66,193,0.342,0.267,0.163,4016,76.550314,246,880,0.908152734778122
"10035",212115,"EAST STROUDSBURG UNIVERSITY OF PENNSYLVANIA",1,0,2002,1123,587,536,314,100,214,0.365,0.28,0.187,4378,76.566622,249,1020,0.908281389136242
"10036",212115,"EAST STROUDSBURG UNIVERSITY OF PENNSYLVANIA",1,0,2003,1076,650,426,394,107,287,0.442,0.366,0.251,4598,83.459234,245,993,0.922862453531598
"10037",212115,"EAST STROUDSBURG UNIVERSITY OF PENNSYLVANIA",1,0,2004,1165,709,456,420,122,298,0.42,0.361,0.268,4810,84.814296,255,1059,0.909012875536481
"10038",212115,"East Stroudsburg University of Pennsylvania",1,0,2005,1087,634,453,392,110,282,0.445,0.361,0.243,4906,84.973395,267,1001,0.920883164673413
"10039",212115,"East Stroudsburg University of Pennsylvania",1,0,2006,1239,716,523,454,147,307,0.429,0.366,0.281,5038,89.027104,280,975,0.786924939467312
"10040",212115,"East Stroudsburg University of Pennsylvania",1,0,2007,1183,612,571,422,156,266,0.435,0.357,0.273,5178,97.780874,285,922,0.779374471682164
"10041",212115,"East Stroudsburg University of Pennsylvania",1,0,2008,1262,655,607,458,167,291,0.444,0.363,0.275,5358,101.59092,306,945,0.748811410459588
"10042",212115,"East Stroudsburg University of Pennsylvania",1,0,2009,1342,737,605,466,167,299,0.406,0.347,0.276,5554,111.407727,305,955,0.711624441132638
"10043",212115,"East Stroudsburg University of Pennsylvania",1,0,2010,1144,658,486,422,137,285,0.433,0.369,0.282,5804,116.238144,301,899,0.785839160839161
"10044",212133,"EASTERN COLLEGE",1,0,1991,134,87,47,55,16,39,0.448,0.41,0.34,9525,12.763837,41,97,0.723880597014925
"10045",212133,"EASTERN COLLEGE",1,0,1992,183,130,53,82,20,62,0.477,0.448,0.377,9875,14.88565,48,146,0.797814207650273
"10046",212133,"EASTERN COLLEGE",1,0,1993,162,113,49,76,22,54,0.478,0.469,0.449,10620,17.745647,57,126,0.777777777777778
"10047",212133,"EASTERN COLLEGE",1,0,1995,226,171,55,103,21,82,0.48,0.456,0.382,11780,22.781524,61,179,0.792035398230089
"10048",212133,"EASTERN COLLEGE",1,0,1996,245,168,77,138,34,104,0.619,0.563,0.442,12250,24.97341,59,197,0.804081632653061
"10049",212133,"EASTERN COLLEGE",1,0,1997,305,211,94,171,40,131,0.621,0.561,0.426,12735,25.363994,65,259,0.849180327868852
"10050",212133,"EASTERN COLLEGE",1,0,1998,317,220,97,168,48,120,0.545,0.53,0.495,13235,27.58869,70,254,0.801261829652997
"10051",212133,"EASTERN COLLEGE",1,0,1999,379,274,105,190,41,149,0.544,0.501,0.39,13728,31.386164,74,346,0.912928759894459
"10052",212133,"EASTERN COLLEGE",1,0,2000,400,279,121,229,60,169,0.606,0.573,0.496,14560,35.904463,80.5,346,0.865
"10053",212133,"EASTERN UNIVERSITY",1,0,2001,427,287,140,216,69,147,0.512,0.506,0.493,15150,42.52855,87,342,0.800936768149883
"10054",212133,"EASTERN UNIVERSITY",1,0,2002,405,288,117,211,49,162,0.562,0.521,0.419,15832,46.704196,85,322,0.795061728395062
"10055",212133,"EASTERN UNIVERSITY",1,0,2003,438,298,140,242,74,168,0.564,0.553,0.529,16780,47.820759,82,355,0.810502283105023
"10056",212133,"EASTERN UNIVERSITY",1,0,2004,450,294,156,243,82,161,0.548,0.54,0.526,17700,49.223419,91,360,0.8
"10057",212133,"Eastern University",1,0,2005,445,300,145,239,70,169,0.563,0.537,0.483,18830,58.080766,114,350,0.786516853932584
"10058",212133,"Eastern University",1,0,2006,494,336,158,230,70,160,0.476,0.466,0.443,20030,64.523829,126,377,0.763157894736842
"10059",212133,"Eastern University",1,0,2007,483,319,164,206,58,148,0.464,0.427,0.354,21350,70.481978,126,318,0.658385093167702
"10060",212133,"Eastern University",1,0,2008,550,367,183,233,68,165,0.45,0.424,0.372,22670,75.059963,128,342,0.621818181818182
"10061",212133,"Eastern University",1,0,2009,489,318,171,213,61,152,0.478,0.436,0.357,23770,82.232687,139,328,0.670756646216769
"10062",212133,"Eastern University",1,0,2010,449,302,147,195,67,128,0.424,0.434,0.456,24550,85.318895,146,264,0.587973273942094
"10063",212160,"EDINBORO UNIVERSITY OF PENNSYLVANIA",1,0,1991,1456,853,603,243,65,178,0.209,0.167,0.108,3013,63.320188,416,1302,0.894230769230769
"10064",212160,"EDINBORO UNIVERSITY OF PENNSYLVANIA",1,0,1992,1500,857,643,257,75,182,0.212,0.171,0.117,3161,69.046635,399,1375,0.916666666666667
"10065",212160,"EDINBORO UNIVERSITY OF PENNSYLVANIA",1,0,1993,1315,763,552,221,65,156,0.204,0.168,0.118,3531,72.363493,392,1209,0.919391634980989
"10066",212160,"EDINBORO UNIVERSITY OF PENNSYLVANIA",1,0,1995,1332,763,569,213,69,144,0.189,0.16,0.121,3924,77.442966,390,1186,0.89039039039039
"10067",212160,"EDINBORO UNIVERSITY OF PENNSYLVANIA",1,0,1996,1250,707,543,214,69,145,0.205,0.171,0.127,4082,78.887483,391,1160,0.928
"10068",212160,"EDINBORO UNIVERSITY OF PENNSYLVANIA",1,0,1997,1251,729,522,234,63,171,0.235,0.187,0.121,4192,79.956983,383,1143,0.913669064748201
"10069",212160,"EDINBORO UNIVERSITY OF PENNSYLVANIA",1,0,1998,1205,691,514,210,54,156,0.226,0.174,0.105,3468,84.684291,368,1107,0.918672199170124
"10070",212160,"EDINBORO UNIVERSITY OF PENNSYLVANIA",1,0,1999,1256,749,507,227,48,179,0.239,0.181,0.095,3618,86.914139,381,1139,0.906847133757962
"10071",212160,"EDINBORO UNIVERSITY OF PENNSYLVANIA",1,0,2000,1304,731,573,297,88,209,0.286,0.228,0.154,3792,88.946681,365.5,1160,0.889570552147239
"10072",212160,"EDINBORO UNIVERSITY OF PENNSYLVANIA",1,0,2001,1409,831,578,323,99,224,0.27,0.229,0.171,4016,94.151855,350,1228,0.871540099361249
"10073",212160,"EDINBORO UNIVERSITY OF PENNSYLVANIA",1,0,2002,1372,788,584,297,86,211,0.268,0.216,0.147,4378,91.179481,351,1204,0.877551020408163
"10074",212160,"EDINBORO UNIVERSITY OF PENNSYLVANIA",1,0,2003,1392,818,574,304,103,201,0.246,0.218,0.179,4598,90.056976,343,1219,0.875718390804598
"10075",212160,"EDINBORO UNIVERSITY OF PENNSYLVANIA",1,0,2004,1232,712,520,272,81,191,0.268,0.221,0.156,4810,90.907135,356,1062,0.862012987012987
"10076",212160,"Edinboro University of Pennsylvania",1,0,2005,1268,719,549,297,82,215,0.299,0.234,0.149,4906,92.17021,346,1104,0.870662460567823
"10077",212160,"Edinboro University of Pennsylvania",1,0,2006,1212,671,541,230,63,167,0.249,0.19,0.116,5038,96.108368,346,1036,0.854785478547855
"10078",212160,"Edinboro University of Pennsylvania",1,0,2007,1243,707,536,239,75,164,0.232,0.192,0.14,5177,100.661254,322,1005,0.80852775543041
"10079",212160,"Edinboro University of Pennsylvania",1,0,2008,1219,697,522,245,77,168,0.241,0.201,0.148,5358,106.688529,325,1041,0.853978671041838
"10080",212160,"Edinboro University of Pennsylvania",1,0,2009,1407,803,604,266,82,184,0.229,0.189,0.136,5554,110.468281,336,1221,0.867803837953092
"10081",212160,"Edinboro University of Pennsylvania",1,0,2010,1551,927,624,340,103,237,0.256,0.219,0.165,5804,112.084642,341,1337,0.862024500322373
"10082",212197,"ELIZABETHTOWN COLLEGE",1,0,1991,455,309,146,265,78,187,0.605,0.582,0.534,11650,27.958524,110,427,0.938461538461538
"10083",212197,"ELIZABETHTOWN COLLEGE",1,0,1992,442,318,124,256,52,204,0.642,0.579,0.419,12550,29.279367,105,429,0.970588235294118
"10084",212197,"ELIZABETHTOWN COLLEGE",1,0,1993,424,276,148,270,76,194,0.703,0.637,0.514,13600,31.748361,105,412,0.971698113207547
"10085",212197,"ELIZABETHTOWN COLLEGE",1,0,1995,434,307,127,282,72,210,0.684,0.65,0.567,15490,36.279776,104,411,0.947004608294931
"10086",212197,"ELIZABETHTOWN COLLEGE",1,0,1996,429,295,134,263,73,190,0.644,0.613,0.545,15890,39.476166,100,403,0.939393939393939
"10087",212197,"ELIZABETHTOWN COLLEGE",1,0,1997,438,298,140,265,74,191,0.641,0.605,0.529,16680,30.544218,100,409,0.9337899543379
"10088",212197,"ELIZABETHTOWN COLLEGE",1,0,1998,422,271,151,265,87,178,0.657,0.628,0.576,17500,32.217955,101,400,0.947867298578199
"10089",212197,"ELIZABETHTOWN COLLEGE",1,0,1999,477,298,179,277,102,175,0.587,0.581,0.57,17770,33.468682,103,438,0.918238993710692
"10090",212197,"ELIZABETHTOWN COLLEGE",1,0,2000,474,318,156,310,98,212,0.667,0.654,0.628,19100,34.822643,108.5,436,0.919831223628692
"10091",212197,"ELIZABETHTOWN COLLEGE",1,0,2001,514,319,195,326,116,210,0.658,0.634,0.595,20200,37.423347,114,482,0.937743190661479
"10092",212197,"ELIZABETHTOWN COLLEGE",1,0,2002,456,304,152,293,85,208,0.684,0.643,0.559,21350,39.521585,120,418,0.916666666666667
"10093",212197,"ELIZABETHTOWN COLLEGE",1,0,2003,495,326,169,328,100,228,0.699,0.663,0.592,22500,40.991427,118,458,0.925252525252525
"10094",212197,"ELIZABETHTOWN COLLEGE",1,0,2004,535,344,191,385,125,260,0.756,0.72,0.654,23710,44.770271,120,508,0.949532710280374
"10095",212197,"Elizabethtown College",1,0,2005,500,337,163,356,104,252,0.748,0.712,0.638,25200,48.270227,125,466,0.932
"10096",212197,"Elizabethtown College",1,0,2006,528,345,183,372,125,247,0.716,0.705,0.683,26950,52.428187,126,497,0.941287878787879
"10097",212197,"Elizabethtown College",1,0,2007,487,324,163,344,113,231,0.713,0.706,0.693,29000,54.954734,130,446,0.915811088295688
"10098",212197,"Elizabethtown College",1,0,2008,508,331,177,328,114,214,0.647,0.646,0.644,30650,58.477065,129,457,0.899606299212598
"10099",212197,"Elizabethtown College",1,0,2009,544,340,204,391,133,258,0.759,0.719,0.652,31800,60.99391,125,489,0.898897058823529
"10100",212197,"Elizabethtown College",1,0,2010,491,303,188,339,104,235,0.776,0.69,0.553,33250,61.123369,130,426,0.867617107942974
"10101",212577,"FRANKLIN AND MARSHALL COLLEGE",1,0,1991,504,228,276,355,173,182,0.798,0.704,0.627,16385,44.490877,148,398,0.78968253968254
"10102",212577,"FRANKLIN AND MARSHALL COLLEGE",1,0,1992,486,222,264,351,182,169,0.761,0.722,0.689,22370,47.526756,146,385,0.792181069958848
"10103",212577,"FRANKLIN AND MARSHALL COLLEGE",1,0,1993,507,229,278,364,190,174,0.76,0.718,0.683,23655,51.173045,152,387,0.763313609467456
"10104",212577,"FRANKLIN AND MARSHALL COLLEGE",1,0,1995,498,234,264,372,179,193,0.825,0.747,0.678,21350,56.891658,160,406,0.815261044176707
"10105",212577,"FRANKLIN AND MARSHALL COLLEGE",1,0,1996,522,272,250,408,175,233,0.857,0.782,0.7,21990,67.258929,158,430,0.823754789272031
"10106",212577,"FRANKLIN AND MARSHALL COLLEGE",1,0,1997,504,251,253,402,202,200,0.797,0.798,0.798,22714,47.441022,155,410,0.813492063492063
"10107",212577,"FRANKLIN AND MARSHALL COLLEGE",1,0,1998,502,257,245,394,175,219,0.852,0.785,0.714,23214,51.702,158,399,0.794820717131474
"10108",212577,"FRANKLIN AND MARSHALL COLLEGE",1,0,1999,515,253,262,387,181,206,0.814,0.751,0.691,23720,55.838,161,443,0.860194174757282
"10109",212577,"FRANKLIN AND MARSHALL COLLEGE",1,0,2000,510,251,259,382,179,203,0.809,0.749,0.691,24816,58.13,164.5,421,0.825490196078431
"10110",212577,"FRANKLIN AND MARSHALL COLLEGE",1,0,2001,510,248,262,401,190,211,0.851,0.786,0.725,26060,61.682,168,410,0.803921568627451
"10111",212577,"FRANKLIN AND MARSHALL COLLEGE",1,0,2002,534,248,286,388,189,199,0.802,0.727,0.661,27230,62.536,184,403,0.754681647940075
"10112",212577,"FRANKLIN AND MARSHALL COLLEGE",1,0,2003,503,233,270,398,198,200,0.858,0.791,0.733,28810,68.34,183,379,0.753479125248509
"10113",212577,"FRANKLIN AND MARSHALL COLLEGE",1,0,2004,529,241,288,424,219,205,0.851,0.802,0.76,30390,71.607,180,422,0.79773156899811
"10114",212577,"Franklin and Marshall College",1,0,2005,581,298,283,468,211,257,0.862,0.806,0.746,32480,77.356159,194,447,0.769363166953528
"10115",212577,"Franklin and Marshall College",1,0,2006,523,274,249,413,196,217,0.792,0.79,0.787,34400,84.542549,200,321,0.61376673040153
"10116",212577,"Franklin and Marshall College",1,0,2007,569,301,268,477,214,263,0.874,0.838,0.799,36430,88.480065,201,417,0.73286467486819
"10117",212577,"Franklin and Marshall College",1,0,2008,588,321,267,485,210,275,0.857,0.825,0.787,38580,96.086995,206,443,0.753401360544218
"10118",212577,"Franklin and Marshall College",1,0,2009,629,334,295,511,229,282,0.844,0.812,0.776,39930,105.471801,223,475,0.75516693163752
"10119",212577,"Franklin and Marshall College",1,0,2010,629,345,284,525,227,298,0.864,0.835,0.799,41090,106.053254,233,473,0.751987281399046
"10120",212601,"GANNON UNIVERSITY",1,0,1991,465,264,201,186,79,107,0.405,0.4,0.393,8719,43.621844,185,440,0.946236559139785
"10121",212601,"GANNON UNIVERSITY",1,0,1992,406,244,162,152,54,98,0.402,0.374,0.333,9198,47.563,182,383,0.943349753694581
"10122",212601,"GANNON UNIVERSITY",1,0,1993,450,257,193,177,79,98,0.381,0.393,0.409,9842,48.109,171,427,0.948888888888889
"10123",212601,"GANNON UNIVERSITY",1,0,1995,394,225,169,174,73,101,0.449,0.442,0.432,11114,49.813,169,369,0.936548223350254
"10124",212601,"GANNON UNIVERSITY",1,0,1996,504,305,199,229,72,157,0.515,0.454,0.362,11694,50.222,157,474,0.94047619047619
"10125",212601,"GANNON UNIVERSITY",1,0,1997,533,318,215,244,74,170,0.535,0.458,0.344,12264,35.777,146,503,0.943714821763602
"10126",212601,"GANNON UNIVERSITY",1,0,1998,608,360,248,282,95,187,0.519,0.464,0.383,12744,35.856,150,556,0.914473684210526
"10127",212601,"GANNON UNIVERSITY",1,0,1999,503,314,189,246,67,179,0.57,0.489,0.354,13820,38.409,157,476,0.946322067594433
"10128",212601,"GANNON UNIVERSITY",1,0,2000,563,327,236,257,87,170,0.52,0.456,0.369,13670,39.367,158.5,524,0.930728241563055
"10129",212601,"GANNON UNIVERSITY",1,0,2001,525,313,212,244,83,161,0.514,0.465,0.392,14490,45.192,160,479,0.912380952380952
"10130",212601,"GANNON UNIVERSITY",1,0,2002,536,311,225,255,80,175,0.563,0.476,0.356,15330,47.903,165,496,0.925373134328358
"10131",212601,"GANNON UNIVERSITY",1,0,2003,587,339,248,246,91,155,0.457,0.419,0.367,16220,49.439,164,539,0.918228279386712
"10132",212601,"GANNON UNIVERSITY",1,0,2004,522,317,205,248,84,164,0.517,0.475,0.41,17550,52.118,169,458,0.877394636015326
"10133",212601,"Gannon University",1,0,2005,619,375,244,292,104,188,0.501,0.472,0.426,18775,54.088,175,558,0.901453957996769
"10134",212601,"Gannon University",1,0,2006,600,352,248,280,97,183,0.52,0.467,0.391,20090,53.942,175,529,0.881666666666667
"10135",212601,"Gannon University",1,0,2007,610,365,245,276,96,180,0.493,0.452,0.392,21480,54.446,184,509,0.834426229508197
"10136",212601,"Gannon University",1,0,2008,620,367,253,289,106,183,0.499,0.466,0.419,22830,60.106,193,544,0.87741935483871
"10137",212601,"Gannon University",1,0,2009,648,382,266,310,106,204,0.534,0.478,0.398,23745,64.142,196,523,0.807098765432099
"10138",212601,"Gannon University",1,0,2010,617,362,255,276,100,176,0.486,0.447,0.392,24765,65.101,192,503,0.815235008103728
"10139",212832,"GWYNEDD-MERCY COLLEGE",1,0,1991,89,79,10,25,1,24,0.304,0.281,0.1,8600,12.328232,93,70,0.786516853932584
"10140",212832,"GWYNEDD-MERCY COLLEGE",1,0,1992,89,72,17,34,2,32,0.444,0.382,0.118,10150,13.804689,96,77,0.865168539325843
"10141",212832,"GWYNEDD-MERCY COLLEGE",1,0,1993,86,74,12,32,2,30,0.405,0.372,0.167,10960,14.960403,98,68,0.790697674418605
"10142",212832,"GWYNEDD-MERCY COLLEGE",1,0,1995,40,35,5,16,0,16,0.457,0.4,0,12017,17.24174,91,33,0.825
"10143",212832,"GWYNEDD-MERCY COLLEGE",1,0,1996,44,32,12,16,3,13,0.406,0.364,0.25,12650,16.998864,91,36,0.818181818181818
"10144",212832,"GWYNEDD MERCY COLLEGE",1,0,1997,65,54,11,26,4,22,0.407,0.4,0.364,13180,16.76453,85,50,0.769230769230769
"10145",212832,"GWYNEDD MERCY COLLEGE",1,0,1998,143,100,43,44,9,35,0.35,0.308,0.209,13710,18.290759,78,129,0.902097902097902
"10146",212832,"GWYNEDD MERCY COLLEGE",1,0,1999,146,114,32,56,13,43,0.377,0.384,0.406,13500,19.574056,74,131,0.897260273972603
"10147",212832,"GWYNEDD MERCY COLLEGE",1,0,2000,179,141,38,70,10,60,0.426,0.391,0.263,14400,21.374,69.5,156,0.871508379888268
"10148",212832,"GWYNEDD MERCY COLLEGE",1,0,2001,176,140,36,85,15,70,0.5,0.483,0.417,15100,22.16,65,158,0.897727272727273
"10149",212832,"GWYNEDD MERCY COLLEGE",1,0,2002,261,211,50,62,18,44,0.209,0.238,0.36,15600,21.069,72,215,0.823754789272031
"10150",212832,"GWYNEDD MERCY COLLEGE",1,0,2003,322,245,77,105,26,79,0.322,0.326,0.338,16200,23.955,77,281,0.872670807453416
"10151",212832,"GWYNEDD MERCY COLLEGE",1,0,2004,280,218,62,87,23,64,0.294,0.311,0.371,16900,26.247,80,261,0.932142857142857
"10152",212832,"Gwynedd Mercy College",1,0,2005,280,210,70,21,15,6,0.029,0.075,0.214,17580,28.206,78,226,0.807142857142857
"10153",212832,"Gwynedd Mercy College",1,0,2006,272,202,70,54,19,35,0.173,0.199,0.271,18720,31.02,81,218,0.801470588235294
"10154",212832,"Gwynedd Mercy College",1,0,2007,291,208,83,58,23,35,0.168,0.199,0.277,20500,32.316,82,256,0.879725085910653
"10155",212832,"Gwynedd Mercy College",1,0,2008,339,223,116,56,23,33,0.148,0.165,0.198,22340,32.784,81,284,0.837758112094395
"10156",212832,"Gwynedd Mercy College",1,0,2009,313,214,99,47,18,29,0.136,0.15,0.182,23730,32.755,75,224,0.715654952076677
"10157",212832,"Gwynedd Mercy College",1,0,2010,284,190,94,38,13,25,0.132,0.134,0.138,25160,33.89,76,218,0.767605633802817
"10158",212911,"HAVERFORD COLLEGE",1,0,1991,295,147,148,256,124,132,0.898,0.868,0.838,16150,31.86286,91,239,0.810169491525424
"10159",212911,"HAVERFORD COLLEGE",1,0,1992,301,145,156,253,132,121,0.835,0.841,0.846,17125,33.499448,95,244,0.81063122923588
"10160",212911,"HAVERFORD COLLEGE",1,0,1993,292,143,149,243,122,121,0.846,0.832,0.819,18000,35.856411,95,247,0.845890410958904
"10161",212911,"HAVERFORD COLLEGE",1,0,1995,306,162,144,269,126,143,0.883,0.879,0.875,20075,39.966344,97,267,0.872549019607843
"10162",212911,"HAVERFORD COLLEGE",1,0,1996,313,172,141,267,116,151,0.878,0.853,0.823,20890,42.972528,95,253,0.808306709265176
"10163",212911,"HAVERFORD COLLEGE",1,0,1997,298,150,148,264,127,137,0.913,0.886,0.858,21740,39.534458,96,229,0.768456375838926
"10164",212911,"HAVERFORD COLLEGE",1,0,1998,322,170,152,277,130,147,0.865,0.86,0.855,22860,41.281997,97,267,0.829192546583851
"10165",212911,"HAVERFORD COLLEGE",1,0,1999,301,160,141,244,113,131,0.819,0.811,0.801,23556,43.101489,102,222,0.737541528239203
"10166",212911,"HAVERFORD COLLEGE",1,0,2000,334,181,153,305,140,165,0.912,0.913,0.915,24706,46.654981,102.5,237,0.709580838323353
"10167",212911,"HAVERFORD COLLEGE",1,0,2001,296,154,142,256,120,136,0.883,0.865,0.845,25826,50.552701,103,199,0.672297297297297
"10168",212911,"HAVERFORD COLLEGE",1,0,2002,312,168,144,283,128,155,0.923,0.907,0.889,27006,55.516383,112,221,0.708333333333333
"10169",212911,"HAVERFORD COLLEGE",1,0,2003,313,164,149,275,132,143,0.872,0.879,0.886,28612,59.10875,108,236,0.753993610223642
"10170",212911,"HAVERFORD COLLEGE",1,0,2004,330,179,151,291,130,161,0.899,0.882,0.861,29990,61.868057,110,226,0.684848484848485
"10171",212911,"Haverford College",1,0,2005,316,168,148,287,131,156,0.929,0.908,0.885,31466,63.468719,111,225,0.712025316455696
"10172",212911,"Haverford College",1,0,2006,314,174,140,281,123,158,0.908,0.895,0.879,33394,68.314037,123,214,0.681528662420382
"10173",212911,"Haverford College",1,0,2007,315,169,146,287,131,156,0.923,0.911,0.897,35058,74.435475,121,215,0.682539682539683
"10174",212911,"Haverford College",1,0,2008,327,182,145,287,124,163,0.896,0.878,0.855,37175,77.997901,128,234,0.715596330275229
"10175",212911,"Haverford College",1,0,2009,323,186,137,275,121,154,0.828,0.851,0.883,38735,81.921556,127,232,0.718266253869969
"10176",212911,"Haverford College",1,0,2010,325,166,159,281,138,143,0.861,0.865,0.868,40260,77.127023,139,215,0.661538461538462
"10177",213020,"INDIANA UNIVERSITY OF PENNSYLVANIA",1,0,1991,2516,1452,1064,604,180,424,0.292,0.24,0.169,2980,133.983232,649,2181,0.866852146263911
"10178",213020,"INDIANA UNIVERSITY OF PENNSYLVANIA",1,0,1992,2423,1423,1000,665,197,468,0.329,0.274,0.197,3157,146.446726,656,2123,0.876186545604622
"10179",213020,"INDIANA UNIVERSITY OF PENNSYLVANIA",1,0,1993,2366,1365,1001,495,154,341,0.25,0.209,0.154,3539,144.920003,658,2131,0.900676246830093
"10180",213020,"INDIANA UNIVERSITY OF PENNSYLVANIA",1,0,1995,2661,1552,1109,652,187,465,0.3,0.245,0.169,3891,163.449089,675,2470,0.928222472754604
"10181",213020,"INDIANA UNIVERSITY OF PENNSYLVANIA",1,0,1996,2617,1493,1124,613,163,450,0.301,0.234,0.145,4064,163.605644,680,2431,0.928926251432938
"10182",213020,"INDIANA UNIVERSITY OF PENNSYLVANIA",1,0,1997,2620,1479,1141,618,176,442,0.299,0.236,0.154,4204,165.766205,692,2399,0.915648854961832
"10183",213020,"INDIANA UNIVERSITY OF PENNSYLVANIA",1,0,1998,2757,1643,1114,661,161,500,0.304,0.24,0.145,4244,173.255543,688,2484,0.900979325353645
"10184",213020,"INDIANA UNIVERSITY OF PENNSYLVANIA-MAIN CAMPUS",1,0,1999,2552,1468,1084,561,165,396,0.27,0.22,0.152,3618,183.441444,671,2203,0.863244514106583
"10185",213020,"INDIANA UNIVERSITY OF PENNSYLVANIA-MAIN CAMPUS",1,0,2000,2776,1607,1169,605,167,438,0.273,0.218,0.143,3792,182.672786,660,2473,0.890850144092219
"10186",213020,"INDIANA UNIVERSITY OF PENNSYLVANIA-MAIN CAMPUS",1,0,2001,2557,1460,1097,624,190,434,0.297,0.244,0.173,4016,191.794757,649,2261,0.884239342980055
"10187",213020,"INDIANA UNIVERSITY OF PENNSYLVANIA-MAIN CAMPUS",1,0,2002,2666,1536,1130,697,207,490,0.319,0.261,0.183,4378,192.265023,634,2338,0.876969242310578
"10188",213020,"INDIANA UNIVERSITY OF PENNSYLVANIA-MAIN CAMPUS",1,0,2003,2847,1669,1178,822,242,580,0.348,0.289,0.205,4598,193.461514,616,2380,0.835967685282754
"10189",213020,"INDIANA UNIVERSITY OF PENNSYLVANIA-MAIN CAMPUS",1,0,2004,2645,1567,1078,768,234,534,0.341,0.29,0.217,4810,197.077048,628,2109,0.797353497164461
"10190",213020,"Indiana University of Pennsylvania-Main Campus",1,0,2005,2462,1335,1127,713,245,468,0.351,0.29,0.217,4906,200.958898,639,1888,0.766856214459789
"10191",213020,"Indiana University of Pennsylvania-Main Campus",1,0,2006,2538,1400,1138,726,225,501,0.358,0.286,0.198,5038,209.48173,641,2030,0.799842395587076
"10192",213020,"Indiana University of Pennsylvania-Main Campus",1,0,2007,2524,1450,1074,786,257,529,0.365,0.311,0.239,5178,221.49609,633,1886,0.747226624405705
"10193",213020,"Indiana University of Pennsylvania-Main Campus",1,0,2008,3065,1790,1275,1041,323,718,0.401,0.34,0.253,5358,225.931951,616,2445,0.797716150081566
"10194",213020,"Indiana University of Pennsylvania-Main Campus",1,0,2009,2993,1774,1219,1068,329,739,0.417,0.357,0.27,5554,232.515303,608,2497,0.834279986635483
"10195",213020,"Indiana University of Pennsylvania-Main Campus",1,0,2010,2984,1751,1233,1087,333,754,0.431,0.364,0.27,5804,237.599566,625,2375,0.795911528150134
"10196",213251,"JUNIATA COLLEGE",1,0,1991,261,129,132,164,78,86,0.667,0.628,0.591,12570,22.456028,75,254,0.973180076628352
"10197",213251,"JUNIATA COLLEGE",1,0,1992,258,132,126,161,68,93,0.705,0.624,0.54,13350,23.479749,78,251,0.972868217054264
"10198",213251,"JUNIATA COLLEGE",1,0,1993,301,166,135,198,87,111,0.669,0.658,0.644,14250,25.089594,74,266,0.883720930232558
"10199",213251,"JUNIATA COLLEGE",1,0,1995,282,175,107,196,73,123,0.703,0.695,0.682,16010,26.461943,73,252,0.893617021276596
"10200",213251,"JUNIATA COLLEGE",1,0,1996,349,182,167,237,100,137,0.753,0.679,0.599,16750,27.860673,70,314,0.899713467048711
"10201",213251,"JUNIATA COLLEGE",1,0,1997,342,186,156,232,89,143,0.769,0.678,0.571,17300,21.633281,77,321,0.93859649122807
"10202",213251,"JUNIATA COLLEGE",1,0,1998,337,192,145,227,88,139,0.724,0.674,0.607,17820,22.296474,75,315,0.934718100890208
"10203",213251,"JUNIATA COLLEGE",1,0,1999,324,184,140,217,81,136,0.739,0.67,0.579,18030,23.849309,83,302,0.932098765432099
"10204",213251,"JUNIATA COLLEGE",1,0,2000,359,207,152,265,105,160,0.773,0.738,0.691,18940,25.696013,84,342,0.952646239554318
"10205",213251,"JUNIATA COLLEGE",1,0,2001,340,205,135,242,87,155,0.756,0.712,0.644,20170,27.751569,85,327,0.961764705882353
"10206",213251,"JUNIATA COLLEGE",1,0,2002,375,215,160,285,119,166,0.772,0.76,0.744,21160,29.311843,90,354,0.944
"10207",213251,"JUNIATA COLLEGE",1,0,2003,381,200,181,284,135,149,0.745,0.745,0.746,22240,31.391815,94,357,0.937007874015748
"10208",213251,"JUNIATA COLLEGE",1,0,2004,390,213,177,273,129,144,0.676,0.7,0.729,23720,34.369498,88,362,0.928205128205128
"10209",213251,"Juniata College",1,0,2005,387,212,175,279,120,159,0.75,0.721,0.686,25260,36.185069,95,358,0.925064599483204
"10210",213251,"Juniata College",1,0,2006,362,195,167,257,111,146,0.749,0.71,0.665,26900,36.518823,95,338,0.933701657458563
"10211",213251,"Juniata College",1,0,2007,377,220,157,271,104,167,0.759,0.719,0.662,28250,41.534792,104,336,0.891246684350133
"10212",213251,"Juniata College",1,0,2008,461,260,201,332,134,198,0.762,0.72,0.667,29610,45.271242,98,402,0.872017353579176
"10213",213251,"Juniata College",1,0,2009,366,207,159,246,98,148,0.715,0.672,0.616,30880,47.997545,99,315,0.860655737704918
"10214",213251,"Juniata College",1,0,2010,421,227,194,303,130,173,0.762,0.72,0.67,32120,47.987841,97,345,0.819477434679335
"10215",213321,"KING'S COLLEGE",1,0,1991,359,164,195,232,115,117,0.713,0.646,0.59,8740,21.272423,92,343,0.955431754874652
"10216",213321,"KING'S COLLEGE",1,0,1992,467,213,254,310,159,151,0.709,0.664,0.626,9770,23.692873,96,438,0.937901498929336
"10217",213321,"KING'S COLLEGE",1,0,1993,380,166,214,241,127,114,0.687,0.634,0.593,10600,26.73237,95,364,0.957894736842105
"10218",213321,"KING'S COLLEGE",1,0,1995,426,180,246,247,126,121,0.672,0.58,0.512,12260,30.84512,99,400,0.938967136150235
"10219",213321,"KING'S COLLEGE",1,0,1996,432,236,196,284,116,168,0.712,0.657,0.592,12980,34.058893,96,398,0.921296296296296
"10220",213321,"KINGS COLLEGE",1,0,1997,435,195,240,260,121,139,0.713,0.598,0.504,14000,28.136947,93,403,0.926436781609195
"10221",213321,"KINGS COLLEGE",1,0,1998,396,189,207,240,113,127,0.672,0.606,0.546,14970,28.566826,106,371,0.936868686868687
"10222",213321,"KINGS COLLEGE",1,0,1999,420,218,202,268,112,156,0.716,0.638,0.554,15240,28.853329,105,374,0.89047619047619
"10223",213321,"KINGS COLLEGE",1,0,2000,457,199,258,285,133,152,0.764,0.624,0.516,16000,30.67968,108.5,407,0.890590809628009
"10224",213321,"KINGS COLLEGE",1,0,2001,441,217,224,286,121,165,0.76,0.649,0.54,16720,32.028942,112,372,0.843537414965986
"10225",213321,"KINGS COLLEGE",1,0,2002,409,195,214,263,125,138,0.708,0.643,0.584,17390,34.659409,114,357,0.872860635696821
"10226",213321,"KINGS COLLEGE",1,0,2003,448,166,282,284,164,120,0.723,0.634,0.582,18260,36.276983,114,371,0.828125
"10227",213321,"KINGS COLLEGE",1,0,2004,449,178,271,268,139,129,0.725,0.597,0.513,19260,38.153013,108,377,0.839643652561247
"10228",213321,"King's College",1,0,2005,479,198,281,282,149,133,0.672,0.589,0.53,20320,36.767381,109,397,0.828810020876827
"10229",213321,"King's College",1,0,2006,478,202,276,295,153,142,0.703,0.617,0.554,22280,39.126443,116,414,0.866108786610879
"10230",213321,"King's College",1,0,2007,555,268,287,338,173,165,0.616,0.609,0.603,23450,42.819595,121,467,0.841441441441441
"10231",213321,"King's College",1,0,2008,559,295,264,315,134,181,0.614,0.564,0.508,24680,47.041151,129,441,0.788908765652952
"10232",213321,"King's College",1,0,2009,499,233,266,303,142,161,0.691,0.607,0.534,25644,50.512882,123,372,0.745490981963928
"10233",213321,"King's College",1,0,2010,528,240,288,310,150,160,0.667,0.587,0.521,26644,52.699628,128,431,0.816287878787879
"10234",213349,"KUTZTOWN UNIVERSITY OF PENNSYLVANIA",1,0,1991,1427,813,614,295,59,236,0.29,0.207,0.096,3022,57.900476,370,1272,0.891380518570427
"10235",213349,"KUTZTOWN UNIVERSITY OF PENNSYLVANIA",1,0,1992,1131,632,499,188,40,148,0.234,0.166,0.08,3160,62.133925,405,982,0.868258178603006
"10236",213349,"KUTZTOWN UNIVERSITY OF PENNSYLVANIA",1,0,1993,1309,771,538,236,57,179,0.232,0.18,0.106,3558,65.110045,383,1207,0.922077922077922
"10237",213349,"KUTZTOWN UNIVERSITY OF PENNSYLVANIA",1,0,1995,1229,715,514,192,52,140,0.196,0.156,0.101,3940,78.482156,395,1105,0.899104963384866
"10238",213349,"KUTZTOWN UNIVERSITY OF PENNSYLVANIA",1,0,1996,1440,883,557,245,56,189,0.214,0.17,0.101,4098,79.354885,406,1341,0.93125
"10239",213349,"KUTZTOWN UNIVERSITY OF PENNSYLVANIA",1,0,1997,1497,837,660,252,72,180,0.215,0.168,0.109,4219,81.956824,407,1380,0.92184368737475
"10240",213349,"KUTZTOWN UNIVERSITY OF PENNSYLVANIA",1,0,1998,1417,840,577,282,70,212,0.252,0.199,0.121,4251,85.136128,370,1320,0.931545518701482
"10241",213349,"KUTZTOWN UNIVERSITY OF PENNSYLVANIA",1,0,1999,1550,922,628,374,89,285,0.309,0.241,0.142,3618,89.38435,401,1464,0.944516129032258
"10242",213349,"KUTZTOWN UNIVERSITY OF PENNSYLVANIA",1,0,2000,1528,925,603,422,100,322,0.348,0.276,0.166,3792,94.783876,381,1448,0.947643979057592
"10243",213349,"KUTZTOWN UNIVERSITY OF PENNSYLVANIA",1,0,2001,1630,957,673,474,111,363,0.379,0.291,0.165,4016,102.443802,361,1454,0.892024539877301
"10244",213349,"KUTZTOWN UNIVERSITY OF PENNSYLVANIA",1,0,2002,1726,1027,699,498,141,357,0.348,0.289,0.202,4378,96.907518,362,1437,0.832560834298957
"10245",213349,"KUTZTOWN UNIVERSITY OF PENNSYLVANIA",1,0,2003,1825,1035,790,549,158,391,0.378,0.301,0.2,4598,100.979063,381,1503,0.823561643835616
"10246",213349,"KUTZTOWN UNIVERSITY OF PENNSYLVANIA",1,0,2004,2049,1217,832,680,191,489,0.402,0.332,0.23,4810,110.030822,396,1698,0.828696925329429
"10247",213349,"Kutztown University of Pennsylvania",1,0,2005,1905,1105,800,621,190,431,0.39,0.326,0.238,4906,118.368573,410,1596,0.837795275590551
"10248",213349,"Kutztown University of Pennsylvania",1,0,2006,1930,1177,753,612,163,449,0.382,0.317,0.216,5038,126.484877,412,1644,0.851813471502591
"10249",213349,"Kutztown University of Pennsylvania",1,0,2007,1888,1111,777,645,182,463,0.417,0.342,0.234,5177,138.665059,417,1577,0.835275423728814
"10250",213349,"Kutztown University of Pennsylvania",1,0,2008,1812,1034,778,680,206,474,0.458,0.375,0.265,5358,150.707776,432,1562,0.862030905077263
"10251",213349,"Kutztown University of Pennsylvania",1,0,2009,1985,1132,853,689,221,468,0.413,0.347,0.259,5554,161.055805,448,1688,0.850377833753149
"10252",213349,"Kutztown University of Pennsylvania",1,0,2010,2009,1175,834,677,217,460,0.392,0.337,0.26,5804,164.16151,427,1663,0.827775012444002
"10253",213358,"LA ROCHE COLLEGE",1,0,1991,120,76,44,34,10,24,0.316,0.283,0.227,7138,10.935348,43,106,0.883333333333333
"10254",213358,"LA ROCHE COLLEGE",1,0,1992,118,84,34,33,6,27,0.321,0.28,0.176,7780,11.77462,43,113,0.957627118644068
"10255",213358,"LA ROCHE COLLEGE",1,0,1993,181,85,96,61,31,30,0.353,0.337,0.323,8468,12.649661,44,124,0.685082872928177
"10256",213358,"LA ROCHE COLLEGE",1,0,1995,147,85,62,37,9,28,0.329,0.252,0.145,9426,14.976321,46,132,0.897959183673469
"10257",213358,"LA ROCHE COLLEGE",1,0,1996,152,106,46,57,19,38,0.359,0.375,0.413,9912,15.999393,43,137,0.901315789473684
"10258",213358,"LA ROCHE COLLEGE",1,0,1997,184,101,83,91,44,47,0.465,0.495,0.53,10360,13.240949,45,148,0.804347826086957
"10259",213358,"LA ROCHE COLLEGE",1,0,1998,204,127,77,82,30,52,0.409,0.402,0.39,10780,13.373657,45,178,0.872549019607843
"10260",213358,"LA ROCHE COLLEGE",1,0,1999,306,170,136,133,58,75,0.441,0.435,0.426,11100,15.711683,45,202,0.660130718954248
"10261",213358,"LA ROCHE COLLEGE",1,0,2000,351,199,152,200,98,102,0.513,0.57,0.645,11600,18.933217,49.5,211,0.601139601139601
"10262",213358,"LA ROCHE COLLEGE",1,0,2001,214,133,81,91,34,57,0.429,0.425,0.42,12180,21.146674,54,178,0.831775700934579
"10263",213358,"LA ROCHE COLLEGE",1,0,2002,295,175,120,117,43,74,0.423,0.397,0.358,12790,23.770179,63,217,0.735593220338983
"10264",213358,"LA ROCHE COLLEGE",1,0,2003,174,124,50,58,13,45,0.363,0.333,0.26,15220,24.949823,68,159,0.913793103448276
"10265",213358,"LA ROCHE COLLEGE",1,0,2004,214,141,73,46,10,36,0.255,0.215,0.137,15982,23.48,65,182,0.850467289719626
"10266",213358,"La Roche College",1,0,2005,302,203,99,103,32,71,0.35,0.341,0.323,16780,22.304509,64,212,0.701986754966887
"10267",213358,"La Roche College",1,0,2006,259,164,95,92,32,60,0.366,0.355,0.337,17620,22.860063,64,158,0.61003861003861
"10268",213358,"La Roche College",1,0,2007,294,192,102,93,29,64,0.333,0.316,0.284,18600,22.982677,64,177,0.602040816326531
"10269",213358,"La Roche College",1,0,2008,227,148,79,60,15,45,0.304,0.264,0.19,19660,23.683738,63,130,0.572687224669604
"10270",213358,"La Roche College",1,0,2009,190,121,69,46,15,31,0.256,0.242,0.217,20740,24.014975,63,112,0.589473684210526
"10271",213358,"La Roche College",1,0,2010,269,151,118,93,48,45,0.298,0.346,0.407,21570,22.585877,62,183,0.680297397769517
"10272",213367,"LA SALLE UNIVERSITY",1,0,1991,594,293,301,331,152,179,0.611,0.557,0.505,10300,56.398733,211,512,0.861952861952862
"10273",213367,"LA SALLE UNIVERSITY",1,0,1992,564,293,271,358,159,199,0.679,0.635,0.587,10970,60.174857,212,485,0.859929078014184
"10274",213367,"LA SALLE UNIVERSITY",1,0,1993,597,327,270,321,125,196,0.599,0.538,0.463,11560,61.062836,209,509,0.852596314907873
"10275",213367,"LA SALLE UNIVERSITY",1,0,1995,741,438,303,404,140,264,0.603,0.545,0.462,13070,62.837209,187,649,0.875843454790823
"10276",213367,"LA SALLE UNIVERSITY",1,0,1996,648,355,293,362,146,216,0.609,0.559,0.498,14090,67.070052,182,550,0.848765432098765
"10277",213367,"LA SALLE UNIVERSITY",1,0,1997,834,479,355,476,184,292,0.61,0.571,0.518,14850,58.139,179,714,0.856115107913669
"10278",213367,"LA SALLE UNIVERSITY",1,0,1998,663,321,342,361,161,200,0.623,0.544,0.471,15860,61.069,171,552,0.832579185520362
"10279",213367,"LA SALLE UNIVERSITY",1,0,1999,801,426,375,446,188,258,0.606,0.557,0.501,16880,59.76,182,681,0.850187265917603
"10280",213367,"LA SALLE UNIVERSITY",1,0,2000,774,404,370,455,203,252,0.624,0.588,0.549,18020,63.65,187.5,641,0.828165374677003
"10281",213367,"LA SALLE UNIVERSITY",1,0,2001,849,476,373,514,190,324,0.681,0.605,0.509,19740,72.182,193,696,0.819787985865724
"10282",213367,"LA SALLE UNIVERSITY",1,0,2002,837,456,381,445,173,272,0.597,0.532,0.454,21270,82.597,200,692,0.826762246117085
"10283",213367,"LA SALLE UNIVERSITY",1,0,2003,809,423,386,461,204,257,0.608,0.57,0.528,22760,83.723,207,584,0.721878862793572
"10284",213367,"LA SALLE UNIVERSITY",1,0,2004,829,419,410,441,195,246,0.587,0.532,0.476,24410,88.024,213,627,0.756332931242461
"10285",213367,"La Salle University",1,0,2005,803,440,363,400,160,240,0.545,0.498,0.441,25880,96.922,210,543,0.676214196762142
"10286",213367,"La Salle University",1,0,2006,884,512,372,467,180,287,0.56,0.528,0.484,27500,104.144,225,609,0.688914027149321
"10287",213367,"La Salle University",1,0,2007,804,472,332,424,136,288,0.61,0.527,0.41,29200,112.133,228,538,0.669154228855721
"10288",213367,"La Salle University",1,0,2008,902,519,383,471,190,281,0.541,0.522,0.496,31000,126.864284,230,548,0.607538802660754
"10289",213367,"La Salle University",1,0,2009,1005,580,425,522,209,313,0.54,0.519,0.492,32500,120.793892,231,618,0.614925373134328
"10290",213367,"La Salle University",1,0,2010,982,605,377,524,182,342,0.565,0.534,0.483,33500,126.843697,226,602,0.613034623217923
"10291",213385,"LAFAYETTE COLLEGE",1,0,1991,519,243,276,426,212,214,0.881,0.821,0.768,15475,55.93895,169,434,0.836223506743738
"10292",213385,"LAFAYETTE COLLEGE",1,0,1992,575,263,312,455,231,224,0.852,0.791,0.74,16795,55.123414,179,506,0.88
"10293",213385,"LAFAYETTE COLLEGE",1,0,1993,570,252,318,443,226,217,0.861,0.777,0.711,17880,57.167058,179,481,0.843859649122807
"10294",213385,"LAFAYETTE COLLEGE",1,0,1995,525,241,284,415,208,207,0.859,0.79,0.732,19621,63.020461,182,457,0.870476190476191
"10295",213385,"LAFAYETTE COLLEGE",1,0,1996,572,281,291,460,215,245,0.872,0.804,0.739,20390,69.023561,180,522,0.912587412587413
"10296",213385,"LAFAYETTE COLLEGE",1,0,1997,568,263,305,456,230,226,0.859,0.803,0.754,21202,61.968249,182,498,0.876760563380282
"10297",213385,"LAFAYETTE COLLEGE",1,0,1998,597,281,316,480,241,239,0.851,0.804,0.763,22049,63.840814,180,517,0.865996649916248
"10298",213385,"LAFAYETTE COLLEGE",1,0,1999,583,316,267,505,218,287,0.908,0.866,0.816,22844,66.784199,178,506,0.867924528301887
"10299",213385,"LAFAYETTE COLLEGE",1,0,2000,558,280,278,490,238,252,0.9,0.878,0.856,23758,73.452413,178.5,482,0.863799283154122
"10300",213385,"LAFAYETTE COLLEGE",1,0,2001,575,287,288,487,238,249,0.868,0.847,0.826,24828,78.953081,179,508,0.883478260869565
"10301",213385,"LAFAYETTE COLLEGE",1,0,2002,580,267,313,498,263,235,0.88,0.859,0.84,25946,85.120254,184,486,0.837931034482759
"10302",213385,"LAFAYETTE COLLEGE",1,0,2003,584,268,316,502,267,235,0.877,0.86,0.845,27178,92.285179,198,475,0.813356164383562
"10303",213385,"LAFAYETTE COLLEGE",1,0,2004,609,315,294,529,249,280,0.889,0.869,0.847,28470,95.265821,200,516,0.847290640394089
"10304",213385,"Lafayette College",1,0,2005,596,275,321,508,268,240,0.873,0.852,0.835,29822,101.691037,196,438,0.73489932885906
"10305",213385,"Lafayette College",1,0,2006,629,290,339,561,299,262,0.903,0.892,0.882,31501,108.674553,198,445,0.707472178060413
"10306",213385,"Lafayette College",1,0,2007,591,277,314,500,253,247,0.892,0.846,0.806,33634,118.029841,210,434,0.734348561759729
"10307",213385,"Lafayette College",1,0,2008,600,270,330,530,280,250,0.926,0.883,0.848,35904,123.434285,208,396,0.66
"10308",213385,"Lafayette College",1,0,2009,616,298,318,533,263,270,0.906,0.865,0.827,37520,125.843648,211,348,0.564935064935065
"10309",213385,"Lafayette College",1,0,2010,648,294,354,553,279,274,0.932,0.853,0.788,38810,125.98603,217,443,0.683641975308642
"10310",213507,"LEBANON VALLEY COLLEGE",1,0,1991,180,77,103,98,50,48,0.623,0.544,0.485,11750,16.649743,67,166,0.922222222222222
"10311",213507,"LEBANON VALLEY COLLEGE",1,0,1992,280,123,157,161,84,77,0.626,0.575,0.535,12875,18.345861,67,263,0.939285714285714
"10312",213507,"LEBANON VALLEY COLLEGE",1,0,1993,314,170,144,191,77,114,0.671,0.608,0.535,13700,19.727216,68,297,0.945859872611465
"10313",213507,"LEBANON VALLEY COLLEGE",1,0,1995,297,155,142,183,79,104,0.671,0.616,0.556,14785,26.106387,70,284,0.956228956228956
"10314",213507,"LEBANON VALLEY COLLEGE",1,0,1996,287,172,115,165,53,112,0.651,0.575,0.461,15360,28.760638,70,269,0.937282229965157
"10315",213507,"LEBANON VALLEY COLLEGE",1,0,1997,303,174,129,185,71,114,0.655,0.611,0.55,15980,23.533455,73,276,0.910891089108911
"10316",213507,"LEBANON VALLEY COLLEGE",1,0,1998,422,208,214,247,110,137,0.659,0.585,0.514,16610,24.784403,76,389,0.921800947867299
"10317",213507,"LEBANON VALLEY COLLEGE",1,0,1999,407,238,169,279,102,177,0.744,0.686,0.604,16730,26.0408,81,383,0.941031941031941
"10318",213507,"LEBANON VALLEY COLLEGE",1,0,2000,388,225,163,242,85,157,0.698,0.624,0.521,17870,27.093853,84.5,358,0.922680412371134
"10319",213507,"LEBANON VALLEY COLLEGE",1,0,2001,416,229,187,266,105,161,0.703,0.639,0.561,19210,28.703866,88,389,0.935096153846154
"10320",213507,"LEBANON VALLEY COLLEGE",1,0,2002,422,234,188,266,99,167,0.714,0.63,0.527,20600,31.476723,95,390,0.924170616113744
"10321",213507,"LEBANON VALLEY COLLEGE",1,0,2003,429,231,198,292,119,173,0.749,0.681,0.601,21860,34.089547,99,387,0.902097902097902
"10322",213507,"LEBANON VALLEY COLLEGE",1,0,2004,416,221,195,287,121,166,0.751,0.69,0.621,22950,35.087412,96,367,0.882211538461538
"10323",213507,"Lebanon Valley College",1,0,2005,454,223,231,304,138,166,0.744,0.67,0.597,24210,35.807046,100,391,0.861233480176211
"10324",213507,"Lebanon Valley College",1,0,2006,447,241,206,300,114,186,0.772,0.671,0.553,25710,37.598895,98,403,0.901565995525727
"10325",213507,"Lebanon Valley College",1,0,2007,450,261,189,308,109,199,0.763,0.684,0.577,27125,39.284029,100,392,0.871111111111111
"10326",213507,"Lebanon Valley College",1,0,2008,395,217,178,276,110,166,0.765,0.699,0.618,28650,42.29392,99,353,0.893670886075949
"10327",213507,"Lebanon Valley College",1,0,2009,378,205,173,258,92,166,0.81,0.683,0.532,29780,44.265341,100,339,0.896825396825397
"10328",213507,"Lebanon Valley College",1,0,2010,460,245,215,331,152,179,0.731,0.72,0.707,30910,47.656836,101,405,0.880434782608696
"10329",213543,"LEHIGH UNIVERSITY",1,0,1991,1117,411,706,749,435,314,0.764,0.671,0.616,15650,170.474,411,980,0.877350044762757
"10330",213543,"LEHIGH UNIVERSITY",1,0,1992,1089,385,704,720,430,290,0.753,0.661,0.611,16700,185.361,418,958,0.879706152433425
"10331",213543,"LEHIGH UNIVERSITY",1,0,1993,1095,394,701,706,404,302,0.767,0.645,0.576,17750,182.466,416,941,0.859360730593607
"10332",213543,"LEHIGH UNIVERSITY",1,0,1995,1045,412,633,734,404,330,0.801,0.702,0.638,19650,199.225,385,828,0.792344497607655
"10333",213543,"LEHIGH UNIVERSITY",1,0,1996,1101,409,692,768,433,335,0.819,0.698,0.626,20500,202.28,399,847,0.769300635785649
"10334",213543,"LEHIGH UNIVERSITY",1,0,1997,1097,442,655,803,444,359,0.812,0.732,0.678,21350,183.213,397,878,0.800364630811304
"10335",213543,"LEHIGH UNIVERSITY",1,0,1998,1112,478,634,789,397,392,0.82,0.71,0.626,22300,190.611,393,857,0.77068345323741
"10336",213543,"LEHIGH UNIVERSITY",1,0,1999,1077,455,622,799,437,362,0.796,0.742,0.703,23150,198.04,391,790,0.733519034354689
"10337",213543,"LEHIGH UNIVERSITY",1,0,2000,1127,464,663,845,473,372,0.802,0.75,0.713,24000,199.791,392,843,0.748003549245785
"10338",213543,"LEHIGH UNIVERSITY",1,0,2001,1109,435,674,798,436,362,0.832,0.72,0.647,24940,207.816,393,838,0.755635707844905
"10339",213543,"LEHIGH UNIVERSITY",1,0,2002,1143,442,701,822,461,361,0.817,0.719,0.658,25980,221.222,406,938,0.820647419072616
"10340",213543,"LEHIGH UNIVERSITY",1,0,2003,1124,448,676,854,487,367,0.819,0.76,0.72,27230,237.034,423,873,0.776690391459075
"10341",213543,"LEHIGH UNIVERSITY",1,0,2004,1054,463,591,814,417,397,0.858,0.772,0.706,29140,248.131,432,847,0.803605313092979
"10342",213543,"Lehigh University",1,0,2005,1223,512,711,956,521,435,0.85,0.782,0.733,31180,266.454,434,1036,0.847097301717089
"10343",213543,"Lehigh University",1,0,2006,1217,511,706,950,523,427,0.836,0.781,0.741,33470,269.002,443,874,0.718159408381265
"10344",213543,"Lehigh University",1,0,2007,1165,450,715,851,485,366,0.813,0.73,0.678,35310,297.879,440,850,0.729613733905579
"10345",213543,"Lehigh University",1,0,2008,1205,516,689,910,484,426,0.826,0.755,0.702,37250,318.378,443,803,0.666390041493776
"10346",213543,"Lehigh University",1,0,2009,1189,489,700,878,469,409,0.836,0.738,0.67,38330,318.249,464,839,0.705634987384357
"10347",213543,"Lehigh University",1,0,2010,1208,516,692,932,495,437,0.847,0.772,0.715,39480,317.062,473,885,0.732615894039735
"10348",213613,"LOCK HAVEN UNIVERSITY",1,0,1991,737,447,290,187,52,135,0.302,0.254,0.179,3020,32.876556,211,700,0.949796472184532
"10349",213613,"LOCK HAVEN UNIVERSITY",1,0,1992,906,514,392,210,61,149,0.29,0.232,0.156,3261,37.603409,201,872,0.962472406181015
"10350",213613,"LOCK HAVEN UNIVERSITY",1,0,1993,758,402,356,157,43,114,0.284,0.207,0.121,3509,39.036953,197,720,0.949868073878628
"10351",213613,"LOCK HAVEN UNIVERISTY OF PENNSYLVANIA",1,0,1995,693,359,334,133,43,90,0.251,0.192,0.129,3822,41.401685,188,635,0.916305916305916
"10352",213613,"LOCK HAVEN UNIVERISTY OF PENNSYLVANIA",1,0,1996,780,419,361,179,62,117,0.279,0.229,0.172,3988,42.10703,183,723,0.926923076923077
"10353",213613,"LOCK HAVEN UNIVERSITY OF PENNSYLVANIA",1,0,1997,822,430,392,188,67,121,0.281,0.229,0.171,4062,45.356273,197,768,0.934306569343066
"10354",213613,"LOCK HAVEN UNIVERSITY OF PENNSYLVANIA",1,0,1998,813,463,350,159,50,109,0.235,0.196,0.143,4071,46.592399,207,754,0.927429274292743
"10355",213613,"LOCK HAVEN UNIVERSITY OF PENNSYLVANIA",1,0,1999,887,502,385,212,65,147,0.293,0.239,0.169,3618,49.507684,202,839,0.945885005636979
"10356",213613,"LOCK HAVEN UNIVERSITY OF PENNSYLVANIA",1,0,2000,890,522,368,250,68,182,0.349,0.281,0.185,3792,52.67909,203.5,824,0.925842696629213
"10357",213613,"LOCK HAVEN UNIVERSITY OF PENNSYLVANIA",1,0,2001,978,581,397,286,96,190,0.327,0.292,0.242,4016,57.25521,205,917,0.937627811860941
"10358",213613,"LOCK HAVEN UNIVERSITY OF PENNSYLVANIA",1,0,2002,1038,646,392,305,89,216,0.334,0.294,0.227,4378,57.125078,213,941,0.906551059730251
"10359",213613,"LOCK HAVEN UNIVERSITY OF PENNSYLVANIA",1,0,2003,1145,657,488,316,104,212,0.323,0.276,0.213,4598,61.646196,220,1033,0.902183406113537
"10360",213613,"LOCK HAVEN UNIVERSITY OF PENNSYLVANIA",1,0,2004,1191,702,489,348,129,219,0.312,0.292,0.264,4810,66.354187,235,1051,0.882451721242653
"10361",213613,"Lock Haven University of Pennsylvania",1,0,2005,1215,695,520,314,110,204,0.294,0.258,0.212,4906,70.743327,236,990,0.814814814814815
"10362",213613,"Lock Haven University of Pennsylvania",1,0,2006,1079,608,471,266,106,160,0.263,0.247,0.225,5038,74.591147,233,900,0.834105653382762
"10363",213613,"Lock Haven University of Pennsylvania",1,0,2007,1217,656,561,321,144,177,0.27,0.264,0.257,5178,76.138562,235,1035,0.850451930977814
"10364",213613,"Lock Haven University",1,0,2008,1269,731,538,340,119,221,0.302,0.268,0.221,5358,80.734613,235,1093,0.861308116627266
"10365",213613,"Lock Haven University",1,0,2009,1185,702,483,336,117,219,0.312,0.284,0.242,5554,81.390521,231,1020,0.860759493670886
"10366",213613,"Lock Haven University",1,0,2010,1185,630,555,361,158,203,0.322,0.305,0.285,5804,86.682931,229,1030,0.869198312236287
"10367",213668,"LYCOMING COLLEGE",1,0,1991,374,190,184,153,67,86,0.453,0.409,0.364,11100,20.504663,85,357,0.954545454545455
"10368",213668,"LYCOMING COLLEGE",1,0,1992,359,179,180,174,72,102,0.57,0.485,0.4,12000,23.368669,83,346,0.963788300835655
"10369",213668,"LYCOMING COLLEGE",1,0,1993,361,203,158,191,72,119,0.586,0.529,0.456,13000,25.739984,86,345,0.955678670360111
"10370",213668,"LYCOMING COLLEGE",1,0,1995,366,210,156,237,82,155,0.738,0.648,0.526,14700,30.337999,87,347,0.948087431693989
"10371",213668,"LYCOMING COLLEGE",1,0,1996,386,186,200,226,102,124,0.667,0.585,0.51,15460,31.070396,86,372,0.963730569948187
"10372",213668,"LYCOMING COLLEGE",1,0,1997,379,227,152,214,65,149,0.656,0.565,0.428,16130,21.445276,91,372,0.981530343007916
"10373",213668,"LYCOMING COLLEGE",1,0,1998,380,195,185,222,85,137,0.703,0.584,0.459,16810,21.936081,87,367,0.965789473684211
"10374",213668,"LYCOMING COLLEGE",1,0,1999,392,209,183,242,99,143,0.684,0.617,0.541,17440,22.653406,86,379,0.966836734693878
"10375",213668,"LYCOMING COLLEGE",1,0,2000,337,177,160,199,90,109,0.616,0.591,0.562,18240,23.870354,84,332,0.985163204747775
"10376",213668,"LYCOMING COLLEGE",1,0,2001,407,218,189,249,100,149,0.683,0.612,0.529,19104,24.32376,82,385,0.945945945945946
"10377",213668,"LYCOMING COLLEGE",1,0,2002,373,195,178,234,100,134,0.687,0.627,0.562,20032,25.629505,82,357,0.957104557640751
"10378",213668,"LYCOMING COLLEGE",1,0,2003,381,226,155,254,97,157,0.695,0.667,0.626,21088,26.5795,84,360,0.94488188976378
"10379",213668,"LYCOMING COLLEGE",1,0,2004,399,217,182,249,109,140,0.645,0.624,0.599,22336,27.911799,81,376,0.942355889724311
"10380",213668,"Lycoming College",1,0,2005,357,219,138,216,74,142,0.648,0.605,0.536,23680,29.804376,84,328,0.918767507002801
"10381",213668,"Lycoming College",1,0,2006,375,193,182,213,87,126,0.653,0.568,0.478,25120,30.949271,80,349,0.930666666666667
"10382",213668,"Lycoming College",1,0,2007,399,211,188,215,84,131,0.621,0.539,0.447,26624,31.483108,84,372,0.932330827067669
"10383",213668,"Lycoming College",1,0,2008,340,161,179,178,77,101,0.627,0.524,0.43,28224,32.560381,82,319,0.938235294117647
"10384",213668,"Lycoming College",1,0,2009,383,194,189,220,89,131,0.675,0.574,0.471,29344,31.856316,81,286,0.746736292428198
"10385",213668,"Lycoming College",1,0,2010,346,211,135,205,67,138,0.654,0.592,0.496,30240,32.275151,85,265,0.765895953757225
"10386",213783,"MANSFIELD UNIVERSITY OF PENNSYLVANIA",1,0,1991,461,283,178,168,50,118,0.417,0.364,0.281,2947,31.745708,178,428,0.928416485900217
"10387",213783,"MANSFIELD UNIVERSITY OF PENNSYLVANIA",1,0,1992,485,294,191,148,44,104,0.354,0.305,0.23,3168,34.195446,179,440,0.907216494845361
"10388",213783,"MANSFIELD UNIVERSITY OF PENNSYLVANIA",1,0,1993,590,350,240,189,59,130,0.371,0.32,0.246,3440,36.307032,179,539,0.913559322033898
"10389",213783,"MANSFIELD UNIVERSITY OF PENNSYLVANIA",1,0,1995,577,340,237,135,41,94,0.276,0.234,0.173,3804,38.771507,179,536,0.92894280762565
"10390",213783,"MANSFIELD UNIVERSITY OF PENNSYLVANIA",1,0,1996,590,316,274,154,57,97,0.307,0.261,0.208,4034,41.080085,171,533,0.903389830508475
"10391",213783,"MANSFIELD UNIVERSITY OF PENNSYLVANIA",1,0,1997,597,329,268,141,53,88,0.268,0.236,0.198,4354,41.32383,168,550,0.921273031825796
"10392",213783,"MANSFIELD UNIVERSITY OF PENNSYLVANIA",1,0,1998,619,346,273,143,64,79,0.228,0.231,0.234,4410,42.813882,156,548,0.88529886914378
"10393",213783,"MANSFIELD UNIVERSITY OF PENNSYLVANIA",1,0,1999,611,364,247,178,53,125,0.343,0.291,0.215,3618,45.011278,169,569,0.93126022913257
"10394",213783,"MANSFIELD UNIVERSITY OF PENNSYLVANIA",1,0,2000,639,363,276,183,79,104,0.286,0.286,0.286,3792,47.052983,168.5,589,0.921752738654147
"10395",213783,"MANSFIELD UNIVERSITY OF PENNSYLVANIA",1,0,2001,640,362,278,200,77,123,0.34,0.312,0.277,4016,49.408939,168,592,0.925
"10396",213783,"MANSFIELD UNIVERSITY OF PENNSYLVANIA",1,0,2002,654,381,273,171,48,123,0.323,0.261,0.176,4378,49.506777,155,589,0.900611620795107
"10397",213783,"MANSFIELD UNIVERSITY OF PENNSYLVANIA",1,0,2003,690,403,287,179,74,105,0.26,0.259,0.258,4598,50.273565,153,595,0.86231884057971
"10398",213783,"MANSFIELD UNIVERSITY OF PENNSYLVANIA",1,0,2004,689,402,287,168,54,114,0.284,0.244,0.188,4810,52.29731,155,571,0.828737300435414
"10399",213783,"Mansfield University of Pennsylvania",1,0,2005,662,406,256,216,62,154,0.379,0.326,0.242,4906,53.068077,147,534,0.806646525679758
"10400",213783,"Mansfield University of Pennsylvania",1,0,2006,603,356,247,172,53,119,0.334,0.285,0.215,5038,54.496988,148,503,0.834162520729685
"10401",213783,"Mansfield University of Pennsylvania",1,0,2007,661,397,264,198,63,135,0.34,0.3,0.239,5177,57.062555,147,526,0.795763993948563
"10402",213783,"Mansfield University of Pennsylvania",1,0,2008,665,410,255,203,67,136,0.332,0.305,0.263,5358,59.964855,158,516,0.77593984962406
"10403",213783,"Mansfield University of Pennsylvania",1,0,2009,704,397,307,189,71,118,0.297,0.268,0.231,5554,61.999222,156,532,0.755681818181818
"10404",213783,"Mansfield University of Pennsylvania",1,0,2010,631,346,285,162,70,92,0.266,0.257,0.246,5804,63.733642,152,503,0.797147385103011
"10405",213826,"MARYWOOD COLLEGE",1,0,1991,281,237,44,95,12,83,0.35,0.338,0.273,8500,25.88374,122,265,0.943060498220641
"10406",213826,"MARYWOOD COLLEGE",1,0,1992,239,193,46,81,5,76,0.394,0.339,0.109,9350,29.284921,121,233,0.97489539748954
"10407",213826,"MARYWOOD COLLEGE",1,0,1993,292,228,64,101,17,84,0.368,0.346,0.266,9950,30.368656,121,274,0.938356164383562
"10408",213826,"MARYWOOD COLLEGE",1,0,1995,245,193,52,99,13,86,0.446,0.404,0.25,11500,36.27492,120,227,0.926530612244898
"10409",213826,"MARYWOOD COLLEGE",1,0,1996,251,191,60,103,18,85,0.445,0.41,0.3,12395,37.924349,114,230,0.916334661354582
"10410",213826,"MARYWOOD UNIVERSITY",1,0,1997,276,209,67,103,18,85,0.407,0.373,0.269,13165,30.773177,116,248,0.898550724637681
"10411",213826,"MARYWOOD UNIVERSITY",1,0,1998,241,186,55,102,16,86,0.462,0.423,0.291,14020,32.562135,118,220,0.912863070539419
"10412",213826,"MARYWOOD UNIVERSITY",1,0,1999,282,207,75,118,25,93,0.449,0.418,0.333,14070,33.249047,117,257,0.911347517730496
"10413",213826,"MARYWOOD UNIVERSITY",1,0,2000,257,188,69,100,29,71,0.378,0.389,0.42,14850,34.035922,119,242,0.941634241245136
"10414",213826,"MARYWOOD UNIVERSITY",1,0,2001,287,215,72,114,23,91,0.423,0.397,0.319,15600,37.09392,121,271,0.944250871080139
"10415",213826,"MARYWOOD UNIVERSITY",1,0,2002,310,238,72,164,29,135,0.567,0.529,0.403,17600,39.330028,123,276,0.890322580645161
"10416",213826,"MARYWOOD UNIVERSITY",1,0,2003,277,199,78,152,34,118,0.593,0.549,0.436,18560,41.967204,122,252,0.909747292418773
"10417",213826,"MARYWOOD UNIVERSITY",1,0,2004,332,262,70,149,24,125,0.477,0.449,0.343,19600,43.322602,121,292,0.879518072289157
"10418",213826,"Marywood University",1,0,2005,301,230,71,153,30,123,0.535,0.508,0.423,20700,45.995376,121,254,0.843853820598007
"10419",213826,"Marywood University",1,0,2006,383,278,105,197,42,155,0.558,0.514,0.4,21840,49.629647,121,321,0.838120104438642
"10420",213826,"Marywood University",1,0,2007,407,297,110,218,46,172,0.579,0.536,0.418,23040,52.470055,123,360,0.884520884520885
"10421",213826,"Marywood University",1,0,2008,422,291,131,238,62,176,0.605,0.564,0.473,24300,56.922224,130,380,0.900473933649289
"10422",213826,"Marywood University",1,0,2009,411,287,124,231,54,177,0.617,0.562,0.435,25150,61.31347,136,365,0.888077858880779
"10423",213826,"Marywood University",1,0,2010,452,338,114,241,44,197,0.583,0.533,0.386,26000,62.981644,143,386,0.853982300884956
"10424",213996,"MESSIAH COLLEGE",1,0,1991,560,343,217,361,136,225,0.656,0.645,0.627,8700,35.156341,126,501,0.894642857142857
"10425",213996,"MESSIAH COLLEGE",1,0,1992,568,357,211,376,142,234,0.655,0.662,0.673,9110,38.148778,126,525,0.924295774647887
"10426",213996,"MESSIAH COLLEGE",1,0,1993,606,376,230,400,155,245,0.652,0.66,0.674,9804,37.228384,131,569,0.938943894389439
"10427",213996,"MESSIAH COLLEGE",1,0,1995,671,416,255,428,163,265,0.637,0.638,0.639,10954,42.253067,128,629,0.937406855439642
"10428",213996,"MESSIAH COLLEGE",1,0,1996,672,407,265,448,168,280,0.688,0.667,0.634,11888,37.286677,135,620,0.922619047619048
"10429",213996,"MESSIAH COLLEGE",1,0,1997,689,445,244,445,165,280,0.629,0.646,0.676,12990,43.407918,139,639,0.927431059506531
"10430",213996,"MESSIAH COLLEGE",1,0,1998,763,480,283,536,205,331,0.69,0.702,0.724,13880,44.167438,142,712,0.933158584534731
"10431",213996,"MESSIAH COLLEGE",1,0,1999,678,413,265,468,168,300,0.726,0.69,0.634,15000,47.749101,141,642,0.946902654867257
"10432",213996,"MESSIAH COLLEGE",1,0,2000,741,451,290,500,184,316,0.701,0.675,0.634,15830,51.545943,149.5,675,0.910931174089069
"10433",213996,"MESSIAH COLLEGE",1,0,2001,702,425,277,472,166,306,0.72,0.672,0.599,16860,72.058136,158,635,0.904558404558405
"10434",213996,"MESSIAH COLLEGE",1,0,2002,763,475,288,526,168,358,0.754,0.689,0.583,17730,61.918011,166,690,0.9043250327654
"10435",213996,"MESSIAH COLLEGE",1,0,2003,735,463,272,529,189,340,0.734,0.72,0.695,18880,65.083597,166,662,0.900680272108843
"10436",213996,"MESSIAH COLLEGE",1,0,2004,690,453,237,484,159,325,0.717,0.701,0.671,20120,69.089429,170,620,0.898550724637681
"10437",213996,"Messiah College",1,0,2005,707,439,268,500,177,323,0.736,0.707,0.66,21420,73.075308,170,629,0.88967468175389
"10438",213996,"Messiah College",1,0,2006,735,471,264,529,179,350,0.743,0.72,0.678,22600,74.358548,173,605,0.82312925170068
"10439",213996,"Messiah College",1,0,2007,723,459,264,514,185,329,0.717,0.711,0.701,23710,76.946775,172,624,0.863070539419087
"10440",213996,"Messiah College",1,0,2008,709,448,261,529,186,343,0.766,0.746,0.713,24900,78.858164,173,585,0.825105782792666
"10441",213996,"Messiah College",1,0,2009,697,440,257,497,173,324,0.736,0.713,0.673,25900,81.279983,170,610,0.875179340028694
"10442",213996,"Messiah College",1,0,2010,721,433,288,523,210,313,0.723,0.725,0.729,26680,81.146541,175,604,0.837725381414702
"10443",214041,"MILLERSVILLE UNIVERSITY OF PENNSYLVANIA",1,0,1991,1089,672,417,429,127,302,0.449,0.394,0.305,3100,64.921997,332,946,0.868686868686869
"10444",214041,"MILLERSVILLE UNIVERSITY OF PENNSYLVANIA",1,0,1992,1002,635,367,375,93,282,0.444,0.374,0.253,3488,70.388359,322,846,0.844311377245509
"10445",214041,"MILLERSVILLE UNIVERSITY OF PENNSYLVANIA",1,0,1993,946,593,353,339,86,253,0.427,0.358,0.244,3750,73.607031,320,770,0.813953488372093
"10446",214041,"MILLERSVILLE UNIVERSITY OF PENNSYLVANIA",1,0,1995,1157,700,457,389,132,257,0.367,0.336,0.289,4100,85.317365,312,1018,0.879861711322385
"10447",214041,"MILLERSVILLE UNIVERSITY OF PENNSYLVANIA",1,0,1996,979,587,392,327,121,206,0.351,0.334,0.309,4268,88.170697,309,848,0.866189989785495
"10448",214041,"MILLERSVILLE UNIVERSITY OF PENNSYLVANIA",1,0,1997,1068,627,441,409,132,277,0.442,0.383,0.299,4400,88.608597,300,899,0.841760299625468
"10449",214041,"MILLERSVILLE UNIVERSITY OF PENNSYLVANIA",1,0,1998,1110,651,459,383,132,251,0.386,0.345,0.288,4429,92.614063,288,976,0.879279279279279
"10450",214041,"MILLERSVILLE UNIVERSITY OF PENNSYLVANIA",1,0,1999,1239,746,493,424,134,290,0.389,0.342,0.272,3618,96.821575,286,1093,0.882163034705408
"10451",214041,"MILLERSVILLE UNIVERSITY OF PENNSYLVANIA",1,0,2000,1265,768,497,463,163,300,0.391,0.366,0.328,3792,97.9744,291,1133,0.895652173913044
"10452",214041,"MILLERSVILLE UNIVERSITY OF PENNSYLVANIA",1,0,2001,1245,758,487,518,162,356,0.47,0.416,0.333,4016,104.94697,296,1118,0.897991967871486
"10453",214041,"MILLERSVILLE UNIVERSITY OF PENNSYLVANIA",1,0,2002,1270,748,522,463,158,305,0.408,0.365,0.303,4378,100.09772,292,1071,0.843307086614173
"10454",214041,"MILLERSVILLE UNIVERSITY OF PENNSYLVANIA",1,0,2003,1334,754,580,478,159,319,0.423,0.358,0.274,4598,105.005775,303,1062,0.796101949025487
"10455",214041,"MILLERSVILLE UNIVERSITY OF PENNSYLVANIA",1,0,2004,1396,791,605,512,177,335,0.424,0.367,0.293,4810,110.981374,298,1019,0.729942693409742
"10456",214041,"Millersville University of Pennsylvania",1,0,2005,1306,774,532,501,172,329,0.425,0.384,0.323,4906,111.855486,302,953,0.729709035222052
"10457",214041,"Millersville University of Pennsylvania",1,0,2006,1342,792,550,482,154,328,0.414,0.359,0.28,5038,116.836188,308,1069,0.796572280178838
"10458",214041,"Millersville University of Pennsylvania",1,0,2007,1326,766,560,491,161,330,0.431,0.37,0.288,5177,126.192544,310,1051,0.792609351432881
"10459",214041,"Millersville University of Pennsylvania",1,0,2008,1311,729,582,503,190,313,0.429,0.384,0.326,5358,132.012491,300,1044,0.796338672768879
"10460",214041,"Millersville University of Pennsylvania",1,0,2009,1317,726,591,472,179,293,0.404,0.358,0.303,5554,136.936972,303,1065,0.808656036446469
"10461",214041,"Millersville University of Pennsylvania",1,0,2010,1315,728,587,494,193,301,0.414,0.376,0.329,5804,136.638979,298,1068,0.812167300380228
"10462",214069,"COLLEGE MISERICORDIA",1,0,1991,246,187,59,86,23,63,0.337,0.35,0.39,7885,13.451226,66,240,0.975609756097561
"10463",214069,"COLLEGE MISERICORDIA",1,0,1992,292,228,64,88,20,68,0.298,0.301,0.312,9500,16.693277,79,283,0.969178082191781
"10464",214069,"COLLEGE MISERICORDIA",1,0,1993,316,231,85,88,24,64,0.277,0.278,0.282,10460,19.418875,84,308,0.974683544303797
"10465",214069,"COLLEGE MISERICORDIA",1,0,1995,280,204,76,88,28,60,0.294,0.314,0.368,12190,25.846453,92,270,0.964285714285714
"10466",214069,"COLLEGE MISERICORDIA",1,0,1996,251,186,65,59,16,43,0.231,0.235,0.246,12880,26.774914,91,246,0.9800796812749
"10467",214069,"COLLEGE MISERICORDIA",1,0,1997,240,174,66,162,32,130,0.747,0.675,0.485,13830,20.447206,95,237,0.9875
"10468",214069,"COLLEGE MISERICORDIA",1,0,1998,187,142,45,126,31,95,0.669,0.674,0.689,14520,21.371926,90,182,0.973262032085562
"10469",214069,"COLLEGE MISERICORDIA",1,0,1999,249,173,76,165,42,123,0.711,0.663,0.553,14470,21.044533,86,241,0.967871485943775
"10470",214069,"COLLEGE MISERICORDIA",1,0,2000,261,185,76,160,39,121,0.654,0.613,0.513,15190,21.620168,87,256,0.980842911877395
"10471",214069,"COLLEGE MISERICORDIA",1,0,2001,260,188,72,157,39,118,0.628,0.604,0.542,15800,24.091688,88,249,0.957692307692308
"10472",214069,"COLLEGE MISERICORDIA",1,0,2002,347,239,108,201,59,142,0.594,0.579,0.546,16420,25.614147,88,329,0.948126801152738
"10473",214069,"COLLEGE MISERICORDIA",1,0,2003,313,233,80,206,49,157,0.674,0.658,0.613,17970,28.113813,90,297,0.94888178913738
"10474",214069,"COLLEGE MISERICORDIA",1,0,2004,317,225,92,171,41,130,0.578,0.539,0.446,17850,30.476814,93,301,0.949526813880126
"10475",214069,"College Misericordia",1,0,2005,324,222,102,181,52,129,0.581,0.559,0.51,18700,32.464061,90,299,0.922839506172839
"10476",214069,"College Misericordia",1,0,2006,308,192,116,165,57,108,0.562,0.536,0.491,19800,34.811644,94,287,0.931818181818182
"10477",214069,"Misericordia University",1,0,2007,364,273,91,234,51,183,0.67,0.643,0.56,20830,35.702691,94,343,0.942307692307692
"10478",214069,"Misericordia University",1,0,2008,378,248,130,238,72,166,0.669,0.63,0.554,21990,39.249618,95,364,0.962962962962963
"10479",214069,"Misericordia University",1,0,2009,371,236,135,237,78,159,0.674,0.639,0.578,22850,41.408705,96,346,0.932614555256065
"10480",214069,"Misericordia University",1,0,2010,375,265,110,255,62,193,0.728,0.68,0.564,23750,44.227458,104,356,0.949333333333333
"10481",214157,"MORAVIAN COLLEGE",1,0,1991,288,143,145,192,92,100,0.699,0.667,0.634,12698,23.553664,85,270,0.9375
"10482",214157,"MORAVIAN COLLEGE",1,0,1992,296,142,154,187,86,101,0.711,0.632,0.558,13696,25.802116,86,281,0.949324324324324
"10483",214157,"MORAVIAN COLLEGE",1,0,1993,304,157,147,216,102,114,0.726,0.711,0.694,14490,26.735509,86,289,0.950657894736842
"10484",214157,"MORAVIAN COLLEGE",1,0,1995,319,169,150,217,97,120,0.71,0.68,0.647,15880,30.021121,86,304,0.952978056426332
"10485",214157,"MORAVIAN COLLEGE",1,0,1996,284,138,146,194,90,104,0.754,0.683,0.616,16500,33.048377,89,275,0.96830985915493
"10486",214157,"MORAVIAN COLLEGE",1,0,1997,325,190,135,219,86,133,0.7,0.674,0.637,17276,27.062786,93,305,0.938461538461538
"10487",214157,"MORAVIAN COLLEGE AND THEOLOGICAL SEMINARY",1,0,1998,292,172,120,183,69,114,0.663,0.627,0.575,17841,28.731574,95,268,0.917808219178082
"10488",214157,"MORAVIAN COLLEGE AND THEOLOGICAL SEMINARY",1,0,1999,318,162,156,213,102,111,0.685,0.67,0.654,18245,29.829511,98,289,0.908805031446541
"10489",214157,"MORAVIAN COLLEGE AND THEOLOGICAL SEMINARY",1,0,2000,378,236,142,246,80,166,0.703,0.651,0.563,19070,32.662925,100.5,357,0.944444444444444
"10490",214157,"MORAVIAN COLLEGE AND THEOLOGICAL SEMINARY",1,0,2001,315,200,115,219,68,151,0.755,0.695,0.591,20115,35.685877,103,295,0.936507936507937
"10491",214157,"MORAVIAN COLLEGE AND THEOLOGICAL SEMINARY",1,0,2002,372,214,158,264,102,162,0.757,0.71,0.646,20925,36.734579,104,338,0.908602150537634
"10492",214157,"MORAVIAN COLLEGE AND THEOLOGICAL SEMINARY",1,0,2003,379,239,140,270,90,180,0.753,0.712,0.643,21663,39.39932,108,339,0.894459102902375
"10493",214157,"MORAVIAN COLLEGE AND THEOLOGICAL SEMINARY",1,0,2004,382,215,167,261,103,158,0.735,0.683,0.617,23184,42.22732,110,348,0.910994764397906
"10494",214157,"Moravian College and Moravian Theological Seminary",1,0,2005,382,204,178,280,123,157,0.77,0.733,0.691,24813,44.421741,113,350,0.916230366492147
"10495",214157,"Moravian College and Moravian Theological Seminary",1,0,2006,375,223,152,268,108,160,0.718,0.715,0.711,26300,46.438394,115,345,0.92
"10496",214157,"Moravian College and Moravian Theological Seminary",1,0,2007,401,214,187,282,130,152,0.71,0.703,0.695,27873,47.17719,112,346,0.86284289276808
"10497",214157,"Moravian College and Moravian Theological Seminary",1,0,2008,387,226,161,253,94,159,0.703,0.654,0.584,29547,48.294867,116,345,0.891472868217054
"10498",214157,"Moravian College and Moravian Theological Seminary",1,0,2009,379,223,156,248,97,151,0.677,0.654,0.622,30735,51.986275,115,300,0.79155672823219
"10499",214157,"Moravian College and Moravian Theological Seminary",1,0,2010,373,216,157,245,96,149,0.69,0.657,0.611,31662,50.798147,106,318,0.85254691689008
"10500",214175,"MUHLENBERG COLLEGE",1,0,1991,463,258,205,336,140,196,0.76,0.726,0.683,15115,34.371126,113,427,0.922246220302376
"10501",214175,"MUHLENBERG COLLEGE",1,0,1992,466,244,222,334,141,193,0.791,0.717,0.635,15740,37.560408,109,427,0.916309012875536
"10502",214175,"MUHLENBERG COLLEGE",1,0,1993,464,270,194,332,131,201,0.744,0.716,0.675,16385,39.146599,115,421,0.907327586206897
"10503",214175,"MUHLENBERG COLLEGE",1,0,1995,486,277,209,392,161,231,0.834,0.807,0.77,17550,43.865566,119,440,0.905349794238683
"10504",214175,"MUHLENBERG COLLEGE",1,0,1996,532,307,225,414,161,253,0.824,0.778,0.716,18100,46.843614,129,489,0.919172932330827
"10505",214175,"MUHLENBERG COLLEGE",1,0,1997,493,293,200,352,135,217,0.741,0.714,0.675,18660,37.560943,123,459,0.931034482758621
"10506",214175,"MUHLENBERG COLLEGE",1,0,1998,577,344,233,438,162,276,0.802,0.759,0.695,19300,39.326177,127,532,0.922010398613518
"10507",214175,"MUHLENBERG COLLEGE",1,0,1999,551,321,230,446,179,267,0.832,0.809,0.778,19910,40.619198,114,419,0.76043557168784
"10508",214175,"MUHLENBERG COLLEGE",1,0,2000,579,340,239,480,196,284,0.835,0.829,0.82,20865,43.5129,128,546,0.94300518134715
"10509",214175,"MUHLENBERG COLLEGE",1,0,2001,574,330,244,456,184,272,0.824,0.794,0.754,22015,46.420363,142,526,0.916376306620209
"10510",214175,"MUHLENBERG COLLEGE",1,0,2002,547,300,247,445,191,254,0.847,0.814,0.773,23250,51.393556,150,510,0.93235831809872
"10511",214175,"MUHLENBERG COLLEGE",1,0,2003,589,354,235,485,179,306,0.864,0.823,0.762,24730,58.209862,147,540,0.916808149405772
"10512",214175,"MUHLENBERG COLLEGE",1,0,2004,559,337,222,456,178,278,0.825,0.816,0.802,26570,58.13161,150,510,0.912343470483005
"10513",214175,"Muhlenberg College",1,0,2005,576,322,254,454,180,274,0.851,0.788,0.709,28550,63.959811,154,538,0.934027777777778
"10514",214175,"Muhlenberg College",1,0,2006,615,376,239,503,185,318,0.846,0.818,0.774,30490,67.307436,164,558,0.907317073170732
"10515",214175,"Muhlenberg College",1,0,2007,551,304,247,445,189,256,0.842,0.808,0.765,32850,70.655105,165,504,0.91470054446461
"10516",214175,"Muhlenberg College",1,0,2008,597,344,253,484,197,287,0.834,0.811,0.779,35125,75.626593,172,542,0.90787269681742
"10517",214175,"Muhlenberg College",1,0,2009,576,337,239,475,187,288,0.855,0.825,0.782,36730,76.921265,167,522,0.90625
"10518",214175,"Muhlenberg College",1,0,2010,603,341,262,485,199,286,0.839,0.804,0.76,38110,79.136147,171,504,0.835820895522388
"10519",214272,"NEUMANN COLLEGE",1,0,1991,84,58,26,30,5,25,0.431,0.357,0.192,8390,7.469778,41,79,0.94047619047619
"10520",214272,"NEUMANN COLLEGE",1,0,1992,63,47,16,29,8,21,0.447,0.46,0.5,9166,8.24009,47,59,0.936507936507937
"10521",214272,"NEUMANN COLLEGE",1,0,1993,84,64,20,33,7,26,0.406,0.393,0.35,10150,8.764541,44,82,0.976190476190476
"10522",214272,"NEUMANN COLLEGE",1,0,1995,159,114,45,15,5,10,0.088,0.094,0.111,11090,10.920075,47,147,0.924528301886792
"10523",214272,"NEUMANN COLLEGE",1,0,1996,114,82,32,41,11,30,0.366,0.36,0.344,12140,12.028817,49,104,0.912280701754386
"10524",214272,"NEUMANN COLLEGE",1,0,1997,187,126,61,59,15,44,0.349,0.316,0.246,12400,11.400333,50,121,0.647058823529412
"10525",214272,"NEUMANN COLLEGE",1,0,1998,314,206,108,131,42,89,0.432,0.417,0.389,13520,13.53263,50,244,0.777070063694268
"10526",214272,"NEUMANN COLLEGE",1,0,1999,324,179,145,108,38,70,0.391,0.333,0.262,13350,16.710296,52,267,0.824074074074074
"10527",214272,"NEUMANN COLLEGE",1,0,2000,299,164,135,87,34,53,0.323,0.291,0.252,13750,17.267767,53.5,241,0.806020066889632
"10528",214272,"NEUMANN COLLEGE",1,0,2001,345,217,128,115,25,90,0.415,0.333,0.195,14460,19.238588,55,265,0.768115942028985
"10529",214272,"NEUMANN COLLEGE",1,0,2002,363,228,135,114,25,89,0.39,0.314,0.185,15060,21.901107,67,286,0.787878787878788
"10530",214272,"NEUMANN COLLEGE",1,0,2003,510,327,183,209,72,137,0.419,0.41,0.393,15820,25.080338,72,402,0.788235294117647
"10531",214272,"NEUMANN COLLEGE",1,0,2004,462,304,158,135,41,94,0.309,0.292,0.259,16590,28.609407,78,322,0.696969696969697
"10532",214272,"Neumann College",1,0,2005,522,334,188,163,46,117,0.35,0.312,0.245,17300,31.551793,84,306,0.586206896551724
"10533",214272,"Neumann College",1,0,2006,544,325,219,160,46,114,0.351,0.294,0.21,17992,33.965564,85,345,0.634191176470588
"10534",214272,"Neumann College",1,0,2007,540,336,204,157,44,113,0.336,0.291,0.216,18846,36.420208,90,344,0.637037037037037
"10535",214272,"Neumann College",1,0,2008,539,348,191,185,51,134,0.385,0.343,0.267,19742,37.988114,89,340,0.630797773654917
"10536",214272,"Neumann University",1,0,2009,519,323,196,189,57,132,0.409,0.364,0.291,20290,40.284045,91,280,0.539499036608863
"10537",214272,"Neumann University",1,0,2010,547,350,197,166,48,118,0.337,0.303,0.244,21456,45.120682,93,261,0.477148080438757
"10538",214777,"PENNSYLVANIA STATE UNIVERSITY MAIN CAMPUS",1,0,1991,3615,1712,1903,2808,1417,1391,0.812,0.777,0.745,4402,722.21635,1778,3203,0.886030428769018
"10539",214777,"PENNSYLVANIA STATE UNIVERSITY MAIN CAMPUS",1,0,1992,4227,1995,2232,2529,1163,1366,0.685,0.598,0.521,4618,739.09937,1796,3636,0.860184528034067
"10540",214777,"PENNSYLVANIA STATE UNIVERSITY-MAIN CAMPUS",1,0,1993,4265,2107,2158,1846,741,1105,0.524,0.433,0.343,4822,755.887583,1799,3769,0.883704572098476
"10541",214777,"PENNSYLVANIA STATE UNIVERSITY-MAIN CAMPUS",1,0,1995,5400,2712,2688,2410,947,1463,0.54,0.446,0.352,5258,878.051085,1844,4656,0.862222222222222
"10542",214777,"PENNSYLVANIA STATE UNIVERSITY-MAIN CAMPUS",1,0,1996,4701,2344,2357,2052,837,1215,0.518,0.437,0.355,5624,923.50728,1836,3900,0.829610721123165
"10543",214777,"PENNSYLVANIA STATE UNIVERSITY-MAIN CAMPUS",1,0,1997,5185,2686,2499,2497,980,1517,0.565,0.482,0.392,5832,949.695076,1889,4384,0.845515911282546
"10544",214777,"PENNSYLVANIA STATE UNIVERSITY-MAIN CAMPUS",1,0,1998,5117,2590,2527,2448,959,1489,0.575,0.478,0.38,6092,950.616242,1934,4273,0.835059605237444
"10545",214777,"PENNSYLVANIA STATE UNIVERSITY-MAIN CAMPUS",1,0,1999,5058,2535,2523,2738,1142,1596,0.63,0.541,0.453,6162,1055.2684,1983,4247,0.839659944642151
"10546",214777,"PENNSYLVANIA STATE UNIVERSITY-MAIN CAMPUS",1,0,2000,5621,2866,2755,3127,1277,1850,0.645,0.556,0.464,6546,1158.471601,2034,4666,0.830101405443871
"10547",214777,"PENNSYLVANIA STATE UNIVERSITY-MAIN CAMPUS",1,0,2001,6146,2983,3163,3576,1586,1990,0.667,0.582,0.501,7054,1253.997874,2085,5088,0.827855515782623
"10548",214777,"PENNSYLVANIA STATE UNIVERSITY-MAIN CAMPUS",1,0,2002,5935,2911,3024,3558,1554,2004,0.688,0.599,0.514,8008,2286.828,2125,4883,0.822746419545072
"10549",214777,"PENNSYLVANIA STATE UNIVERSITY-MAIN CAMPUS",1,0,2003,6035,3058,2977,3747,1598,2149,0.703,0.621,0.537,8796,2423.788,2181,4990,0.826843413421707
"10550",214777,"PENNSYLVANIA STATE UNIVERSITY-MAIN CAMPUS",1,0,2004,5905,2884,3021,3681,1674,2007,0.696,0.623,0.554,10408,2611.892,2201,4962,0.84030482641829
"10551",214777,"Pennsylvania State University-Main Campus",1,0,2005,6499,2976,3523,4096,1969,2127,0.715,0.63,0.559,11024,2802.159,2260,5455,0.839359901523311
"10552",214777,"Pennsylvania State University-Penn State Main Campus",1,0,2006,8016,3790,4226,5243,2460,2783,0.734,0.654,0.582,11646,2969.259,2283,6792,0.847305389221557
"10553",214777,"Pennsylvania State University-Main Campus",1,0,2007,6492,3121,3371,4191,1943,2248,0.72,0.646,0.576,12284,3103.787,2329,5328,0.820702402957486
"10554",214777,"Pennsylvania State University-Main Campus",1,0,2008,7241,3428,3813,4746,2226,2520,0.735,0.655,0.584,13014,3373.296,2377,5833,0.805551719375777
"10555",214777,"Pennsylvania State University-Main Campus",1,0,2009,6574,3217,3357,4226,1910,2316,0.72,0.643,0.569,13604,3627.649,2419,4878,0.742013994523882
"10556",214777,"Pennsylvania State University-Main Campus",1,0,2010,7321,3542,3779,4942,2239,2703,0.763,0.675,0.592,14412,3881.115,2435,5484,0.749077994809452
"10557",215062,"UNIVERSITY OF PENNSYLVANIA",1,0,1991,2286,986,1300,1791,981,810,0.822,0.783,0.755,15644,1230.674,1003,1414,0.618547681539808
"10558",215062,"UNIVERSITY OF PENNSYLVANIA",1,0,1992,2259,977,1282,1789,972,817,0.836,0.792,0.758,16838,1381.305,997,1374,0.608233731739708
"10559",215062,"UNIVERSITY OF PENNSYLVANIA",1,0,1993,2434,1086,1348,1923,1008,915,0.843,0.79,0.748,17838,1501.315,993,1453,0.59695973705834
"10560",215062,"UNIVERSITY OF PENNSYLVANIA",1,0,1995,2349,1158,1191,1954,952,1002,0.865,0.832,0.799,19898,1803.529,989,1388,0.590889740315028
"10561",215062,"UNIVERSITY OF PENNSYLVANIA",1,0,1996,2307,1169,1138,1976,924,1052,0.9,0.857,0.812,21130,2247.785,949,1387,0.601213697442566
"10562",215062,"UNIVERSITY OF PENNSYLVANIA",1,0,1997,2324,1132,1192,1928,941,987,0.872,0.83,0.789,22250,2165.922,971,1369,0.589070567986231
"10563",215062,"UNIVERSITY OF PENNSYLVANIA",1,0,1998,2301,1128,1173,1975,969,1006,0.892,0.858,0.826,23254,2629.389,970,1198,0.5206431986093
"10564",215062,"UNIVERSITY OF PENNSYLVANIA",1,0,1999,2402,1155,1247,2079,1056,1023,0.886,0.866,0.847,21746,2959.95,979,1218,0.507077435470441
"10565",215062,"UNIVERSITY OF PENNSYLVANIA",1,0,2000,2270,1125,1145,1986,967,1019,0.906,0.875,0.845,22682,3009.889,994.5,1224,0.53920704845815
"10566",215062,"UNIVERSITY OF PENNSYLVANIA",1,0,2001,2316,1148,1168,2018,997,1021,0.889,0.871,0.854,23998,3113.914,1010,1163,0.502158894645941
"10567",215062,"UNIVERSITY OF PENNSYLVANIA",1,0,2002,2373,1183,1190,2096,1030,1066,0.901,0.883,0.866,25078,3310.93,1019,1201,0.506110408765276
"10568",215062,"UNIVERSITY OF PENNSYLVANIA",1,0,2003,2378,1221,1157,2082,992,1090,0.893,0.876,0.857,26282,3562.752,1031,1211,0.509251471825063
"10569",215062,"UNIVERSITY OF PENNSYLVANIA",1,0,2004,2359,1191,1168,2090,999,1091,0.916,0.886,0.855,27544,3716.145,1055,1090,0.46206019499788
"10570",215062,"University of Pennsylvania",1,0,2005,2479,1260,1219,2162,1033,1129,0.896,0.872,0.847,29030,3969.24,1051,1169,0.471561113352158
"10571",215062,"University of Pennsylvania",1,0,2006,2334,1193,1141,2036,952,1084,0.909,0.872,0.834,30598,4197.595,1065,1017,0.43573264781491
"10572",215062,"University of Pennsylvania",1,0,2007,2342,1107,1235,2058,1052,1006,0.909,0.879,0.852,32160,4423.621,1081,1050,0.448334756618275
"10573",215062,"University of Pennsylvania",1,0,2008,2392,1278,1114,2078,943,1135,0.888,0.869,0.846,33608,4730.825,1293,916,0.382943143812709
"10574",215062,"University of Pennsylvania",1,0,2009,2402,1232,1170,2091,976,1115,0.905,0.871,0.834,34868,5015.111,1297,870,0.362198168193172
"10575",215062,"University of Pennsylvania",1,0,2010,2363,1213,1150,1999,917,1082,0.892,0.846,0.797,36208,5263.101,1257,1158,0.49005501481168
"10576",215743,"SAINT FRANCIS COLLEGE",1,0,1991,279,144,135,97,38,59,0.41,0.348,0.281,9596,18.552249,57,265,0.949820788530466
"10577",215743,"SAINT FRANCIS COLLEGE",1,0,1992,297,145,152,121,58,63,0.435,0.407,0.382,10384,21.418054,62,287,0.966329966329966
"10578",215743,"SAINT FRANCIS COLLEGE",1,0,1993,285,136,149,115,49,66,0.485,0.404,0.329,10480,24.144336,66,266,0.933333333333333
"10579",215743,"SAINT FRANCIS COLLEGE",1,0,1995,334,145,189,135,61,74,0.51,0.404,0.323,11850,26.828385,74,320,0.958083832335329
"10580",215743,"SAINT FRANCIS COLLEGE",1,0,1996,346,205,141,95,24,71,0.346,0.275,0.17,12475,27.550852,74,311,0.898843930635838
"10581",215743,"SAINT FRANCIS COLLEGE",1,0,1997,354,200,154,79,22,57,0.285,0.223,0.143,13120,24.037755,76,314,0.887005649717514
"10582",215743,"SAINT FRANCIS COLLEGE",1,0,1998,335,182,153,90,47,43,0.236,0.269,0.307,13510,25.867437,78,298,0.88955223880597
"10583",215743,"SAINT FRANCIS COLLEGE",1,0,1999,333,215,118,147,34,113,0.526,0.441,0.288,14100,29.171375,81,285,0.855855855855856
"10584",215743,"SAINT FRANCIS COLLEGE",1,0,2000,355,210,145,159,58,101,0.481,0.448,0.4,15808,31.430208,83.5,263,0.740845070422535
"10585",215743,"SAINT FRANCIS UNIVERSITY",1,0,2001,342,187,155,163,60,103,0.551,0.477,0.387,16512,33.733029,86,272,0.795321637426901
"10586",215743,"SAINT FRANCIS UNIVERSITY",1,0,2002,281,154,127,122,47,75,0.487,0.434,0.37,17024,35.650547,90,224,0.797153024911032
"10587",215743,"SAINT FRANCIS UNIVERSITY",1,0,2003,332,200,132,174,63,111,0.555,0.524,0.477,18292,39.67118,90,279,0.840361445783133
"10588",215743,"SAINT FRANCIS UNIVERSITY",1,0,2004,321,198,123,175,48,127,0.641,0.545,0.39,19390,40.921724,87,271,0.844236760124611
"10589",215743,"Saint Francis University",1,0,2005,364,220,144,190,59,131,0.596,0.522,0.41,20360,40.439319,84,294,0.807692307692308
"10590",215743,"Saint Francis University",1,0,2006,384,234,150,194,66,128,0.547,0.505,0.44,21174,40.724612,97,304,0.791666666666667
"10591",215743,"Saint Francis University",1,0,2007,403,258,145,230,71,159,0.616,0.571,0.49,22444,44.062132,99,356,0.883374689826303
"10592",215743,"Saint Francis University",1,0,2008,412,224,188,254,99,155,0.692,0.617,0.527,23790,48.156241,102,363,0.881067961165049
"10593",215743,"Saint Francis University",1,0,2009,349,207,142,15,3,12,0.058,0.043,0.021,24504,52.097368,108,308,0.882521489971347
"10594",215743,"Saint Francis University",1,0,2010,429,258,171,243,82,161,0.624,0.566,0.48,25484,54.94286,113,353,0.822843822843823
"10595",215798,"SAINT VINCENT COLLEGE",1,0,1991,228,118,110,129,51,78,0.661,0.566,0.464,8760,16.949047,61,214,0.93859649122807
"10596",215798,"SAINT VINCENT COLLEGE",1,0,1992,267,152,115,148,50,98,0.645,0.554,0.435,9360,19.275711,59,260,0.973782771535581
"10597",215798,"SAINT VINCENT COLLEGE",1,0,1993,277,122,155,144,74,70,0.574,0.52,0.477,9900,20.48805,64,266,0.96028880866426
"10598",215798,"SAINT VINCENT COLLEGE",1,0,1995,260,129,131,161,72,89,0.69,0.619,0.55,11310,23.095907,60,247,0.95
"10599",215798,"SAINT VINCENT COLLEGE",1,0,1996,271,136,135,168,76,92,0.677,0.62,0.563,12100,26.031017,60,259,0.955719557195572
"10600",215798,"SAINT VINCENT COLLEGE",1,0,1997,272,129,143,159,77,82,0.636,0.585,0.538,13030,21.579042,59,264,0.970588235294118
"10601",215798,"SAINT VINCENT COLLEGE",1,0,1998,262,135,127,153,73,80,0.593,0.584,0.575,13780,22.87751,62,251,0.958015267175573
"10602",215798,"SAINT VINCENT COLLEGE",1,0,1999,272,138,134,162,74,88,0.638,0.596,0.552,14250,23.910802,65,251,0.922794117647059
"10603",215798,"SAINT VINCENT COLLEGE",1,0,2000,302,141,161,192,99,93,0.66,0.636,0.615,15531,25.099689,63,281,0.93046357615894
"10604",215798,"SAINT VINCENT COLLEGE",1,0,2001,262,128,134,161,69,92,0.719,0.615,0.515,16585,26.608151,61,241,0.919847328244275
"10605",215798,"SAINT VINCENT COLLEGE",1,0,2002,322,159,163,209,102,107,0.673,0.649,0.626,18080,27.310393,67,296,0.919254658385093
"10606",215798,"SAINT VINCENT COLLEGE",1,0,2003,362,196,166,221,91,130,0.663,0.61,0.548,19000,30.906395,72,345,0.953038674033149
"10607",215798,"SAINT VINCENT COLLEGE",1,0,2004,331,186,145,226,93,133,0.715,0.683,0.641,20312,37.549667,76,282,0.851963746223565
"10608",215798,"Saint Vincent College",1,0,2005,481,254,227,308,141,167,0.657,0.64,0.621,21104,35.193908,84,430,0.893970893970894
"10609",215798,"Saint Vincent College",1,0,2006,437,217,220,272,133,139,0.641,0.622,0.605,22350,38.779591,86,401,0.917620137299771
"10610",215798,"Saint Vincent College",1,0,2007,423,200,223,269,130,139,0.695,0.636,0.583,23459,42.204082,92,389,0.919621749408983
"10611",215798,"Saint Vincent College",1,0,2008,442,195,247,302,167,135,0.692,0.683,0.676,24620,45.967819,99,386,0.873303167420814
"10612",215798,"Saint Vincent College",1,0,2009,446,197,249,267,125,142,0.721,0.599,0.502,25350,48.147979,104,388,0.869955156950673
"10613",215798,"Saint Vincent College",1,0,2010,422,202,220,261,113,148,0.733,0.618,0.514,26350,48.865509,101,372,0.881516587677725
"10614",215929,"UNIVERSITY OF SCRANTON",1,0,1991,897,457,440,646,294,352,0.77,0.72,0.668,9530,60.182045,241,840,0.936454849498328
"10615",215929,"UNIVERSITY OF SCRANTON",1,0,1992,898,495,403,605,262,343,0.693,0.674,0.65,9920,72.641744,241,814,0.906458797327394
"10616",215929,"UNIVERSITY OF SCRANTON",1,0,1993,899,496,403,582,239,343,0.692,0.647,0.593,10820,70.234313,242,812,0.903225806451613
"10617",215929,"UNIVERSITY OF SCRANTON",1,0,1995,907,515,392,590,261,329,0.639,0.65,0.666,12570,81.591828,244,830,0.915104740904079
"10618",215929,"UNIVERSITY OF SCRANTON",1,0,1996,948,550,398,623,254,369,0.671,0.657,0.638,15000,85.780481,244,869,0.916666666666667
"10619",215929,"UNIVERSITY OF SCRANTON",1,0,1997,905,538,367,644,247,397,0.738,0.712,0.673,15880,73.285108,244,820,0.906077348066298
"10620",215929,"UNIVERSITY OF SCRANTON",1,0,1998,873,527,346,607,217,390,0.74,0.695,0.627,16820,76.170671,246,804,0.920962199312715
"10621",215929,"UNIVERSITY OF SCRANTON",1,0,1999,958,550,408,675,268,407,0.74,0.705,0.657,17540,79.23623,243,876,0.914405010438413
"10622",215929,"UNIVERSITY OF SCRANTON",1,0,2000,833,472,361,625,259,366,0.775,0.75,0.717,18460,84.609262,243.5,717,0.860744297719088
"10623",215929,"UNIVERSITY OF SCRANTON",1,0,2001,1013,578,435,674,258,416,0.72,0.665,0.593,19330,87.714563,244,853,0.842053307008884
"10624",215929,"UNIVERSITY OF SCRANTON",1,0,2002,958,569,389,702,258,444,0.78,0.733,0.663,20248,90.966793,243,795,0.829853862212944
"10625",215929,"UNIVERSITY OF SCRANTON",1,0,2003,974,538,436,716,307,409,0.76,0.735,0.704,21208,92.959015,247,832,0.854209445585216
"10626",215929,"UNIVERSITY OF SCRANTON",1,0,2004,965,559,406,658,248,410,0.733,0.682,0.611,22214,95.670609,242,769,0.796891191709845
"10627",215929,"University of Scranton",1,0,2005,943,551,392,629,248,381,0.692,0.667,0.633,23750,99.715169,245,768,0.814422057264051
"10628",215929,"University of Scranton",1,0,2006,980,585,395,740,289,451,0.771,0.755,0.732,25638,101.901873,244,802,0.818367346938776
"10629",215929,"University of Scranton",1,0,2007,1025,574,451,771,307,464,0.808,0.752,0.681,28458,113.097865,253,822,0.801951219512195
"10630",215929,"University of Scranton",1,0,2008,961,555,406,710,274,436,0.786,0.739,0.675,31276,115.449791,253,828,0.861602497398543
"10631",215929,"University of Scranton",1,0,2009,1027,578,449,747,296,451,0.78,0.727,0.659,32824,124.154565,263,852,0.829600778967868
"10632",215929,"University of Scranton",1,0,2010,950,508,442,688,291,397,0.782,0.724,0.658,34236,128.111906,271,745,0.784210526315789
"10633",216010,"SHIPPENSBURG UNIVERSITY OF PENNSYLVANIA",1,0,1991,1163,631,532,474,153,321,0.509,0.408,0.288,3108,53.135533,298,1070,0.920034393809114
"10634",216010,"SHIPPENSBURG UNIVERSITY OF PENNSYLVANIA",1,0,1992,1238,675,563,441,156,285,0.422,0.356,0.277,3388,60.419789,288,1173,0.947495961227787
"10635",216010,"SHIPPENSBURG UNIVERSITY OF PENNSYLVANIA",1,0,1993,1114,603,511,443,162,281,0.466,0.398,0.317,3710,64.89107,292,1039,0.932675044883303
"10636",216010,"SHIPPENSBURG UNIVERSITY OF PENNSYLVANIA",1,0,1995,1278,665,613,497,188,309,0.465,0.389,0.307,4010,74.360696,299,1182,0.924882629107981
"10637",216010,"SHIPPENSBURG UNIVERSITY OF PENNSYLVANIA",1,0,1996,1272,674,598,455,168,287,0.426,0.358,0.281,4230,76.119379,294,1168,0.918238993710692
"10638",216010,"SHIPPENSBURG UNIVERSITY OF PENNSYLVANIA",1,0,1997,1292,741,551,476,178,298,0.402,0.368,0.323,4344,77.075813,296,1193,0.923374613003096
"10639",216010,"SHIPPENSBURG UNIVERSITY OF PENNSYLVANIA",1,0,1998,1211,654,557,480,181,299,0.457,0.396,0.325,4346,79.181426,288,1095,0.904211395540875
"10640",216010,"SHIPPENSBURG UNIVERSITY OF PENNSYLVANIA",1,0,1999,1377,734,643,574,231,343,0.467,0.417,0.359,3618,84.324982,295,1291,0.937545388525781
"10641",216010,"SHIPPENSBURG UNIVERSITY OF PENNSYLVANIA",1,0,2000,1520,831,689,679,233,446,0.537,0.447,0.338,3792,89.97313,296,1421,0.934868421052632
"10642",216010,"SHIPPENSBURG UNIVERSITY OF PENNSYLVANIA",1,0,2001,1478,805,673,683,239,444,0.552,0.462,0.355,4016,96.953861,297,1353,0.915426251691475
"10643",216010,"SHIPPENSBURG UNIVERSITY OF PENNSYLVANIA",1,0,2002,1507,831,676,721,270,451,0.543,0.478,0.399,4378,91.407073,307,1336,0.886529528865295
"10644",216010,"SHIPPENSBURG UNIVERSITY OF PENNSYLVANIA",1,0,2003,1485,742,743,666,271,395,0.532,0.448,0.365,4598,96.901779,307,1292,0.87003367003367
"10645",216010,"SHIPPENSBURG UNIVERSITY OF PENNSYLVANIA",1,0,2004,1458,748,710,629,251,378,0.505,0.431,0.354,4810,99.540732,333,1241,0.85116598079561
"10646",216010,"Shippensburg University of Pennsylvania",1,0,2005,1495,775,720,622,233,389,0.502,0.416,0.324,4906,102.37051,305,1261,0.843478260869565
"10647",216010,"Shippensburg University of Pennsylvania",1,0,2006,1496,778,718,601,215,386,0.496,0.402,0.299,5038,106.145348,321,1252,0.836898395721925
"10648",216010,"Shippensburg University of Pennsylvania",1,0,2007,1720,927,793,639,251,388,0.419,0.372,0.317,5178,112.288253,316,1412,0.82093023255814
"10649",216010,"Shippensburg University of Pennsylvania",1,0,2008,1716,871,845,638,247,391,0.449,0.372,0.292,5358,117.172362,319,1388,0.808857808857809
"10650",216010,"Shippensburg University of Pennsylvania",1,0,2009,1673,873,800,669,273,396,0.454,0.4,0.341,5554,121.921591,320,1370,0.818888224745965
"10651",216010,"Shippensburg University of Pennsylvania",1,0,2010,1706,888,818,693,275,418,0.471,0.406,0.336,5804,126.398882,328,1466,0.859320046893318
"10652",216038,"SLIPPERY ROCK UNIVERSITY OF PENNSYLVANIA",1,0,1991,1191,690,501,232,76,156,0.226,0.195,0.152,3045,66.048384,367,1100,0.923593618807725
"10653",216038,"SLIPPERY ROCK UNIVERSITY OF PENNSYLVANIA",1,0,1992,1164,658,506,242,95,147,0.223,0.208,0.188,3287,73.297245,380,1060,0.910652920962199
"10654",216038,"SLIPPERY ROCK UNIVERSITY OF PENNSYLVANIA",1,0,1993,1239,739,500,247,77,170,0.23,0.199,0.154,3547,75.057293,380,1110,0.895883777239709
"10655",216038,"SLIPPERY ROCK UNIVERSITY OF PENNSYLVANIA",1,0,1995,1279,715,564,254,82,172,0.241,0.199,0.145,4013,82.425817,379,1174,0.91790461297889
"10656",216038,"SLIPPERY ROCK UNIVERSITY OF PENNSYLVANIA",1,0,1996,1197,677,520,247,85,162,0.239,0.206,0.163,4179,85.001917,371,1079,0.901420217209691
"10657",216038,"SLIPPERY ROCK UNIVERSITY OF PENNSYLVANIA",1,0,1997,1193,684,509,248,76,172,0.252,0.208,0.149,4302,82.087382,371,1118,0.937133277451802
"10658",216038,"SLIPPERY ROCK UNIVERSITY OF PENNSYLVANIA",1,0,1998,1260,713,547,297,95,202,0.283,0.236,0.174,4311,84.223454,362,1189,0.943650793650794
"10659",216038,"SLIPPERY ROCK UNIVERSITY OF PENNSYLVANIA",1,0,1999,1302,742,560,334,103,231,0.311,0.257,0.184,3618,88.61933,349,1206,0.926267281105991
"10660",216038,"SLIPPERY ROCK UNIVERSITY OF PENNSYLVANIA",1,0,2000,1346,794,552,372,105,267,0.336,0.276,0.19,3792,90.731302,353.5,1229,0.913075780089153
"10661",216038,"SLIPPERY ROCK UNIVERSITY OF PENNSYLVANIA",1,0,2001,1314,751,563,378,117,261,0.348,0.288,0.208,4016,97.426983,358,1200,0.91324200913242
"10662",216038,"SLIPPERY ROCK UNIVERSITY OF PENNSYLVANIA",1,0,2002,1421,796,625,416,139,277,0.348,0.293,0.222,4378,92.95107,335,1273,0.895847994370162
"10663",216038,"SLIPPERY ROCK UNIVERSITY OF PENNSYLVANIA",1,0,2003,1465,803,662,455,158,297,0.37,0.311,0.239,4598,102.479231,342,1311,0.894880546075085
"10664",216038,"SLIPPERY ROCK UNIVERSITY OF PENNSYLVANIA",1,0,2004,1530,890,640,551,196,355,0.399,0.36,0.306,4810,107.944947,340,1383,0.903921568627451
"10665",216038,"Slippery Rock University of Pennsylvania",1,0,2005,1457,800,657,556,216,340,0.425,0.382,0.329,4906,106.886506,340,1315,0.902539464653397
"10666",216038,"Slippery Rock University of Pennsylvania",1,0,2006,1416,832,584,545,185,360,0.433,0.385,0.317,5038,108.752222,333,1228,0.867231638418079
"10667",216038,"Slippery Rock University of Pennsylvania",1,0,2007,1498,876,622,596,185,411,0.469,0.398,0.297,5178,119.727887,340,1272,0.84913217623498
"10668",216038,"Slippery Rock University of Pennsylvania",1,0,2008,1527,887,640,749,272,477,0.538,0.491,0.425,5358,124.462231,343,1262,0.826457105435494
"10669",216038,"Slippery Rock University of Pennsylvania",1,0,2009,1534,915,619,795,258,537,0.587,0.518,0.417,5554,133.283479,352,1312,0.855280312907432
"10670",216038,"Slippery Rock University of Pennsylvania",1,0,2010,1562,969,593,808,265,543,0.56,0.517,0.447,5804,134.973824,354,1378,0.882202304737516
"10671",216287,"SWARTHMORE COLLEGE",1,0,1991,319,148,171,266,138,128,0.865,0.834,0.807,16640,53.413154,155,247,0.774294670846395
"10672",216287,"SWARTHMORE COLLEGE",1,0,1992,353,172,181,285,143,142,0.826,0.807,0.79,17646,62.067407,154,255,0.722379603399433
"10673",216287,"SWARTHMORE COLLEGE",1,0,1993,413,226,187,348,149,199,0.88,0.843,0.797,18482,57.840585,162,289,0.699757869249395
"10674",216287,"SWARTHMORE COLLEGE",1,0,1995,354,190,164,308,134,174,0.916,0.87,0.817,20186,66.457262,161,266,0.751412429378531
"10675",216287,"SWARTHMORE COLLEGE",1,0,1996,412,217,195,354,167,187,0.862,0.859,0.856,21054,70.672,157,243,0.589805825242718
"10676",216287,"SWARTHMORE COLLEGE",1,0,1997,373,193,180,309,136,173,0.896,0.828,0.756,22000,64.948,167,232,0.621983914209115
"10677",216287,"SWARTHMORE COLLEGE",1,0,1998,361,193,168,297,132,165,0.855,0.823,0.786,23240,69.808,173,210,0.581717451523546
"10678",216287,"SWARTHMORE COLLEGE",1,0,1999,368,192,176,315,142,173,0.901,0.856,0.807,23964,73.137,174,222,0.603260869565217
"10679",216287,"SWARTHMORE COLLEGE",1,0,2000,366,195,171,316,141,175,0.897,0.863,0.825,24950,80.011,170.5,227,0.620218579234973
"10680",216287,"SWARTHMORE COLLEGE",1,0,2001,380,193,187,346,165,181,0.938,0.911,0.882,26098,87.885,167,218,0.573684210526316
"10681",216287,"SWARTHMORE COLLEGE",1,0,2002,371,189,182,326,155,171,0.905,0.879,0.852,27272,91.373,173,197,0.53099730458221
"10682",216287,"SWARTHMORE COLLEGE",1,0,2003,368,198,170,316,141,175,0.884,0.859,0.829,28500,97.794,195,173,0.470108695652174
"10683",216287,"SWARTHMORE COLLEGE",1,0,2004,365,189,176,324,153,171,0.905,0.888,0.869,29782,99.861,192,151,0.413698630136986
"10684",216287,"Swarthmore College",1,0,2005,389,198,191,355,171,184,0.929,0.913,0.895,31196,100.219,194,170,0.437017994858612
"10685",216287,"Swarthmore College",1,0,2006,370,193,177,318,143,175,0.907,0.859,0.808,32912,106.41,192,166,0.448648648648649
"10686",216287,"Swarthmore College",1,0,2007,365,190,175,324,152,172,0.905,0.888,0.869,34564,114.661,202,162,0.443835616438356
"10687",216287,"Swarthmore College",1,0,2008,372,184,188,330,159,171,0.929,0.887,0.846,36154,118.204,193,163,0.438172043010753
"10688",216287,"Swarthmore College",1,0,2009,394,204,190,343,159,184,0.902,0.871,0.837,37510,121.884,197,165,0.418781725888325
"10689",216287,"Swarthmore College",1,0,2010,387,195,192,339,169,170,0.872,0.876,0.88,39260,118.902,189,183,0.472868217054264
"10690",216339,"TEMPLE UNIVERSITY",1,0,1991,2084,1071,1013,287,115,172,0.161,0.138,0.114,4756,634.387943,1130,1252,0.600767754318618
"10691",216339,"TEMPLE UNIVERSITY",1,0,1992,2029,1068,961,337,124,213,0.199,0.166,0.129,5008,702.863,1156,1130,0.556924593395762
"10692",216339,"TEMPLE UNIVERSITY",1,0,1993,2186,1209,977,355,141,214,0.177,0.162,0.144,5226,755.045,1147,1263,0.577767612076853
"10693",216339,"TEMPLE UNIVERSITY",1,0,1995,2302,1366,936,440,143,297,0.217,0.191,0.153,5514,889.436,1119,1090,0.473501303214596
"10694",216339,"TEMPLE UNIVERSITY",1,0,1996,2155,1284,871,442,138,304,0.237,0.205,0.158,5828,1002.468,1119,1001,0.464501160092807
"10695",216339,"TEMPLE UNIVERSITY",1,0,1997,2149,1233,916,503,176,327,0.265,0.234,0.192,6150,1023.207,1090,1016,0.472778036295952
"10696",216339,"TEMPLE UNIVERSITY",1,0,1998,2150,1279,871,521,171,350,0.274,0.242,0.196,6378,1152.533,1071,1077,0.50093023255814
"10697",216339,"TEMPLE UNIVERSITY",1,0,1999,2747,1628,1119,721,228,493,0.303,0.262,0.204,6332,1284.62,1066,1396,0.508190753549327
"10698",216339,"TEMPLE UNIVERSITY",1,0,2000,3031,1767,1264,857,318,539,0.305,0.283,0.252,6648,1430.454,1114,1536,0.506763444407786
"10699",216339,"TEMPLE UNIVERSITY",1,0,2001,3157,1826,1331,919,319,600,0.329,0.291,0.24,6974,1429.655,1162,1694,0.536585365853659
"10700",216339,"TEMPLE UNIVERSITY",1,0,2002,3467,2034,1433,1170,394,776,0.382,0.337,0.275,7602,1569.486,1196,2075,0.598500144216902
"10701",216339,"TEMPLE UNIVERSITY",1,0,2003,3590,2106,1484,1232,459,773,0.367,0.343,0.309,8134,1517.236,1220,2203,0.613649025069638
"10702",216339,"TEMPLE UNIVERSITY",1,0,2004,3788,2184,1604,1216,468,748,0.342,0.321,0.292,8622,1645.339,1207,2290,0.60454065469905
"10703",216339,"Temple University",1,0,2005,3841,2175,1666,1247,483,764,0.351,0.325,0.29,9140,1735.249,1225,2295,0.597500650872169
"10704",216339,"Temple University",1,0,2006,3848,2105,1743,1377,578,799,0.38,0.358,0.332,9680,1805.842,1245,2224,0.577962577962578
"10705",216339,"Temple University",1,0,2007,4385,2478,1907,1705,684,1021,0.412,0.389,0.359,10252,1804.521,1303,2607,0.594526795895097
"10706",216339,"Temple University",1,0,2008,4157,2260,1897,1718,663,1055,0.467,0.413,0.349,10858,1984.796,1383,2511,0.604041375992302
"10707",216339,"Temple University",1,0,2009,4183,2320,1863,1808,687,1121,0.483,0.432,0.369,11174,2072.166,1427,2575,0.61558689935453
"10708",216339,"Temple University",1,0,2010,4305,2273,2032,1920,783,1137,0.5,0.446,0.385,11834,2069.216,1462,2770,0.643437862950058
"10709",216524,"URSINUS COLLEGE",1,0,1991,234,124,110,155,69,86,0.694,0.662,0.627,12555,24.136108,89,205,0.876068376068376
"10710",216524,"URSINUS COLLEGE",1,0,1992,403,199,204,285,131,154,0.774,0.707,0.642,13330,24.709435,87,363,0.900744416873449
"10711",216524,"URSINUS COLLEGE",1,0,1993,308,159,149,226,108,118,0.742,0.734,0.725,14265,28.911973,92,281,0.912337662337662
"10712",216524,"URSINUS COLLEGE",1,0,1995,315,170,145,230,106,124,0.729,0.73,0.731,15840,31.519613,85,270,0.857142857142857
"10713",216524,"URSINUS COLLEGE",1,0,1996,327,180,147,244,105,139,0.772,0.746,0.714,16600,34.450349,84,281,0.859327217125382
"10714",216524,"URSINUS COLLEGE",1,0,1997,314,162,152,236,117,119,0.735,0.752,0.77,17380,26.800167,87,260,0.828025477707006
"10715",216524,"URSINUS COLLEGE",1,0,1998,336,189,147,249,93,156,0.825,0.741,0.633,18520,27.503463,86,280,0.833333333333333
"10716",216524,"URSINUS COLLEGE",1,0,1999,337,173,164,241,106,135,0.78,0.715,0.646,19950,29.20252,92,271,0.804154302670623
"10717",216524,"URSINUS COLLEGE",1,0,2000,376,214,162,287,112,175,0.818,0.763,0.691,21050,31.53743,94,313,0.832446808510638
"10718",216524,"URSINUS COLLEGE",1,0,2001,387,230,157,278,114,164,0.713,0.718,0.726,24850,34.190312,96,314,0.811369509043928
"10719",216524,"URSINUS COLLEGE",1,0,2002,427,212,215,301,134,167,0.788,0.705,0.623,26200,36.634605,102,348,0.814988290398126
"10720",216524,"URSINUS COLLEGE",1,0,2003,453,233,220,356,163,193,0.828,0.786,0.741,27500,38.171257,110,338,0.746136865342163
"10721",216524,"URSINUS COLLEGE",1,0,2004,393,200,193,303,142,161,0.805,0.771,0.736,29650,41.136641,114,305,0.776081424936387
"10722",216524,"Ursinus College",1,0,2005,411,222,189,309,136,173,0.779,0.752,0.72,31450,45.448528,115,294,0.715328467153285
"10723",216524,"Ursinus College",1,0,2006,405,217,188,287,126,161,0.742,0.709,0.67,33200,49.844008,120,300,0.740740740740741
"10724",216524,"Ursinus College",1,0,2007,468,242,226,353,159,194,0.802,0.754,0.704,35000,49.947246,120,354,0.756410256410256
"10725",216524,"Ursinus College",1,0,2008,543,304,239,428,181,247,0.812,0.788,0.757,36750,52.65444,122,376,0.692449355432781
"10726",216524,"Ursinus College",1,0,2009,509,260,249,379,178,201,0.773,0.745,0.715,38500,56.217555,125,406,0.797642436149312
"10727",216524,"Ursinus College",1,0,2010,441,236,205,323,144,179,0.758,0.732,0.702,39950,59.064241,127,332,0.752834467120181
"10728",216694,"WAYNESBURG COLLEGE",1,0,1991,317,185,132,112,33,79,0.427,0.353,0.25,7690,13.73906,64,294,0.927444794952681
"10729",216694,"WAYNESBURG COLLEGE",1,0,1992,346,178,168,158,65,93,0.522,0.457,0.387,8120,15.78179,67,333,0.96242774566474
"10730",216694,"WAYNESBURG COLLEGE",1,0,1993,325,180,145,132,51,81,0.45,0.406,0.352,8580,16.988336,67,293,0.901538461538462
"10731",216694,"WAYNESBURG COLLEGE",1,0,1995,295,141,154,109,46,63,0.447,0.369,0.299,9600,19.135073,65,275,0.932203389830508
"10732",216694,"WAYNESBURG COLLEGE",1,0,1996,305,134,171,138,59,79,0.59,0.452,0.345,10040,19.64793,58,287,0.940983606557377
"10733",216694,"WAYNESBURG COLLEGE",1,0,1997,309,123,186,132,72,60,0.488,0.427,0.387,10550,18.393652,53,281,0.909385113268608
"10734",216694,"WAYNESBURG COLLEGE",1,0,1998,290,113,177,116,60,56,0.496,0.4,0.339,10970,15.0777,55,258,0.889655172413793
"10735",216694,"WAYNESBURG COLLEGE",1,0,1999,277,126,151,121,64,57,0.452,0.437,0.424,11160,16.0228,55,251,0.906137184115523
"10736",216694,"WAYNESBURG COLLEGE",1,0,2000,328,160,168,146,57,89,0.556,0.445,0.339,11670,22.511487,57,314,0.957317073170732
"10737",216694,"WAYNESBURG COLLEGE",1,0,2001,315,159,156,141,56,85,0.535,0.448,0.359,12250,26.092385,59,292,0.926984126984127
"10738",216694,"WAYNESBURG COLLEGE",1,0,2002,297,141,156,142,50,92,0.652,0.478,0.321,12870,26.904427,62,274,0.922558922558923
"10739",216694,"WAYNESBURG COLLEGE",1,0,2003,327,157,170,157,70,87,0.554,0.48,0.412,13520,25.131989,61,308,0.941896024464832
"10740",216694,"WAYNESBURG COLLEGE",1,0,2004,367,189,178,175,70,105,0.556,0.477,0.393,14200,25.324906,63,330,0.899182561307902
"10741",216694,"Waynesburg College",1,0,2005,340,208,132,171,58,113,0.543,0.503,0.439,14810,28.719771,62,294,0.864705882352941
"10742",216694,"Waynesburg College",1,0,2006,322,172,150,174,69,105,0.61,0.54,0.46,15440,31.686875,63,287,0.891304347826087
"10743",216694,"Waynesburg University",1,0,2007,402,232,170,182,67,115,0.496,0.453,0.394,16080,29.161731,65,374,0.930348258706468
"10744",216694,"Waynesburg University",1,0,2008,376,218,158,195,76,119,0.546,0.519,0.481,16730,34.150351,67,351,0.933510638297872
"10745",216694,"Waynesburg University",1,0,2009,380,221,159,211,77,134,0.606,0.555,0.484,17400,35.857288,72,353,0.928947368421053
"10746",216694,"Waynesburg University",1,0,2010,401,229,172,213,77,136,0.594,0.531,0.448,18050,37.628709,76,371,0.925187032418953
"10747",216764,"WEST CHESTER UNIVERSITY OF PENNSYLVANIA",1,0,1991,1467,960,507,337,79,258,0.269,0.23,0.156,2918,88.423919,491,1275,0.869120654396728
"10748",216764,"WEST CHESTER UNIVERSITY OF PENNSYLVANIA",1,0,1992,1378,883,495,357,90,267,0.302,0.259,0.182,3158,93.833781,495,1209,0.877358490566038
"10749",216764,"WEST CHESTER UNIVERSITY OF PENNSYLVANIA",1,0,1993,1386,876,510,346,74,272,0.31,0.25,0.145,3504,93.637,483,1170,0.844155844155844
"10750",216764,"WEST CHESTER UNIVERSITY OF PENNSYLVANIA",1,0,1995,1384,873,511,363,85,278,0.318,0.262,0.166,3874,104.995468,478,1180,0.852601156069364
"10751",216764,"WEST CHESTER UNIVERSITY OF PENNSYLVANIA",1,0,1996,1454,943,511,376,88,288,0.305,0.259,0.172,4032,110.806218,464,1223,0.841127922971114
"10752",216764,"WEST CHESTER UNIVERSITY OF PENNSYLVANIA",1,0,1997,1581,1025,556,409,93,316,0.308,0.259,0.167,4162,114.139198,463,1374,0.869070208728653
"10753",216764,"WEST CHESTER UNIVERSITY OF PENNSYLVANIA",1,0,1998,1629,1031,598,474,124,350,0.34,0.291,0.207,4248,121.217493,468,1418,0.870472682627379
"10754",216764,"WEST CHESTER UNIVERSITY OF PENNSYLVANIA",1,0,1999,1710,1069,641,444,122,322,0.301,0.26,0.19,3618,126.574879,453,1513,0.884795321637427
"10755",216764,"WEST CHESTER UNIVERSITY OF PENNSYLVANIA",1,0,2000,1715,1085,630,536,127,409,0.377,0.313,0.202,3792,136.747116,467.5,1506,0.878134110787172
"10756",216764,"WEST CHESTER UNIVERSITY OF PENNSYLVANIA",1,0,2001,1626,1020,606,561,144,417,0.409,0.345,0.238,4016,147.862401,482,1390,0.854858548585486
"10757",216764,"WEST CHESTER UNIVERSITY OF PENNSYLVANIA",1,0,2002,1766,1104,662,642,168,474,0.429,0.364,0.254,4378,141.145952,537,1535,0.869195922989808
"10758",216764,"WEST CHESTER UNIVERSITY OF PENNSYLVANIA",1,0,2003,1723,1119,604,685,152,533,0.476,0.398,0.252,4598,149.15784,504,1441,0.83633197910621
"10759",216764,"WEST CHESTER UNIVERSITY OF PENNSYLVANIA",1,0,2004,1870,1214,656,734,177,557,0.459,0.393,0.27,4810,150.85294,512,1607,0.859358288770053
"10760",216764,"West Chester University of Pennsylvania",1,0,2005,1898,1219,679,812,216,596,0.489,0.428,0.318,4906,160.524294,527,1616,0.851422550052687
"10761",216764,"West Chester University of Pennsylvania",1,0,2006,1883,1200,683,803,196,607,0.506,0.426,0.287,5038,165.908418,520,1597,0.848114710568242
"10762",216764,"West Chester University of Pennsylvania",1,0,2007,1955,1215,740,857,235,622,0.512,0.438,0.318,5177,176.98703,545,1655,0.846547314578005
"10763",216764,"West Chester University of Pennsylvania",1,0,2008,1992,1231,761,872,232,640,0.52,0.438,0.305,5358,190.342386,568,1644,0.825301204819277
"10764",216764,"West Chester University of Pennsylvania",1,0,2009,2241,1353,888,954,277,677,0.5,0.426,0.312,5554,196.108592,516,1908,0.85140562248996
"10765",216764,"West Chester University of Pennsylvania",1,0,2010,2060,1295,765,946,263,683,0.527,0.459,0.344,5804,204.87654,540,1643,0.797572815533981
"10766",216807,"WESTMINSTER COLLEGE",1,0,1991,319,175,144,223,99,124,0.709,0.699,0.688,10580,23.592705,92,312,0.978056426332288
"10767",216807,"WESTMINSTER COLLEGE",1,0,1992,362,213,149,227,89,138,0.648,0.627,0.597,11210,25.136586,91,350,0.966850828729282
"10768",216807,"WESTMINSTER COLLEGE",1,0,1993,375,216,159,250,93,157,0.727,0.667,0.585,11770,25.573738,93,362,0.965333333333333
"10769",216807,"WESTMINSTER COLLEGE",1,0,1995,376,230,146,250,86,164,0.713,0.665,0.589,13950,29.570364,100,364,0.968085106382979
"10770",216807,"WESTMINSTER COLLEGE",1,0,1996,304,176,128,208,78,130,0.739,0.684,0.609,14535,30.470646,98,293,0.963815789473684
"10771",216807,"WESTMINSTER COLLEGE",1,0,1997,394,239,155,259,93,166,0.695,0.657,0.6,14650,23.961079,97,383,0.972081218274112
"10772",216807,"WESTMINSTER COLLEGE",1,0,1998,372,236,136,252,79,173,0.733,0.677,0.581,15510,24.075566,96,365,0.981182795698925
"10773",216807,"WESTMINSTER COLLEGE",1,0,1999,351,224,127,228,69,159,0.71,0.65,0.543,15485,23.521949,95,347,0.988603988603989
"10774",216807,"WESTMINSTER COLLEGE",1,0,2000,340,199,141,230,87,143,0.719,0.676,0.617,16180,24.955393,99,285,0.838235294117647
"10775",216807,"WESTMINSTER COLLEGE",1,0,2001,375,219,156,224,76,148,0.676,0.597,0.487,16920,26.915112,103,286,0.762666666666667
"10776",216807,"WESTMINSTER COLLEGE",1,0,2002,350,235,115,208,56,152,0.647,0.594,0.487,18100,28.61816,101,272,0.777142857142857
"10777",216807,"WESTMINSTER COLLEGE",1,0,2003,337,206,131,200,61,139,0.675,0.593,0.466,19370,29.09829,100,242,0.718100890207715
"10778",216807,"WESTMINSTER COLLEGE",1,0,2004,378,235,143,225,72,153,0.651,0.595,0.503,20530,31.027498,100,269,0.711640211640212
"10779",216807,"Westminster College",1,0,2005,360,231,129,223,75,148,0.641,0.619,0.581,21700,33.010016,103,301,0.836111111111111
"10780",216807,"Westminster College",1,0,2006,311,180,131,225,87,138,0.767,0.723,0.664,23220,33.954005,105,265,0.852090032154341
"10781",216807,"Westminster College",1,0,2007,311,179,132,195,76,119,0.665,0.627,0.576,24430,34.185046,104,258,0.829581993569132
"10782",216807,"Westminster College",1,0,2008,441,246,195,313,128,185,0.752,0.71,0.656,25900,35.840087,101,381,0.863945578231292
"10783",216807,"Westminster College",1,0,2009,451,277,174,313,117,196,0.708,0.694,0.672,26940,36.468606,110,377,0.835920177383592
"10784",216807,"Westminster College",1,0,2010,402,248,154,274,99,175,0.706,0.682,0.643,28020,37.124562,109,341,0.848258706467662
"10785",216852,"WIDENER UNIVERSITY PENNSYLVANIA CAMPUS",1,0,1991,464,206,258,172,81,91,0.442,0.371,0.314,10500,76.026133,250,390,0.84051724137931
"10786",216852,"WIDENER UNIVERSITY PENNSYLVANIA CAMPUS",1,0,1992,436,169,267,140,66,74,0.438,0.321,0.247,11120,79.529468,211,369,0.846330275229358
"10787",216852,"WIDENER UNIVERSITY-MAIN CAMPUS",1,0,1993,473,215,258,182,79,103,0.479,0.385,0.306,11740,84.200944,216,375,0.792811839323467
"10788",216852,"WIDENER UNIVERSITY-MAIN CAMPUS",1,0,1995,421,175,246,141,64,77,0.44,0.335,0.26,12950,95.190811,215,361,0.857482185273159
"10789",216852,"WIDENER UNIVERSITY-MAIN CAMPUS",1,0,1996,462,217,245,172,73,99,0.456,0.372,0.298,13560,101.795243,218,365,0.79004329004329
"10790",216852,"WIDENER UNIVERSITY-MAIN CAMPUS",1,0,1997,391,174,217,145,65,80,0.46,0.371,0.3,14380,83.206112,218,318,0.813299232736573
"10791",216852,"WIDENER UNIVERSITY-MAIN CAMPUS",1,0,1998,490,207,283,204,111,93,0.449,0.416,0.392,15750,83.82089,219,427,0.871428571428571
"10792",216852,"WIDENER UNIVERSITY-MAIN CAMPUS",1,0,1999,548,250,298,213,100,113,0.452,0.389,0.336,16750,85.335764,220,460,0.839416058394161
"10793",216852,"WIDENER UNIVERSITY-MAIN CAMPUS",1,0,2000,534,231,303,218,96,122,0.528,0.408,0.317,17950,89.009799,219,466,0.872659176029963
"10794",216852,"WIDENER UNIVERSITY-MAIN CAMPUS",1,0,2001,550,227,323,188,78,110,0.485,0.342,0.241,19300,90.564624,218,410,0.745454545454545
"10795",216852,"WIDENER UNIVERSITY-MAIN CAMPUS",1,0,2002,716,327,389,284,119,165,0.505,0.397,0.306,20450,95.723664,219,538,0.751396648044693
"10796",216852,"WIDENER UNIVERSITY-MAIN CAMPUS",1,0,2003,578,286,292,237,90,147,0.514,0.41,0.308,21400,101.649501,219,445,0.769896193771626
"10797",216852,"WIDENER UNIVERSITY-MAIN CAMPUS",1,0,2004,736,342,394,247,97,150,0.439,0.336,0.246,22800,108.830084,244,527,0.716032608695652
"10798",216852,"Widener University-Main Campus",1,0,2005,646,332,314,258,98,160,0.482,0.399,0.312,24620,117.082366,248,449,0.695046439628483
"10799",216852,"Widener University-Main Campus",1,0,2006,740,354,386,317,135,182,0.514,0.428,0.35,26350,124.303931,253,466,0.62972972972973
"10800",216852,"Widener University-Main Campus",1,0,2007,782,382,400,312,133,179,0.469,0.399,0.332,28180,129.447407,219,575,0.735294117647059
"10801",216852,"Widener University-Main Campus",1,0,2008,718,337,381,266,121,145,0.43,0.37,0.318,29990,136.632097,220,547,0.761838440111421
"10802",216852,"Widener University-Main Campus",1,0,2009,710,372,338,304,127,177,0.476,0.428,0.376,31340,140.776582,226,505,0.711267605633803
"10803",216852,"Widener University-Main Campus",1,0,2010,718,371,347,298,116,182,0.491,0.415,0.334,32750,145.407277,228,512,0.713091922005571
"10804",216931,"WILKES UNIVERSITY",1,0,1991,395,170,225,154,71,83,0.488,0.39,0.316,9275,33.077967,149,378,0.956962025316456
"10805",216931,"WILKES UNIVERSITY",1,0,1992,404,164,240,153,73,80,0.488,0.379,0.304,9868,35.054347,140,383,0.948019801980198
"10806",216931,"WILKES UNIVERSITY",1,0,1993,434,198,236,177,85,92,0.465,0.408,0.36,10898,35.4172,138,412,0.949308755760369
"10807",216931,"WILKES UNIVERSITY",1,0,1995,369,167,202,118,60,58,0.347,0.32,0.297,12473,41.399343,134,352,0.953929539295393
"10808",216931,"WILKES UNIVERSITY",1,0,1996,448,181,267,154,83,71,0.392,0.344,0.311,13147,42.714374,134,415,0.926339285714286
"10809",216931,"WILKES UNIVERSITY",1,0,1997,355,168,187,161,72,89,0.53,0.454,0.385,15091,34.680206,125,331,0.932394366197183
"10810",216931,"WILKES UNIVERSITY",1,0,1998,376,160,216,148,70,78,0.488,0.394,0.324,15702,32.429461,116,353,0.938829787234043
"10811",216931,"WILKES UNIVERSITY",1,0,1999,377,161,216,166,88,78,0.485,0.44,0.407,15652,34.098262,114,364,0.96551724137931
"10812",216931,"WILKES UNIVERSITY",1,0,2000,460,196,264,194,93,101,0.515,0.422,0.352,16388,33.500828,110,439,0.954347826086957
"10813",216931,"WILKES UNIVERSITY",1,0,2001,407,198,209,198,99,99,0.5,0.486,0.474,17142,36.304106,106,381,0.936117936117936
"10814",216931,"WILKES UNIVERSITY",1,0,2002,471,239,232,224,101,123,0.515,0.476,0.435,17956,41.717851,106,444,0.942675159235669
"10815",216931,"WILKES UNIVERSITY",1,0,2003,509,235,274,254,107,147,0.625,0.499,0.391,18680,43.420688,112,481,0.944990176817289
"10816",216931,"WILKES UNIVERSITY",1,0,2004,550,296,254,287,128,159,0.537,0.522,0.504,19428,47.491483,120,507,0.921818181818182
"10817",216931,"Wilkes University",1,0,2005,562,297,265,270,114,156,0.525,0.48,0.43,20592,51.313287,131,501,0.891459074733096
"10818",216931,"Wilkes University",1,0,2006,570,285,285,279,133,146,0.512,0.489,0.467,21830,59.306549,133,510,0.894736842105263
"10819",216931,"Wilkes University",1,0,2007,620,299,321,291,146,145,0.485,0.469,0.455,22820,66.038321,136,530,0.854838709677419
"10820",216931,"Wilkes University",1,0,2008,559,290,269,249,114,135,0.465,0.445,0.424,23850,68.830161,146,443,0.792486583184258
"10821",216931,"Wilkes University",1,0,2009,527,243,284,250,121,129,0.531,0.474,0.426,24690,73.705994,148,437,0.829222011385199
"10822",216931,"Wilkes University",1,0,2010,499,249,250,240,106,134,0.538,0.481,0.424,25802,76.205741,157,337,0.675350701402806
"10823",217059,"YORK COLLEGE PENNSYLVANIA",1,0,1991,697,396,301,265,88,177,0.447,0.38,0.292,4380,19.522776,108,676,0.96987087517934
"10824",217059,"YORK COLLEGE PENNSYLVANIA",1,0,1992,691,414,277,263,87,176,0.425,0.381,0.314,4645,21.867604,114,662,0.958031837916064
"10825",217059,"YORK COLLEGE PENNSYLVANIA",1,0,1993,691,397,294,274,102,172,0.433,0.397,0.347,4995,23.689904,113,656,0.949348769898698
"10826",217059,"YORK COLLEGE PENNSYLVANIA",1,0,1995,851,483,368,350,121,229,0.474,0.411,0.329,5730,27.182783,115,819,0.962397179788484
"10827",217059,"YORK COLLEGE PENNSYLVANIA",1,0,1996,805,443,362,319,122,197,0.445,0.396,0.337,5790,28.902416,119,774,0.961490683229814
"10828",217059,"YORK COLLEGE PENNSYLVANIA",1,0,1997,842,496,346,348,128,220,0.444,0.413,0.37,6100,28.571563,124,812,0.96437054631829
"10829",217059,"YORK COLLEGE PENNSYLVANIA",1,0,1998,853,462,391,370,145,225,0.487,0.434,0.371,6310,31.356988,128,809,0.94841735052755
"10830",217059,"YORK COLLEGE PENNSYLVANIA",1,0,1999,909,511,398,372,122,250,0.489,0.409,0.307,6280,33.608423,130,880,0.968096809680968
"10831",217059,"YORK COLLEGE PENNSYLVANIA",1,0,2000,900,510,390,366,129,237,0.465,0.407,0.331,6600,36.088867,134,864,0.96
"10832",217059,"YORK COLLEGE PENNSYLVANIA",1,0,2001,968,540,428,383,137,246,0.456,0.396,0.32,7000,38.865202,138,925,0.955578512396694
"10833",217059,"YORK COLLEGE PENNSYLVANIA",1,0,2002,921,521,400,373,138,235,0.451,0.405,0.345,7500,42.403985,134,878,0.953311617806732
"10834",217059,"YORK COLLEGE PENNSYLVANIA",1,0,2003,1013,541,472,425,171,254,0.47,0.42,0.362,8000,45.162382,133,926,0.914116485686081
"10835",217059,"YORK COLLEGE PENNSYLVANIA",1,0,2004,1037,612,425,423,151,272,0.444,0.408,0.355,8600,49.6461,130,949,0.915139826422372
"10836",217059,"York College Pennsylvania",1,0,2005,1078,591,487,442,175,267,0.452,0.41,0.359,9350,53.216098,134,970,0.899814471243043
"10837",217059,"York College Pennsylvania",1,0,2006,1092,536,556,452,207,245,0.457,0.414,0.372,10160,60.284253,145,945,0.865384615384615
"10838",217059,"York College Pennsylvania",1,0,2007,1177,597,580,437,189,248,0.415,0.371,0.326,11500,64.563289,147,1014,0.861512319456245
"10839",217059,"York College Pennsylvania",1,0,2008,1097,580,517,427,185,242,0.417,0.389,0.358,12320,74.610929,155,974,0.887876025524157
"10840",217059,"York College Pennsylvania",1,0,2009,1092,595,497,431,144,287,0.482,0.395,0.29,13000,78.16197,183,911,0.834249084249084
"10841",217059,"York College Pennsylvania",1,0,2010,1231,657,574,481,182,299,0.455,0.391,0.317,13640,86.066541,185,1053,0.855402112103981
"10842",217156,"BROWN UNIVERSITY",1,0,1991,1358,658,700,1048,543,505,0.768,0.772,0.776,17224,244.332319,515,879,0.647275405007364
"10843",217156,"BROWN UNIVERSITY",1,0,1992,1406,711,695,1121,553,568,0.799,0.797,0.796,18392,254.995538,517,889,0.632290184921764
"10844",217156,"BROWN UNIVERSITY",1,0,1993,1424,770,654,1109,494,615,0.799,0.779,0.755,19556,270.950138,514,961,0.674859550561798
"10845",217156,"BROWN UNIVERSITY",1,0,1995,1370,739,631,1106,492,614,0.831,0.807,0.78,21727,303.676683,516,885,0.645985401459854
"10846",217156,"BROWN UNIVERSITY",1,0,1996,1469,810,659,1220,536,684,0.844,0.83,0.813,22719,322.640712,531,960,0.653505786249149
"10847",217156,"BROWN UNIVERSITY",1,0,1997,1368,722,646,1136,527,609,0.843,0.83,0.816,23287,297.681,532,866,0.633040935672515
"10848",217156,"BROWN UNIVERSITY",1,0,1998,1417,772,645,1180,520,660,0.855,0.833,0.806,23616,310.965,525,897,0.63302752293578
"10849",217156,"BROWN UNIVERSITY",1,0,1999,1376,729,647,1146,539,607,0.833,0.833,0.833,24624,327.287,539,685,0.49781976744186
"10850",217156,"BROWN UNIVERSITY",1,0,2000,1415,767,648,1177,530,647,0.843,0.832,0.818,25600,353.497,567.5,667,0.471378091872792
"10851",217156,"BROWN UNIVERSITY",1,0,2001,1375,760,615,1154,506,648,0.853,0.839,0.823,26568,368.257,596,655,0.476363636363636
"10852",217156,"BROWN UNIVERSITY",1,0,2002,1451,817,634,1213,505,708,0.867,0.836,0.797,27856,401.232,621,777,0.535492763611303
"10853",217156,"BROWN UNIVERSITY",1,0,2003,1392,736,656,1192,539,653,0.887,0.856,0.822,29200,443.342,657,719,0.516522988505747
"10854",217156,"BROWN UNIVERSITY",1,0,2004,1429,744,685,1224,580,644,0.866,0.857,0.847,30672,473.669,651,785,0.549335199440168
"10855",217156,"Brown University",1,0,2005,1439,735,704,1197,577,620,0.843,0.832,0.82,32264,523.444,643,742,0.515635858234885
"10856",217156,"Brown University",1,0,2006,1464,740,724,1215,590,625,0.845,0.83,0.815,33888,554.135,687,717,0.489754098360656
"10857",217156,"Brown University",1,0,2007,1477,814,663,1246,548,698,0.858,0.844,0.827,35584,570.838,714,687,0.465132024373731
"10858",217156,"Brown University",1,0,2008,1546,813,733,1307,612,695,0.855,0.845,0.835,36928,606.272,738,694,0.448900388098318
"10859",217156,"Brown University",1,0,2009,1490,770,720,1238,598,640,0.831,0.831,0.831,38048,636.547,728,728,0.488590604026846
"10860",217156,"Brown University",1,0,2010,1495,784,711,1251,599,652,0.832,0.837,0.842,39928,658.792,728,683,0.45685618729097
"10861",217402,"PROVIDENCE COLLEGE",1,0,1991,963,529,434,764,330,434,0.82,0.793,0.76,11840,69.026729,215,884,0.917964693665628
"10862",217402,"PROVIDENCE COLLEGE",1,0,1992,931,523,408,734,322,412,0.788,0.788,0.789,12700,72.601303,221,837,0.899033297529538
"10863",217402,"PROVIDENCE COLLEGE",1,0,1993,968,503,465,775,368,407,0.809,0.801,0.791,13625,74.275428,219,867,0.895661157024793
"10864",217402,"PROVIDENCE COLLEGE",1,0,1995,954,589,365,795,297,498,0.846,0.833,0.814,15380,84.029666,216,851,0.892033542976939
"10865",217402,"PROVIDENCE COLLEGE",1,0,1996,938,556,382,786,310,476,0.856,0.838,0.812,15930,91.922549,216,826,0.880597014925373
"10866",217402,"PROVIDENCE COLLEGE",1,0,1997,974,563,411,801,326,475,0.844,0.822,0.793,16480,72.150609,218,869,0.892197125256673
"10867",217402,"PROVIDENCE COLLEGE",1,0,1998,994,599,395,813,323,490,0.818,0.818,0.818,17285,75.50441,227,895,0.900402414486921
"10868",217402,"PROVIDENCE COLLEGE",1,0,1999,973,556,417,838,351,487,0.876,0.861,0.842,17640,76.003195,234,860,0.883864337101747
"10869",217402,"PROVIDENCE COLLEGE",1,0,2000,930,527,403,775,328,447,0.848,0.833,0.814,18440,77.727059,240,816,0.87741935483871
"10870",217402,"PROVIDENCE COLLEGE",1,0,2001,933,531,402,795,334,461,0.868,0.852,0.831,19375,82.266491,246,809,0.867095391211147
"10871",217402,"PROVIDENCE COLLEGE",1,0,2002,877,540,337,734,274,460,0.852,0.837,0.813,20440,86.038926,264,711,0.810718358038769
"10872",217402,"PROVIDENCE COLLEGE",1,0,2003,975,561,414,823,339,484,0.863,0.844,0.819,21665,94.243365,251,821,0.842051282051282
"10873",217402,"PROVIDENCE COLLEGE",1,0,2004,1036,549,487,859,406,453,0.825,0.829,0.834,23180,98.889185,256,865,0.834942084942085
"10874",217402,"Providence College",1,0,2005,1064,593,471,857,367,490,0.826,0.805,0.779,24800,101.967231,256,895,0.841165413533835
"10875",217402,"Providence College",1,0,2006,1023,585,438,860,351,509,0.87,0.841,0.801,26780,108.333726,260,848,0.828934506353861
"10876",217402,"Providence College",1,0,2007,989,559,430,820,361,459,0.821,0.829,0.84,28920,114.564789,261,788,0.796764408493428
"10877",217402,"Providence College",1,0,2008,987,575,412,821,336,485,0.843,0.832,0.816,30800,127.60686,264,709,0.718338399189463
"10878",217402,"Providence College",1,0,2009,952,549,403,772,324,448,0.816,0.811,0.804,32320,130.394491,269,649,0.68172268907563
"10879",217402,"Providence College",1,0,2010,1102,633,469,888,383,505,0.798,0.806,0.817,38610,136.755031,266,839,0.761343012704174
"10880",217536,"SALVE REGINA UNIVERSITY",1,0,1991,400,281,119,196,49,147,0.523,0.49,0.412,11930,26.092,109,379,0.9475
"10881",217536,"SALVE REGINA UNIVERSITY",1,0,1992,381,264,117,208,58,150,0.568,0.546,0.496,13000,26.871,115,360,0.94488188976378
"10882",217536,"SALVE REGINA UNIVERSITY",1,0,1993,345,235,110,181,57,124,0.528,0.525,0.518,14200,27.616,124,328,0.950724637681159
"10883",217536,"SALVE REGINA UNIVERSITY",1,0,1995,354,258,96,190,49,141,0.546,0.537,0.51,14650,29.103,111,286,0.807909604519774
"10884",217536,"SALVE REGINA UNIVERSITY",1,0,1996,393,271,122,209,61,148,0.546,0.532,0.5,15190,28.938,107,372,0.946564885496183
"10885",217536,"SALVE REGINA UNIVERSITY",1,0,1997,479,318,161,219,55,164,0.516,0.457,0.342,15650,24.92,105,442,0.922755741127349
"10886",217536,"SALVE REGINA UNIVERSITY",1,0,1998,443,296,147,241,69,172,0.581,0.544,0.469,16300,26.842,104,411,0.927765237020316
"10887",217536,"SALVE REGINA UNIVERSITY",1,0,1999,528,352,176,277,69,208,0.591,0.525,0.392,16500,29.266,110,487,0.922348484848485
"10888",217536,"SALVE REGINA UNIVERSITY",1,0,2000,510,383,127,273,63,210,0.548,0.535,0.496,17200,31.807,107.5,474,0.929411764705882
"10889",217536,"SALVE REGINA UNIVERSITY",1,0,2001,551,396,155,321,78,243,0.614,0.583,0.503,17950,34.295,105,498,0.903811252268603
"10890",217536,"SALVE REGINA UNIVERSITY",1,0,2002,523,378,145,334,93,241,0.638,0.639,0.641,19000,36.397,105,470,0.898661567877629
"10891",217536,"SALVE REGINA UNIVERSITY",1,0,2003,571,401,170,361,91,270,0.673,0.632,0.535,20100,39.404,106,492,0.861646234676007
"10892",217536,"SALVE REGINA UNIVERSITY",1,0,2004,558,397,161,358,99,259,0.652,0.642,0.615,21750,40.757,113,472,0.845878136200717
"10893",217536,"Salve Regina University",1,0,2005,562,418,144,382,82,300,0.718,0.68,0.569,23500,44.751,122,468,0.832740213523132
"10894",217536,"Salve Regina University",1,0,2006,568,394,174,390,113,277,0.703,0.687,0.649,24975,49.146,121,475,0.836267605633803
"10895",217536,"Salve Regina University",1,0,2007,556,353,203,338,117,221,0.626,0.608,0.576,26750,53.337,122,461,0.829136690647482
"10896",217536,"Salve Regina University",1,0,2008,556,382,174,355,94,261,0.683,0.638,0.54,28950,57.057,119,423,0.760791366906475
"10897",217536,"Salve Regina University",1,0,2009,501,346,155,343,98,245,0.708,0.685,0.632,29800,59.323,117,375,0.748502994011976
"10898",217536,"Salve Regina University",1,0,2010,592,423,169,380,96,284,0.671,0.642,0.568,31250,58.215,110,473,0.798986486486487
"10899",217776,"CENTRAL WESLEYAN COLLEGE",1,0,1991,78,41,37,16,6,10,0.244,0.205,0.162,7090,6.579395,34,70,0.897435897435897
"10900",217776,"CENTRAL WESLEYAN COLLEGE",1,0,1992,88,54,34,26,6,20,0.37,0.295,0.176,7500,7.257534,38,80,0.909090909090909
"10901",217776,"CENTRAL WESLEYAN COLLEGE",1,0,1993,90,48,42,23,8,15,0.312,0.256,0.19,8100,7.756117,36,79,0.877777777777778
"10902",217776,"SOUTHERN WESLEYAN UNIVERSITY",1,0,1995,69,32,37,11,3,8,0.25,0.159,0.081,9081,8.804551,35,58,0.840579710144927
"10903",217776,"SOUTHERN WESLEYAN UNIVERSITY",1,0,1996,73,36,37,19,8,11,0.306,0.26,0.216,9616,8.886734,38,64,0.876712328767123
"10904",217776,"SOUTHERN WESLEYAN UNIVERSITY",1,0,1997,101,51,50,27,9,18,0.353,0.267,0.18,10180,7.927444,38,86,0.851485148514851
"10905",217776,"SOUTHERN WESLEYAN UNIVERSITY",1,0,1998,91,51,40,25,11,14,0.274,0.275,0.275,10840,8.467775,40,84,0.923076923076923
"10906",217776,"SOUTHERN WESLEYAN UNIVERSITY",1,0,1999,99,47,52,35,12,23,0.489,0.354,0.231,11148,8.855634,41,91,0.919191919191919
"10907",217776,"SOUTHERN WESLEYAN UNIVERSITY",1,0,2000,92,51,41,33,12,21,0.412,0.359,0.293,11704,10.34855,42,81,0.880434782608696
"10908",217776,"SOUTHERN WESLEYAN UNIVERSITY",1,0,2001,139,78,61,46,18,28,0.359,0.331,0.295,12400,12.020548,43,103,0.741007194244604
"10909",217776,"SOUTHERN WESLEYAN UNIVERSITY",1,0,2002,141,76,65,36,11,25,0.329,0.255,0.169,13000,13.930975,47,105,0.74468085106383
"10910",217776,"SOUTHERN WESLEYAN UNIVERSITY",1,0,2003,160,100,60,41,17,24,0.24,0.256,0.283,13650,16.169009,47,129,0.80625
"10911",217776,"SOUTHERN WESLEYAN UNIVERSITY",1,0,2004,161,98,63,40,15,25,0.255,0.248,0.238,14300,18.600126,51,122,0.757763975155279
"10912",217776,"Southern Wesleyan University",1,0,2005,176,110,66,46,18,28,0.254,0.261,0.273,15000,19.726249,54,127,0.721590909090909
"10913",217776,"Southern Wesleyan University",1,0,2006,150,86,64,61,28,33,0.384,0.407,0.438,15700,21.476629,50,123,0.82
"10914",217776,"Southern Wesleyan University",1,0,2007,183,114,69,49,20,29,0.254,0.268,0.29,16700,21.391437,52,135,0.737704918032787
"10915",217776,"Southern Wesleyan University",1,0,2008,142,84,58,52,13,39,0.464,0.366,0.224,17500,22.860033,53,114,0.802816901408451
"10916",217776,"Southern Wesleyan University",1,0,2009,168,100,68,67,26,41,0.41,0.399,0.382,18200,23.650565,52,133,0.791666666666667
"10917",217776,"Southern Wesleyan University",1,0,2010,153,80,73,77,40,37,0.462,0.503,0.548,19000,24.965728,57,119,0.777777777777778
"10918",217819,"COLLEGE OF CHARLESTON",1,0,1991,1434,943,491,483,104,379,0.402,0.337,0.212,2400,55.385543,267,1277,0.890516039051604
"10919",217819,"COLLEGE OF CHARLESTON",1,0,1992,1296,853,443,426,100,326,0.382,0.329,0.226,2650,58.908933,293,1171,0.903549382716049
"10920",217819,"COLLEGE OF CHARLESTON",1,0,1993,1519,1004,515,485,123,362,0.361,0.319,0.239,2950,63.359238,320,1353,0.890717577353522
"10921",217819,"COLLEGE OF CHARLESTON",1,0,1995,1748,1190,558,596,136,460,0.387,0.341,0.244,3090,77.548214,347,1542,0.882151029748284
"10922",217819,"COLLEGE OF CHARLESTON",1,0,1996,1867,1236,631,624,149,475,0.384,0.334,0.236,3190,81.794799,368,1641,0.878950187466524
"10923",217819,"COLLEGE OF CHARLESTON",1,0,1997,1568,1031,537,565,130,435,0.422,0.36,0.242,3290,88.863027,378,1385,0.883290816326531
"10924",217819,"COLLEGE OF CHARLESTON",1,0,1998,1937,1248,689,712,179,533,0.427,0.368,0.26,3390,94.896099,394,1699,0.877129581827568
"10925",217819,"COLLEGE OF CHARLESTON",1,0,1999,2067,1399,668,850,206,644,0.46,0.411,0.308,206,108.112333,414,1784,0.863086598935656
"10926",217819,"COLLEGE OF CHARLESTON",1,0,2000,1985,1337,648,835,215,620,0.464,0.421,0.332,276,115.225391,425.5,1704,0.858438287153652
"10927",217819,"COLLEGE OF CHARLESTON",1,0,2001,1967,1295,672,868,248,620,0.479,0.441,0.369,276,122.10311,437,1631,0.829181494661922
"10928",217819,"COLLEGE OF CHARLESTON",1,0,2002,1991,1333,658,941,253,688,0.516,0.473,0.384,386,121.107399,445,1693,0.850326469111
"10929",217819,"COLLEGE OF CHARLESTON",1,0,2003,1868,1229,639,896,251,645,0.525,0.48,0.393,386,136.710043,469,1602,0.857601713062099
"10930",217819,"COLLEGE OF CHARLESTON",1,0,2004,1940,1323,617,1039,268,771,0.583,0.536,0.434,456,139.466198,481,1664,0.857731958762887
"10931",217819,"College of Charleston",1,0,2005,1984,1342,642,1031,291,740,0.551,0.52,0.453,70,151.381694,495,1650,0.831653225806452
"10932",217819,"College of Charleston",1,0,2006,1959,1332,627,1132,315,817,0.613,0.578,0.502,70,159.541818,502,1671,0.852986217457887
"10933",217819,"College of Charleston",1,0,2007,2061,1352,709,1071,302,769,0.569,0.52,0.426,70,167.401291,499,1722,0.83551673944687
"10934",217819,"College of Charleston",1,0,2008,1949,1296,653,1070,318,752,0.58,0.549,0.487,70,188.11982,503,1663,0.853258081067214
"10935",217819,"College of Charleston",1,0,2009,2136,1497,639,1203,320,883,0.59,0.563,0.501,70,190.310704,504,1769,0.828183520599251
"10936",217819,"College of Charleston",1,0,2010,2001,1329,672,1162,325,837,0.63,0.581,0.484,70,199.252019,510,1699,0.849075462268866
"10937",217882,"CLEMSON UNIVERSITY",1,0,1991,2474,1120,1354,871,321,550,0.491,0.352,0.237,2630,291.344694,829,2151,0.86944219886823
"10938",217882,"CLEMSON UNIVERSITY",1,0,1992,2484,1179,1305,910,330,580,0.492,0.366,0.253,2762,308.759238,846,2186,0.880032206119163
"10939",217882,"CLEMSON UNIVERSITY",1,0,1993,2300,1053,1247,872,323,549,0.521,0.379,0.259,2954,312.590382,801,2015,0.876086956521739
"10940",217882,"CLEMSON UNIVERSITY",1,0,1995,2556,1255,1301,905,319,586,0.467,0.354,0.245,3112,331.488105,879,2259,0.883802816901408
"10941",217882,"CLEMSON UNIVERSITY",1,0,1996,2538,1234,1304,945,327,618,0.501,0.372,0.251,3112,323.312569,867,2288,0.901497241922774
"10942",217882,"CLEMSON UNIVERSITY",1,0,1997,2579,1265,1314,997,341,656,0.519,0.387,0.26,3252,345.424217,865,2285,0.886002326483133
"10943",217882,"CLEMSON UNIVERSITY",1,0,1998,2699,1273,1426,1091,396,695,0.546,0.404,0.278,3344,371.796792,923,2408,0.89218228973694
"10944",217882,"CLEMSON UNIVERSITY",1,0,1999,2886,1354,1532,1267,490,777,0.574,0.439,0.32,2835,411.824968,935,2566,0.889119889119889
"10945",217882,"CLEMSON UNIVERSITY",1,0,2000,3028,1451,1577,1333,496,837,0.577,0.44,0.315,3590,424.172268,907.5,2690,0.888375165125495
"10946",217882,"CLEMSON UNIVERSITY",1,0,2001,2530,1184,1346,1166,443,723,0.611,0.461,0.329,5090,454.287758,880,2069,0.817786561264822
"10947",217882,"CLEMSON UNIVERSITY",1,0,2002,2463,1214,1249,1231,462,769,0.633,0.5,0.37,5834,445.830142,964,2072,0.841250507511165
"10948",217882,"CLEMSON UNIVERSITY",1,0,2003,2748,1293,1455,1379,535,844,0.653,0.502,0.368,6934,479.797102,952,2205,0.802401746724891
"10949",217882,"CLEMSON UNIVERSITY",1,0,2004,2994,1369,1625,1488,597,891,0.651,0.497,0.367,7840,483.089497,942,2461,0.821977287909152
"10950",217882,"Clemson University",1,0,2005,2893,1426,1467,1565,611,954,0.669,0.541,0.416,8816,501.047888,1014,2420,0.836501901140684
"10951",217882,"Clemson University",1,0,2006,2755,1363,1392,1575,604,971,0.712,0.572,0.434,9056,536.594989,1061,2269,0.823593466424682
"10952",217882,"Clemson University",1,0,2007,2702,1304,1398,1598,677,921,0.706,0.591,0.484,9344,576.916523,1086,2232,0.826054774241303
"10953",217882,"Clemson University",1,0,2008,2866,1412,1454,1747,737,1010,0.715,0.61,0.507,9886,647.471481,1094,2356,0.82205163991626
"10954",217882,"Clemson University",1,0,2009,3336,1564,1772,1926,853,1073,0.686,0.577,0.481,10298,626.929868,1052,2847,0.85341726618705
"10955",217882,"Clemson University",1,0,2010,2977,1498,1479,1755,707,1048,0.7,0.59,0.478,11128,629.036314,1043,2570,0.863285186429291
"10956",217998,"ERSKINE COLLEGE AND SEMINARY",1,0,1991,101,64,37,66,21,45,0.703,0.653,0.568,9565,8.883029,39,97,0.96039603960396
"10957",217998,"ERSKINE COLLEGE AND SEMINARY",1,0,1992,185,98,87,110,52,58,0.592,0.595,0.598,10125,10.343241,39,173,0.935135135135135
"10958",217998,"ERSKINE COLLEGE AND SEMINARY",1,0,1993,177,108,69,113,36,77,0.713,0.638,0.522,10630,10.819058,50,170,0.96045197740113
"10959",217998,"ERSKINE COLLEGE AND SEMINARY",1,0,1995,143,77,66,93,42,51,0.662,0.65,0.636,11823,12.412164,51,140,0.979020979020979
"10960",217998,"ERSKINE COLLEGE AND SEMINARY",1,0,1996,134,82,52,89,34,55,0.671,0.664,0.654,13087,12.718344,51,128,0.955223880597015
"10961",217998,"ERSKINE COLLEGE AND SEMINARY",1,0,1997,132,78,54,85,31,54,0.692,0.644,0.574,13902,13.863032,52,118,0.893939393939394
"10962",217998,"ERSKINE COLLEGE AND SEMINARY",1,0,1998,136,84,52,89,28,61,0.726,0.654,0.538,14893,13.768542,47,122,0.897058823529412
"10963",217998,"ERSKINE COLLEGE AND SEMINARY",1,0,1999,156,91,65,100,33,67,0.736,0.641,0.508,14269,12.057453,50,144,0.923076923076923
"10964",217998,"ERSKINE COLLEGE AND SEMINARY",1,0,2000,138,79,59,89,31,58,0.734,0.645,0.525,14697,11.490837,55,122,0.884057971014493
"10965",217998,"ERSKINE COLLEGE AND SEMINARY",1,0,2001,217,127,90,125,44,81,0.638,0.576,0.489,15138,12.106033,60,197,0.907834101382488
"10966",217998,"ERSKINE COLLEGE AND SEMINARY",1,0,2002,165,100,65,87,25,62,0.62,0.527,0.385,15700,16.655713,55,152,0.921212121212121
"10967",217998,"ERSKINE COLLEGE AND SEMINARY",1,0,2003,176,102,74,111,43,68,0.667,0.631,0.581,16312,16.205801,53,154,0.875
"10968",217998,"ERSKINE COLLEGE AND SEMINARY",1,0,2004,179,106,73,97,39,58,0.547,0.542,0.534,16948,16.029184,54,160,0.893854748603352
"10969",217998,"Erskine College and Seminary",1,0,2005,181,90,91,82,33,49,0.544,0.453,0.363,17700,16.954243,53,160,0.883977900552486
"10970",217998,"Erskine College and Seminary",1,0,2006,178,100,78,101,34,67,0.67,0.567,0.436,18840,17.211668,58,150,0.842696629213483
"10971",217998,"Erskine College and Seminary",1,0,2007,163,94,69,84,30,54,0.575,0.515,0.435,20185,18.14053,59,145,0.889570552147239
"10972",217998,"Erskine College and Seminary",1,0,2008,163,83,80,72,32,40,0.482,0.442,0.4,21590,20.482355,62,106,0.650306748466258
"10973",217998,"Erskine College and Seminary",1,0,2009,182,99,83,102,45,57,0.576,0.56,0.542,23000,19.931597,61,152,0.835164835164835
"10974",217998,"Erskine College and Seminary",1,0,2010,144,81,63,85,34,51,0.63,0.59,0.54,24750,20.910411,58,117,0.8125
"10975",218061,"FRANCIS MARION COLLEGE",1,0,1991,735,388,347,79,23,56,0.144,0.107,0.066,2140,24.582035,157,587,0.798639455782313
"10976",218061,"FRANCIS MARION UNIVERSITY",1,0,1992,875,487,388,110,42,68,0.14,0.126,0.108,2440,27.281202,160,666,0.761142857142857
"10977",218061,"FRANCIS MARION UNIVERSITY",1,0,1993,807,435,372,130,40,90,0.207,0.161,0.108,2800,29.083781,166,583,0.722428748451053
"10978",218061,"FRANCIS MARION UNIVERSITY",1,0,1995,757,405,352,140,43,97,0.24,0.185,0.122,3010,31.789883,167,550,0.726552179656539
"10979",218061,"FRANCIS MARION UNIVERSITY",1,0,1996,636,365,271,119,39,80,0.219,0.187,0.144,3100,32.895807,154,442,0.694968553459119
"10980",218061,"FRANCIS MARION UNIVERSITY",1,0,1997,582,336,246,99,34,65,0.194,0.17,0.138,3390,33.230886,161,425,0.730240549828179
"10981",218061,"FRANCIS MARION UNIVERSITY",1,0,1998,649,372,277,188,57,131,0.352,0.29,0.206,3350,34.158552,161,413,0.636363636363636
"10982",218061,"FRANCIS MARION UNIVERSITY",1,0,1999,570,332,238,104,27,77,0.232,0.182,0.113,3260,40.89668,159,371,0.650877192982456
"10983",218061,"FRANCIS MARION UNIVERSITY",1,0,2000,602,356,246,95,33,62,0.174,0.158,0.134,3410,38.384963,158.5,412,0.684385382059801
"10984",218061,"FRANCIS MARION UNIVERSITY",1,0,2001,634,377,257,127,41,86,0.228,0.2,0.16,3620,39.092475,158,403,0.635646687697161
"10985",218061,"FRANCIS MARION UNIVERSITY",1,0,2002,734,431,303,142,48,94,0.218,0.193,0.158,4190,34.605776,158,463,0.630790190735695
"10986",218061,"FRANCIS MARION UNIVERSITY",1,0,2003,765,447,318,153,48,105,0.235,0.2,0.151,4947,37.050866,164,445,0.581699346405229
"10987",218061,"FRANCIS MARION UNIVERSITY",1,0,2004,745,463,282,139,34,105,0.227,0.187,0.121,5405,38.62782,170,395,0.530201342281879
"10988",218061,"Francis Marion University",1,0,2005,797,517,280,158,40,118,0.228,0.198,0.143,5849,39.783174,175,416,0.521957340025094
"10989",218061,"Francis Marion University",1,0,2006,795,519,276,142,34,108,0.208,0.179,0.123,6327,44.129677,190,422,0.530817610062893
"10990",218061,"Francis Marion University",1,0,2007,776,493,283,127,47,80,0.162,0.164,0.166,6803,47.791315,200,419,0.539948453608247
"10991",218061,"Francis Marion University",1,0,2008,676,452,224,104,34,70,0.155,0.154,0.152,7347,53.019039,199,289,0.427514792899408
"10992",218061,"Francis Marion University",1,0,2009,791,533,258,142,44,98,0.184,0.18,0.171,7625,52.247293,199,355,0.448798988621997
"10993",218061,"Francis Marion University",1,0,2010,737,479,258,130,40,90,0.188,0.176,0.155,8145,53.642387,202,352,0.477611940298507
"10994",218229,"LANDER COLLEGE",1,0,1991,421,286,135,83,18,65,0.227,0.197,0.133,2620,18.252179,120,343,0.814726840855107
"10995",218229,"LANDER COLLEGE",1,0,1992,402,273,129,65,16,49,0.18,0.162,0.124,2920,18.617032,115,332,0.825870646766169
"10996",218229,"LANDER UNIVERSITY",1,0,1993,491,327,164,80,21,59,0.18,0.163,0.128,3220,20.738444,110,398,0.810590631364562
"10997",218229,"LANDER UNIVERSITY",1,0,1995,477,301,176,155,46,109,0.362,0.325,0.261,3400,23.778917,116,389,0.815513626834382
"10998",218229,"LANDER UNIVERSITY",1,0,1996,437,273,164,134,40,94,0.344,0.307,0.244,3550,24.764903,120,342,0.782608695652174
"10999",218229,"LANDER UNIVERSITY",1,0,1997,434,288,146,94,23,71,0.246,0.217,0.158,5328,28.70194,120,353,0.813364055299539
"11000",218229,"LANDER UNIVERSITY",1,0,1998,488,322,166,92,19,73,0.227,0.189,0.114,5476,30.326064,121,396,0.811475409836066
"11001",218229,"LANDER UNIVERSITY",1,0,1999,494,313,181,107,22,85,0.272,0.217,0.122,5548,30.563263,122,417,0.84412955465587
"11002",218229,"LANDER UNIVERSITY",1,0,2000,509,321,188,88,23,65,0.202,0.173,0.122,5832,28.535033,116.5,414,0.81335952848723
"11003",218229,"LANDER UNIVERSITY",1,0,2001,488,291,197,118,25,93,0.32,0.242,0.127,4152,30.388411,111,401,0.82172131147541
"11004",218229,"LANDER UNIVERSITY",1,0,2002,526,335,191,117,25,92,0.275,0.222,0.131,4704,28.450057,114,439,0.834600760456274
"11005",218229,"LANDER UNIVERSITY",1,0,2003,541,356,185,139,30,109,0.306,0.257,0.162,5400,31.707595,124,439,0.811460258780037
"11006",218229,"LANDER UNIVERSITY",1,0,2004,647,440,207,140,32,108,0.246,0.216,0.155,5856,33.331582,118,471,0.727975270479134
"11007",218229,"Lander University",1,0,2005,555,369,186,110,34,76,0.206,0.198,0.183,6588,34.925159,123,377,0.679279279279279
"11008",218229,"Lander University",1,0,2006,578,379,199,127,29,98,0.259,0.22,0.146,6602,37.303726,136,395,0.683391003460208
"11009",218229,"Lander University",1,0,2007,433,296,137,139,35,104,0.351,0.321,0.255,7098,37.982974,128,315,0.727482678983834
"11010",218229,"Lander University",1,0,2008,554,398,156,162,39,123,0.309,0.292,0.25,8380,39.482191,130,344,0.620938628158845
"11011",218229,"Lander University",1,0,2009,581,405,176,160,46,114,0.281,0.275,0.261,7980,40.939003,117,383,0.6592082616179
"11012",218229,"Lander University",1,0,2010,685,476,209,195,44,151,0.317,0.285,0.211,8374,42.739012,126,447,0.652554744525547
"11013",218238,"LIMESTONE COLLEGE",1,0,1991,232,126,106,17,5,12,0.095,0.073,0.047,6464,6.665409,27,118,0.508620689655172
"11014",218238,"LIMESTONE COLLEGE",1,0,1992,115,48,67,9,4,5,0.104,0.078,0.06,6878,8.286339,28,80,0.695652173913043
"11015",218238,"LIMESTONE COLLEGE",1,0,1993,214,88,126,43,22,21,0.239,0.201,0.175,7200,7.59851,28,143,0.668224299065421
"11016",218238,"LIMESTONE COLLEGE",1,0,1995,164,82,82,40,18,22,0.268,0.244,0.22,8000,9.200771,31,127,0.774390243902439
"11017",218238,"LIMESTONE COLLEGE",1,0,1996,87,38,49,16,5,11,0.29,0.184,0.102,8200,9.067723,32,73,0.839080459770115
"11018",218238,"LIMESTONE COLLEGE",1,0,1997,193,92,101,4,3,1,0.011,0.021,0.03,8600,12.362317,33,141,0.730569948186529
"11019",218238,"LIMESTONE COLLEGE",1,0,1998,112,58,54,26,8,18,0.31,0.232,0.148,9100,13.881542,41,80,0.714285714285714
"11020",218238,"LIMESTONE COLLEGE",1,0,1999,136,58,78,27,13,14,0.241,0.199,0.167,9500,14.745461,50,105,0.772058823529412
"11021",218238,"LIMESTONE COLLEGE",1,0,2000,103,49,54,23,6,17,0.347,0.223,0.111,10100,16.982912,52,80,0.776699029126214
"11022",218238,"LIMESTONE COLLEGE",1,0,2001,136,69,67,31,11,20,0.29,0.228,0.164,10800,18.237246,54,107,0.786764705882353
"11023",218238,"LIMESTONE COLLEGE",1,0,2002,180,83,97,26,12,14,0.169,0.144,0.124,11500,23.591398,56,136,0.755555555555556
"11024",218238,"LIMESTONE COLLEGE",1,0,2003,176,98,78,35,15,20,0.204,0.199,0.192,12300,28.129554,65,112,0.636363636363636
"11025",218238,"LIMESTONE COLLEGE",1,0,2004,203,95,108,41,15,26,0.274,0.202,0.139,13200,33.58527,66,146,0.719211822660099
"11026",218238,"Limestone College",1,0,2005,201,99,102,40,10,30,0.303,0.199,0.098,14040,41.379238,71,137,0.681592039800995
"11027",218238,"Limestone College",1,0,2006,206,87,119,39,17,22,0.253,0.189,0.143,15000,22.931518,75,145,0.703883495145631
"11028",218238,"Limestone College",1,0,2007,225,92,133,42,18,24,0.261,0.187,0.135,15900,24.924136,76,163,0.724444444444444
"11029",218238,"Limestone College",1,0,2008,229,98,131,29,8,21,0.214,0.127,0.061,17300,27.362254,98,145,0.633187772925764
"11030",218238,"Limestone College",1,0,2009,288,133,155,63,22,41,0.308,0.219,0.142,18300,26.802978,91,179,0.621527777777778
"11031",218238,"Limestone College",1,0,2010,275,129,146,52,19,33,0.256,0.189,0.13,19200,30.073704,91,165,0.6
"11032",218399,"MORRIS COLLEGE",1,0,1991,196,135,61,38,6,32,0.237,0.194,0.098,3939,9.095713,48,0,0
"11033",218399,"MORRIS COLLEGE",1,0,1992,293,177,116,40,16,24,0.136,0.137,0.138,4136,9.393012,44,0,0
"11034",218399,"MORRIS COLLEGE",1,0,1993,327,213,114,33,10,23,0.108,0.101,0.088,4290,10.605843,46,1,0.00305810397553517
"11035",218399,"MORRIS COLLEGE",1,0,1995,241,167,74,35,8,27,0.162,0.145,0.108,4867,11.784711,51,0,0
"11036",218399,"MORRIS COLLEGE",1,0,1996,246,145,101,45,11,34,0.234,0.183,0.109,5105,12.487797,48,0,0
"11037",218399,"MORRIS COLLEGE",1,0,1997,262,180,82,68,15,53,0.294,0.26,0.183,5240,12.093826,48,0,0
"11038",218399,"MORRIS COLLEGE",1,0,1998,204,123,81,37,10,27,0.22,0.181,0.123,5515,13.094891,48,0,0
"11039",218399,"MORRIS COLLEGE",1,0,1999,263,173,90,53,10,43,0.249,0.202,0.111,5640,13.782421,48,0,0
"11040",218399,"MORRIS COLLEGE",1,0,2000,265,167,98,48,14,34,0.204,0.181,0.143,5894,15.003864,47.5,0,0
"11041",218399,"MORRIS COLLEGE",1,0,2001,268,167,101,56,13,43,0.258,0.209,0.129,6483,16.600557,47,0,0
"11042",218399,"MORRIS COLLEGE",1,0,2002,289,175,114,51,11,40,0.229,0.176,0.096,6783,17.536229,48,0,0
"11043",218399,"MORRIS COLLEGE",1,0,2003,276,168,108,46,9,37,0.22,0.167,0.083,7190,18.024661,48,0,0
"11044",218399,"MORRIS COLLEGE",1,0,2004,232,141,91,19,3,16,0.114,0.082,0.033,7550,18.490422,48,0,0
"11045",218399,"Morris College",1,0,2005,207,130,77,30,9,21,0.161,0.145,0.117,7828,19.152105,47,0,0
"11046",218399,"Morris College",1,0,2006,249,144,105,39,11,28,0.194,0.157,0.105,8562,16.834307,46,0,0
"11047",218399,"Morris College",1,0,2007,295,152,143,40,14,26,0.171,0.136,0.098,8990,16.325498,46,0,0
"11048",218399,"Morris College",1,0,2008,292,162,130,37,6,31,0.191,0.127,0.046,9621,19.474695,44,1,0.00342465753424658
"11049",218399,"Morris College",1,0,2009,300,166,134,37,9,28,0.169,0.123,0.067,9630,18.278418,48,0,0
"11050",218399,"Morris College",1,0,2010,319,173,146,19,6,13,0.075,0.06,0.041,10015,19.649469,48,0,0
"11051",218414,"NEWBERRY COLLEGE",1,0,1991,189,77,112,45,21,24,0.312,0.238,0.188,7400,9.040601,42,143,0.756613756613757
"11052",218414,"NEWBERRY COLLEGE",1,0,1992,177,82,95,36,16,20,0.244,0.203,0.168,7900,9.858377,46,136,0.768361581920904
"11053",218414,"NEWBERRY COLLEGE",1,0,1993,155,62,93,44,24,20,0.323,0.284,0.258,8594,10.116283,46,110,0.709677419354839
"11054",218414,"NEWBERRY COLLEGE",1,0,1995,166,70,96,50,19,31,0.443,0.301,0.198,10950,12.267861,50,125,0.753012048192771
"11055",218414,"NEWBERRY COLLEGE",1,0,1996,234,103,131,91,36,55,0.534,0.389,0.275,11510,13.269608,47,197,0.841880341880342
"11056",218414,"NEWBERRY COLLEGE",1,0,1997,161,52,109,41,22,19,0.365,0.255,0.202,12322,10.27345,46,130,0.807453416149068
"11057",218414,"NEWBERRY COLLEGE",1,0,1998,206,92,114,74,27,47,0.511,0.359,0.237,13062,9.98662,48,157,0.762135922330097
"11058",218414,"NEWBERRY COLLEGE",1,0,1999,179,70,109,59,18,41,0.586,0.33,0.165,13602,9.881399,48,139,0.776536312849162
"11059",218414,"NEWBERRY COLLEGE",1,0,2000,181,80,101,58,25,33,0.413,0.32,0.248,14282,10.289449,47,131,0.723756906077348
"11060",218414,"NEWBERRY COLLEGE",1,0,2001,178,70,108,55,26,29,0.414,0.309,0.241,15000,10.446321,46,129,0.724719101123595
"11061",218414,"NEWBERRY COLLEGE",1,0,2002,250,94,156,70,33,37,0.394,0.28,0.212,15800,10.962781,44,168,0.672
"11062",218414,"NEWBERRY COLLEGE",1,0,2003,203,69,134,64,36,28,0.406,0.315,0.269,16640,11.810702,43,145,0.714285714285714
"11063",218414,"NEWBERRY COLLEGE",1,0,2004,231,90,141,73,28,45,0.5,0.316,0.199,17470,13.339797,48,152,0.658008658008658
"11064",218414,"Newberry College",1,0,2005,275,96,179,67,34,33,0.344,0.244,0.19,18170,13.631159,51,178,0.647272727272727
"11065",218414,"Newberry College",1,0,2006,264,116,148,65,24,41,0.353,0.246,0.162,18900,15.950146,50,173,0.65530303030303
"11066",218414,"Newberry College",1,0,2007,323,122,201,88,41,47,0.385,0.272,0.204,19900,16.970595,55,227,0.702786377708978
"11067",218414,"Newberry College",1,0,2008,297,118,179,78,27,51,0.432,0.263,0.151,20500,18.982963,54,211,0.71043771043771
"11068",218414,"Newberry College",1,0,2009,342,133,209,84,32,52,0.391,0.246,0.153,20500,19.127339,52,221,0.646198830409357
"11069",218414,"Newberry College",1,0,2010,288,110,178,82,41,41,0.373,0.285,0.23,21500,21.041576,56,203,0.704861111111111
"11070",218663,"UNIVERSITY OF SOUTH CAROLINA AT COLUMBIA",1,0,1991,2591,1398,1193,643,242,401,0.287,0.248,0.203,2686,304.347444,1077,1972,0.761096101891162
"11071",218663,"UNIVERSITY OF SOUTH CAROLINA AT COLUMBIA",1,0,1992,2460,1312,1148,643,257,386,0.294,0.261,0.224,2818,306.831877,1059,1768,0.71869918699187
"11072",218663,"UNIVERSITY OF SOUTH CAROLINA AT COLUMBIA",1,0,1993,2298,1269,1029,681,246,435,0.343,0.296,0.239,3090,331.48288,1034,1681,0.731505657093124
"11073",218663,"UNIVERSITY OF SOUTH CAROLINA AT COLUMBIA",1,0,1995,2593,1477,1116,799,282,517,0.35,0.308,0.253,3280,371.307023,1018,1945,0.750096413420748
"11074",218663,"UNIVERSITY OF SOUTH CAROLINA AT COLUMBIA",1,0,1996,2635,1518,1117,857,289,568,0.374,0.325,0.259,3432,391.727705,1028,1921,0.729032258064516
"11075",218663,"UNIVERSITY OF SOUTH CAROLINA AT COLUMBIA",1,0,1997,2919,1596,1323,1065,393,672,0.421,0.365,0.297,3534,415.343829,1032,2220,0.760534429599178
"11076",218663,"UNIVERSITY OF SOUTH CAROLINA AT COLUMBIA",1,0,1998,2756,1553,1203,1098,398,700,0.451,0.398,0.331,3630,441.613792,1024,2038,0.739477503628447
"11077",218663,"UNIVERSITY OF SOUTH CAROLINA AT COLUMBIA",1,0,1999,2596,1511,1085,1073,367,706,0.467,0.413,0.338,3640,429.154031,1036,1915,0.737673343605547
"11078",218663,"UNIVERSITY OF SOUTH CAROLINA AT COLUMBIA",1,0,2000,2475,1394,1081,988,351,637,0.457,0.399,0.325,3768,507.90256,1021,1852,0.748282828282828
"11079",218663,"UNIVERSITY OF SOUTH CAROLINA AT COLUMBIA",1,0,2001,3227,1770,1457,1304,461,843,0.476,0.404,0.316,3964,531.483778,1006,2415,0.748373101952278
"11080",218663,"UNIVERSITY OF SOUTH CAROLINA AT COLUMBIA",1,0,2002,3500,1909,1591,1557,594,963,0.505,0.445,0.373,4784,512.702836,1015,2632,0.752
"11081",218663,"UNIVERSITY OF SOUTH CAROLINA-COLUMBIA",1,0,2003,3441,1949,1492,1578,586,992,0.509,0.459,0.393,5548,544.272676,1011,2580,0.749782040104621
"11082",218663,"UNIVERSITY OF SOUTH CAROLINA-COLUMBIA",1,0,2004,3330,1841,1489,1524,593,931,0.506,0.458,0.398,6156,563.672484,1043,2319,0.696396396396396
"11083",218663,"University of South Carolina-Columbia",1,0,2005,3677,2087,1590,1881,682,1199,0.575,0.512,0.429,6914,620.835159,1169,2769,0.753059559423443
"11084",218663,"University of South Carolina-Columbia",1,0,2006,3646,2084,1562,1932,702,1230,0.59,0.53,0.449,7408,665.256349,1163,2717,0.745200219418541
"11085",218663,"University of South Carolina-Columbia",1,0,2007,3690,2117,1573,1999,734,1265,0.598,0.542,0.467,7946,707.719872,1217,2995,0.811653116531165
"11086",218663,"University of South Carolina-Columbia",1,0,2008,3826,2133,1693,2129,812,1317,0.617,0.556,0.48,8438,751.506561,1201,2983,0.779665446941976
"11087",218663,"University of South Carolina-Columbia",1,0,2009,3881,2089,1792,2132,825,1307,0.626,0.549,0.46,8756,722.957692,1152,3232,0.832775057974749
"11088",218663,"University of South Carolina-Columbia",1,0,2010,4421,2431,1990,2400,911,1489,0.613,0.543,0.458,9386,728.956614,1178,3663,0.828545577923547
"11089",218724,"UNIVERSITY OF SOUTH CAROLINA AT COASTAL CAROLINA",1,0,1991,584,328,256,84,26,58,0.177,0.144,0.102,2020,24.90627,142,518,0.886986301369863
"11090",218724,"UNIVERSITY OF SOUTH CAROLINA AT COASTAL CAROLINA",1,0,1992,591,305,286,71,17,54,0.177,0.12,0.059,2170,25.854586,140,506,0.856175972927242
"11091",218724,"COASTAL CAROLINA UNIVERSITY",1,0,1993,732,379,353,86,26,60,0.158,0.117,0.074,2470,27.831498,143,635,0.867486338797814
"11092",218724,"COASTAL CAROLINA UNIVERSITY",1,0,1995,734,411,323,117,27,90,0.219,0.159,0.084,2800,32.33959,160,648,0.88283378746594
"11093",218724,"COASTAL CAROLINA UNIVERSITY",1,0,1996,823,408,415,120,44,76,0.186,0.146,0.106,2910,35.711497,164,713,0.866342648845686
"11094",218724,"COASTAL CAROLINA UNIVERSITY",1,0,1997,826,443,383,121,43,78,0.176,0.146,0.112,3030,38.589002,179,725,0.87772397094431
"11095",218724,"COASTAL CAROLINA UNIVERSITY",1,0,1998,855,468,387,150,53,97,0.207,0.175,0.137,3150,42.51287,180,757,0.885380116959064
"11096",218724,"COASTAL CAROLINA UNIVERSITY",1,0,1999,757,405,352,161,60,101,0.249,0.213,0.17,3270,45.609636,176,674,0.890356671070013
"11097",218724,"COASTAL CAROLINA UNIVERSITY",1,0,2000,784,434,350,157,57,100,0.23,0.2,0.163,3420,49.975779,178,687,0.876275510204082
"11098",218724,"COASTAL CAROLINA UNIVERSITY",1,0,2001,931,494,437,212,60,152,0.308,0.228,0.137,3690,54.176785,180,842,0.904403866809882
"11099",218724,"COASTAL CAROLINA UNIVERSITY",1,0,2002,1072,523,549,236,104,132,0.252,0.22,0.189,4430,51.847725,200,932,0.869402985074627
"11100",218724,"COASTAL CAROLINA UNIVERSITY",1,0,2003,1266,618,648,283,109,174,0.282,0.224,0.168,5270,60.227632,208,1076,0.849921011058452
"11101",218724,"COASTAL CAROLINA UNIVERSITY",1,0,2004,1320,669,651,288,104,184,0.275,0.218,0.16,6100,68.994299,220,1115,0.84469696969697
"11102",218724,"Coastal Carolina University",1,0,2005,1493,775,718,375,130,245,0.316,0.251,0.181,6780,75.804097,233,1284,0.860013395847287
"11103",218724,"Coastal Carolina University",1,0,2006,1466,810,656,420,144,276,0.341,0.286,0.22,7420,86.418258,248,1241,0.846521145975443
"11104",218724,"Coastal Carolina University",1,0,2007,1647,886,761,443,143,300,0.339,0.269,0.188,7520,95.049759,264,1363,0.827565270188221
"11105",218724,"Coastal Carolina University",1,0,2008,1641,835,806,422,157,265,0.317,0.257,0.195,8570,103.620388,299,1314,0.80073126142596
"11106",218724,"Coastal Carolina University",1,0,2009,1766,950,816,465,142,323,0.34,0.263,0.174,8870,112.246817,315,1353,0.766138165345413
"11107",218724,"Coastal Carolina University",1,0,2010,1996,1087,909,530,181,349,0.321,0.266,0.199,9310,118.644429,346,1437,0.719939879759519
"11108",218733,"SOUTH CAROLINA STATE COLLEGE",1,0,1991,888,486,402,85,17,68,0.14,0.096,0.042,2050,48.554086,224,9,0.0101351351351351
"11109",218733,"SOUTH CAROLINA STATE UNIVERSITY",1,0,1992,701,366,335,89,25,64,0.175,0.127,0.075,2200,51.212416,291,3,0.00427960057061341
"11110",218733,"SOUTH CAROLINA STATE UNIVERSITY",1,0,1993,613,329,284,80,20,60,0.182,0.131,0.07,2500,53.857807,255,3,0.00489396411092985
"11111",218733,"SOUTH CAROLINA STATE UNIVERSITY",1,0,1995,859,447,412,279,100,179,0.4,0.325,0.243,2550,56.082588,257,10,0.0116414435389988
"11112",218733,"SOUTH CAROLINA STATE UNIVERSITY",1,0,1996,801,452,349,159,24,135,0.299,0.199,0.069,2730,59.015469,249,3,0.00374531835205993
"11113",218733,"SOUTH CAROLINA STATE UNIVERSITY",1,0,1997,601,320,281,169,52,117,0.366,0.281,0.185,2974,65.542049,236,3,0.00499168053244592
"11114",218733,"SOUTH CAROLINA STATE UNIVERSITY",1,0,1998,739,428,311,186,50,136,0.318,0.252,0.161,3184,66.657161,217,4,0.0054127198917456
"11115",218733,"SOUTH CAROLINA STATE UNIVERSITY",1,0,1999,680,351,329,143,37,106,0.302,0.21,0.112,3410,67.914926,217,7,0.0102941176470588
"11116",218733,"SOUTH CAROLINA STATE UNIVERSITY",1,0,2000,571,307,264,170,48,122,0.397,0.298,0.182,3654,85.267453,218,2,0.00350262697022767
"11117",218733,"SOUTH CAROLINA STATE UNIVERSITY",1,0,2001,615,358,257,135,47,88,0.246,0.22,0.183,4096,79.496293,219,2,0.0032520325203252
"11118",218733,"SOUTH CAROLINA STATE UNIVERSITY",1,0,2002,717,401,316,174,45,129,0.322,0.243,0.142,2278,79.924171,218,4,0.00557880055788006
"11119",218733,"SOUTH CAROLINA STATE UNIVERSITY",1,0,2003,794,453,341,106,33,73,0.161,0.134,0.097,5570,79.924171,190,8,0.0100755667506297
"11120",218733,"SOUTH CAROLINA STATE UNIVERSITY",1,0,2004,945,523,422,164,41,123,0.235,0.174,0.097,6170,81.354199,211,5,0.00529100529100529
"11121",218733,"South Carolina State University",1,0,2005,1002,544,458,140,50,90,0.165,0.14,0.109,150,96.045622,202,4,0.00399201596806387
"11122",218733,"South Carolina State University",1,0,2006,870,458,412,134,49,85,0.186,0.154,0.119,514,100.951965,212,8,0.00919540229885057
"11123",218733,"South Carolina State University",1,0,2007,1292,652,640,177,59,118,0.181,0.137,0.092,550,111.901572,225,10,0.00773993808049536
"11124",218733,"South Carolina State University",1,0,2008,923,484,439,138,38,100,0.207,0.15,0.087,572,126.822841,228,9,0.00975081256771398
"11125",218733,"South Carolina State University",1,0,2009,713,358,355,106,37,69,0.193,0.149,0.104,624,124.361561,229,14,0.0196353436185133
"11126",218733,"South Carolina State University",1,0,2010,816,414,402,156,58,98,0.237,0.191,0.144,8328,119.568874,216,10,0.0122549019607843
"11127",218742,"UNIVERSITY OF SOUTH CAROLINA AT SPARTANBURG",1,0,1991,485,277,208,58,13,45,0.162,0.12,0.062,2020,19.55213,133,416,0.857731958762887
"11128",218742,"UNIVERSITY OF SOUTH CAROLINA AT SPARTANBURG",1,0,1992,399,240,159,56,16,40,0.167,0.14,0.101,2120,20.217523,135,332,0.832080200501253
"11129",218742,"UNIVERSITY OF SOUTH CAROLINA AT SPARTANBURG",1,0,1993,327,216,111,46,6,40,0.185,0.141,0.054,2320,21.26048,132,258,0.788990825688073
"11130",218742,"UNIVERSITY OF SOUTH CAROLINA AT SPARTANBURG",1,0,1995,427,264,163,66,15,51,0.193,0.155,0.092,2578,22.9267,130,338,0.791569086651054
"11131",218742,"UNIVERSITY OF SOUTH CAROLINA AT SPARTANBURG",1,0,1996,438,284,154,75,12,63,0.222,0.171,0.078,2808,25.71645,133,327,0.746575342465753
"11132",218742,"UNIVERSITY OF SOUTH CAROLINA AT SPARTANBURG",1,0,1997,539,327,212,81,18,63,0.193,0.15,0.085,2974,26.772426,136,390,0.723562152133581
"11133",218742,"UNIVERSITY OF SOUTH CAROLINA AT SPARTANBURG",1,0,1998,547,362,185,106,18,88,0.243,0.194,0.097,3118,30.176588,137,369,0.674588665447898
"11134",218742,"UNIVERSITY OF SOUTH CAROLINA AT SPARTANBURG",1,0,1999,540,334,206,87,24,63,0.189,0.161,0.117,3250,32.923722,138,355,0.657407407407407
"11135",218742,"UNIVERSITY OF SOUTH CAROLINA AT SPARTANBURG",1,0,2000,546,358,188,94,24,70,0.196,0.172,0.128,3494,35.643837,142.5,348,0.637362637362637
"11136",218742,"UNIVERSITY OF SOUTH CAROLINA AT SPARTANBURG",1,0,2001,573,350,223,107,36,71,0.203,0.187,0.161,3738,37.92566,147,334,0.582897033158813
"11137",218742,"UNIVERSITY OF SOUTH CAROLINA AT SPARTANBURG",1,0,2002,647,414,233,119,19,100,0.242,0.184,0.082,4598,38.938578,165,410,0.633693972179289
"11138",218742,"UNIVERSITY OF SOUTH CAROLINA-SPARTANBURG",1,0,2003,684,450,234,139,35,104,0.231,0.203,0.15,5310,45.093689,179,409,0.597953216374269
"11139",218742,"UNIVERSITY OF SOUTH CAROLINA UPSTATE",1,0,2004,643,398,245,145,51,94,0.236,0.226,0.208,5860,47.976008,180,408,0.63452566096423
"11140",218742,"University of South Carolina-Upstate",1,0,2005,718,469,249,153,41,112,0.239,0.213,0.165,6436,50.710835,183,382,0.532033426183844
"11141",218742,"University of South Carolina-Upstate",1,0,2006,781,497,284,166,42,124,0.25,0.213,0.148,6958,52.748411,196,429,0.549295774647887
"11142",218742,"University of South Carolina-Upstate",1,0,2007,805,488,317,191,54,137,0.281,0.237,0.17,7480,59.458774,206,458,0.568944099378882
"11143",218742,"University of South Carolina-Upstate",1,0,2008,708,455,253,164,47,117,0.257,0.232,0.186,8062,65.150327,214,382,0.53954802259887
"11144",218742,"University of South Carolina-Upstate",1,0,2009,837,540,297,219,63,156,0.289,0.262,0.212,8362,64.228786,206,474,0.566308243727599
"11145",218742,"University of South Carolina-Upstate",1,0,2010,838,559,279,200,54,146,0.261,0.239,0.194,8792,66.358245,206,461,0.550119331742243
"11146",218973,"WOFFORD COLLEGE",1,0,1991,295,117,178,217,124,93,0.795,0.736,0.697,9790,17.909337,63,264,0.894915254237288
"11147",218973,"WOFFORD COLLEGE",1,0,1992,287,132,155,206,113,93,0.705,0.718,0.729,10490,20.01568,63,250,0.871080139372822
"11148",218973,"WOFFORD COLLEGE",1,0,1993,273,109,164,210,117,93,0.853,0.769,0.713,11480,20.82517,64,248,0.908424908424908
"11149",218973,"WOFFORD COLLEGE",1,0,1995,286,140,146,219,99,120,0.857,0.766,0.678,13795,23.331698,65,263,0.91958041958042
"11150",218973,"WOFFORD COLLEGE",1,0,1996,291,132,159,204,106,98,0.742,0.701,0.667,14675,25.62907,67,266,0.914089347079038
"11151",218973,"WOFFORD COLLEGE",1,0,1997,296,139,157,210,102,108,0.777,0.709,0.65,15390,22.502115,67,262,0.885135135135135
"11152",218973,"WOFFORD COLLEGE",1,0,1998,298,145,153,224,113,111,0.765,0.752,0.739,16170,25.394237,68,263,0.88255033557047
"11153",218973,"WOFFORD COLLEGE",1,0,1999,307,154,153,226,112,114,0.74,0.736,0.732,16410,26.496739,72,269,0.876221498371335
"11154",218973,"WOFFORD COLLEGE",1,0,2000,308,150,158,222,104,118,0.787,0.721,0.658,17030,30.747775,73.5,280,0.909090909090909
"11155",218973,"WOFFORD COLLEGE",1,0,2001,303,152,151,218,100,118,0.776,0.719,0.662,17760,28.466803,75,269,0.887788778877888
"11156",218973,"WOFFORD COLLEGE",1,0,2002,297,170,127,234,95,139,0.818,0.788,0.748,19415,38.234431,79,267,0.898989898989899
"11157",218973,"WOFFORD COLLEGE",1,0,2003,330,163,167,255,127,128,0.785,0.773,0.76,20610,37.554752,82,284,0.860606060606061
"11158",218973,"WOFFORD COLLEGE",1,0,2004,323,144,179,253,129,124,0.861,0.783,0.721,22300,38.019697,81,293,0.907120743034056
"11159",218973,"Wofford College",1,0,2005,320,144,176,241,123,118,0.819,0.753,0.699,24130,40.120314,91,280,0.875
"11160",218973,"Wofford College",1,0,2006,377,191,186,299,139,160,0.838,0.793,0.747,26110,43.272977,99,329,0.872679045092838
"11161",218973,"Wofford College",1,0,2007,385,193,192,301,141,160,0.829,0.782,0.734,27830,43.461438,106,324,0.841558441558442
"11162",218973,"Wofford College",1,0,2008,415,203,212,296,140,156,0.768,0.713,0.66,29465,44.870683,111,364,0.87710843373494
"11163",218973,"Wofford College",1,0,2009,391,203,188,302,138,164,0.808,0.772,0.734,29240,49.515867,117,318,0.813299232736573
"11164",218973,"Wofford College",1,0,2010,429,202,227,334,173,161,0.797,0.779,0.762,30630,51.4535,116,357,0.832167832167832
"11165",219000,"AUGUSTANA COLLEGE",1,0,1991,323,221,102,151,41,110,0.498,0.467,0.402,9330,24.12612,106,306,0.947368421052632
"11166",219000,"AUGUSTANA COLLEGE",1,0,1992,347,228,119,162,48,114,0.5,0.467,0.403,9800,24.500595,109,334,0.962536023054755
"11167",219000,"AUGUSTANA COLLEGE",1,0,1993,306,208,98,128,25,103,0.495,0.418,0.255,10180,26.167664,108,299,0.977124183006536
"11168",219000,"AUGUSTANA COLLEGE",1,0,1995,372,242,130,168,52,116,0.479,0.452,0.4,11780,26.522677,116,363,0.975806451612903
"11169",219000,"AUGUSTANA COLLEGE",1,0,1996,383,244,139,190,55,135,0.553,0.496,0.396,12488,27.716925,121,374,0.976501305483029
"11170",219000,"AUGUSTANA COLLEGE",1,0,1997,326,209,117,171,53,118,0.565,0.525,0.453,12968,23.137652,119,318,0.975460122699387
"11171",219000,"AUGUSTANA COLLEGE",1,0,1998,403,257,146,213,61,152,0.591,0.529,0.418,13490,24.079806,121,393,0.975186104218362
"11172",219000,"AUGUSTANA COLLEGE",1,0,1999,469,314,155,231,65,166,0.529,0.493,0.419,13960,25.445447,118,463,0.987206823027719
"11173",219000,"AUGUSTANA COLLEGE",1,0,2000,460,286,174,222,76,146,0.51,0.483,0.437,14592,26.637709,115.5,453,0.984782608695652
"11174",219000,"AUGUSTANA COLLEGE",1,0,2001,416,276,140,214,58,156,0.565,0.514,0.414,15280,27.549877,113,404,0.971153846153846
"11175",219000,"AUGUSTANA COLLEGE",1,0,2002,416,259,157,208,74,134,0.517,0.5,0.471,15892,29.279914,108,405,0.973557692307692
"11176",219000,"AUGUSTANA COLLEGE",1,0,2003,424,281,143,217,61,156,0.555,0.512,0.427,16766,28.674608,106,409,0.964622641509434
"11177",219000,"AUGUSTANA COLLEGE",1,0,2004,392,231,161,197,70,127,0.55,0.503,0.435,17764,29.162617,109,377,0.961734693877551
"11178",219000,"Augustana College",1,0,2005,390,256,134,192,54,138,0.539,0.492,0.403,18634,30.312729,109,371,0.951282051282051
"11179",219000,"Augustana College",1,0,2006,442,282,160,228,64,164,0.582,0.516,0.4,19750,31.010789,111,420,0.950226244343891
"11180",219000,"Augustana College",1,0,2007,429,272,157,207,54,153,0.562,0.483,0.344,20932,34.224389,117,397,0.925407925407925
"11181",219000,"Augustana College",1,0,2008,426,292,134,211,50,161,0.551,0.495,0.373,22188,36.697729,119,396,0.929577464788732
"11182",219000,"Augustana College",1,0,2009,431,261,170,245,80,165,0.632,0.568,0.471,23276,38.733811,125,404,0.937354988399072
"11183",219000,"Augustana College",1,0,2010,418,276,142,226,55,171,0.62,0.541,0.387,24790,39.077763,132,371,0.88755980861244
"11184",219046,"BLACK HILLS STATE UNIVERSITY",1,0,1991,492,285,207,23,5,18,0.063,0.047,0.024,1770,17.515296,101,454,0.922764227642276
"11185",219046,"BLACK HILLS STATE UNIVERSITY",1,0,1992,1056,597,459,226,79,147,0.246,0.214,0.172,2126,18.430457,106,986,0.933712121212121
"11186",219046,"BLACK HILLS STATE UNIVERSITY",1,0,1993,1078,586,492,243,85,158,0.27,0.225,0.173,2220,20.080397,107,980,0.909090909090909
"11187",219046,"BLACK HILLS STATE UNIVERSITY",1,0,1995,435,234,201,33,8,25,0.107,0.076,0.04,2458,20.212732,107,408,0.937931034482759
"11188",219046,"BLACK HILLS STATE UNIVERSITY",1,0,1996,452,260,192,58,15,43,0.165,0.128,0.078,2502,19.751866,110,423,0.935840707964602
"11189",219046,"BLACK HILLS STATE UNIVERSITY",1,0,1997,451,227,224,38,8,30,0.132,0.084,0.036,2698,20.223999,110,416,0.922394678492239
"11190",219046,"BLACK HILLS STATE UNIVERSITY",1,0,1998,632,381,251,48,13,35,0.092,0.076,0.052,2920,22.33186,115,594,0.939873417721519
"11191",219046,"BLACK HILLS STATE UNIVERSITY",1,0,1999,630,360,270,71,17,54,0.15,0.113,0.063,3115,25.149769,114,604,0.958730158730159
"11192",219046,"BLACK HILLS STATE UNIVERSITY",1,0,2000,586,361,225,48,11,37,0.103,0.082,0.049,3630,26.157765,116.5,525,0.895904436860068
"11193",219046,"BLACK HILLS STATE UNIVERSITY",1,0,2001,565,354,211,65,27,38,0.107,0.115,0.128,1997,27.790596,119,491,0.869026548672566
"11194",219046,"BLACK HILLS STATE UNIVERSITY",1,0,2002,537,334,203,43,11,32,0.096,0.08,0.054,2080,28.020193,111,491,0.914338919925512
"11195",219046,"BLACK HILLS STATE UNIVERSITY",1,0,2003,653,409,244,62,17,45,0.11,0.095,0.07,2307,29.273203,114,580,0.888208269525268
"11196",219046,"BLACK HILLS STATE UNIVERSITY",1,0,2004,581,350,231,46,11,35,0.1,0.079,0.048,2371,31.255442,123,517,0.889845094664372
"11197",219046,"Black Hills State University",1,0,2005,584,353,231,74,22,52,0.147,0.127,0.095,2444,33.626103,124,477,0.816780821917808
"11198",219046,"Black Hills State University",1,0,2006,595,353,242,122,28,94,0.266,0.205,0.116,2540,34.568112,121,494,0.830252100840336
"11199",219046,"Black Hills State University",1,0,2007,472,268,204,51,14,37,0.138,0.108,0.069,2643,38.551895,127,411,0.870762711864407
"11200",219046,"Black Hills State University",1,0,2008,545,345,200,64,17,47,0.136,0.117,0.085,2822,40.40985,133,455,0.834862385321101
"11201",219046,"Black Hills State University",1,0,2009,540,308,232,85,23,62,0.201,0.157,0.099,2934,42.139467,134,473,0.875925925925926
"11202",219046,"Black Hills State University",1,0,2010,648,386,262,105,30,75,0.194,0.162,0.115,3194,42.877851,143,559,0.862654320987654
"11203",219082,"DAKOTA STATE UNIVERSITY",1,0,1991,209,110,99,9,2,7,0.064,0.043,0.02,1582,9.129926,54,195,0.933014354066986
"11204",219082,"DAKOTA STATE UNIVERSITY",1,0,1992,234,123,111,26,12,14,0.114,0.111,0.108,1653,10.207427,55,224,0.957264957264957
"11205",219082,"DAKOTA STATE UNIVERSITY",1,0,1993,208,116,92,14,2,12,0.103,0.067,0.022,1770,10.995956,59,200,0.961538461538462
"11206",219082,"DAKOTA STATE UNIVERSITY",1,0,1995,256,125,131,22,5,17,0.136,0.086,0.038,2585,11.210189,64,244,0.953125
"11207",219082,"DAKOTA STATE UNIVERSITY",1,0,1996,189,100,89,25,5,20,0.2,0.132,0.056,2607,12.250322,63,186,0.984126984126984
"11208",219082,"DAKOTA STATE UNIVERSITY",1,0,1997,249,135,114,1,1,0,0,0.004,0.009,2838,12.320974,65,239,0.959839357429719
"11209",219082,"DAKOTA STATE UNIVERSITY",1,0,1998,231,110,121,45,17,28,0.254,0.195,0.14,3301,13.879996,62,223,0.965367965367965
"11210",219082,"DAKOTA STATE UNIVERSITY",1,0,1999,306,124,182,45,21,24,0.194,0.147,0.115,1867,14.759764,72,288,0.941176470588235
"11211",219082,"DAKOTA STATE UNIVERSITY",1,0,2000,351,149,202,51,25,26,0.174,0.145,0.124,1935,16.458575,79,306,0.871794871794872
"11212",219082,"DAKOTA STATE UNIVERSITY",1,0,2001,292,123,169,54,28,26,0.211,0.185,0.166,1997,18.95004,86,267,0.914383561643836
"11213",219082,"DAKOTA STATE UNIVERSITY",1,0,2002,273,111,162,45,22,23,0.207,0.165,0.136,2080,21.565458,82,260,0.952380952380952
"11214",219082,"DAKOTA STATE UNIVERSITY",1,0,2003,290,120,170,43,18,25,0.208,0.148,0.106,2163,21.387943,79,254,0.875862068965517
"11215",219082,"DAKOTA STATE UNIVERSITY",1,0,2004,249,114,135,44,18,26,0.228,0.177,0.133,2223,22.189127,81,221,0.887550200803213
"11216",219082,"Dakota State University",1,0,2005,280,135,145,29,14,15,0.111,0.104,0.097,2290,24.251108,77,265,0.946428571428571
"11217",219082,"Dakota State University",1,0,2006,295,137,158,41,23,18,0.131,0.139,0.146,2382,23.90253,80,276,0.935593220338983
"11218",219082,"Dakota State University",1,0,2007,243,110,133,44,23,21,0.191,0.181,0.173,2478,24.974342,89,220,0.905349794238683
"11219",219082,"Dakota State University",1,0,2008,258,121,137,45,18,27,0.223,0.174,0.131,2646,26.479823,89,240,0.930232558139535
"11220",219082,"Dakota State University",1,0,2009,284,116,168,54,28,26,0.224,0.19,0.167,2751,28.661597,92,252,0.887323943661972
"11221",219082,"Dakota State University",1,0,2010,314,113,201,62,43,19,0.168,0.197,0.214,2994,31.858767,93,273,0.869426751592357
"11222",219198,"MOUNT MARTY COLLEGE",1,0,1991,126,95,31,38,8,30,0.316,0.302,0.258,6690,5.923169,40,114,0.904761904761905
"11223",219198,"MOUNT MARTY COLLEGE",1,0,1992,107,72,35,31,9,22,0.306,0.29,0.257,7078,6.979272,44,100,0.934579439252336
"11224",219198,"MOUNT MARTY COLLEGE",1,0,1993,117,96,21,39,9,30,0.312,0.333,0.429,7470,7.415085,39,112,0.957264957264957
"11225",219198,"MOUNT MARTY COLLEGE",1,0,1995,95,62,33,27,11,16,0.258,0.284,0.333,8196,8.576001,43,88,0.926315789473684
"11226",219198,"MOUNT MARTY COLLEGE",1,0,1996,117,77,40,42,11,31,0.403,0.359,0.275,8649,8.225183,39,108,0.923076923076923
"11227",219198,"MOUNT MARTY COLLEGE",1,0,1997,129,96,33,47,12,35,0.365,0.364,0.364,9168,8.19092,54,125,0.968992248062015
"11228",219198,"MOUNT MARTY COLLEGE",1,0,1998,126,85,41,44,13,31,0.365,0.349,0.317,9628,8.822153,33,123,0.976190476190476
"11229",219198,"MOUNT MARTY COLLEGE",1,0,1999,121,84,37,34,8,26,0.31,0.281,0.216,9248,9.44689,31,119,0.983471074380165
"11230",219198,"MOUNT MARTY COLLEGE",1,0,2000,154,97,57,46,21,25,0.258,0.299,0.368,9710,9.862531,34.5,146,0.948051948051948
"11231",219198,"MOUNT MARTY COLLEGE",1,0,2001,148,109,39,49,10,39,0.358,0.331,0.256,9942,11.405165,38,136,0.918918918918919
"11232",219198,"MOUNT MARTY COLLEGE",1,0,2002,137,104,33,44,7,37,0.356,0.321,0.212,11580,11.228505,45,134,0.978102189781022
"11233",219198,"MOUNT MARTY COLLEGE",1,0,2003,158,113,45,33,11,22,0.195,0.209,0.244,12506,12.679134,44,148,0.936708860759494
"11234",219198,"MOUNT MARTY COLLEGE",1,0,2004,150,111,39,51,13,38,0.342,0.34,0.333,13256,10.586617,50,138,0.92
"11235",219198,"Mount Marty College",1,0,2005,139,91,48,54,15,39,0.429,0.388,0.312,14050,11.221263,48,132,0.949640287769784
"11236",219198,"Mount Marty College",1,0,2006,127,92,35,57,14,43,0.467,0.449,0.4,14752,12.138248,49,119,0.937007874015748
"11237",219198,"Mount Marty College",1,0,2007,108,73,35,49,14,35,0.48,0.454,0.4,15638,12.620298,50,94,0.87037037037037
"11238",219198,"Mount Marty College",1,0,2008,136,88,48,66,20,46,0.523,0.485,0.417,16420,13.007102,54,125,0.919117647058823
"11239",219198,"Mount Marty College",1,0,2009,109,66,43,47,16,31,0.47,0.431,0.372,17078,12.862567,43,96,0.880733944954128
"11240",219198,"Mount Marty College",1,0,2010,120,64,56,48,17,31,0.484,0.4,0.304,18102,12.83341,42,107,0.891666666666667
"11241",219259,"NORTHERN STATE UNIVERSITY",1,0,1991,511,258,253,45,15,30,0.116,0.088,0.059,1835,18.031857,126,487,0.953033268101761
"11242",219259,"NORTHERN STATE UNIVERSITY",1,0,1992,587,313,274,60,20,40,0.128,0.102,0.073,1978,18.841971,102,568,0.96763202725724
"11243",219259,"NORTHERN STATE UNIVERSITY",1,0,1993,647,360,287,73,14,59,0.164,0.113,0.049,2120,19.991599,105,598,0.924265842349305
"11244",219259,"NORTHERN STATE UNIVERSITY",1,0,1995,574,343,231,75,19,56,0.163,0.131,0.082,2455,20.394184,123,544,0.947735191637631
"11245",219259,"NORTHERN STATE UNIVERSITY",1,0,1996,560,324,236,68,24,44,0.136,0.121,0.102,2526,20.661795,104,510,0.910714285714286
"11246",219259,"NORTHERN STATE UNIVERSITY",1,0,1997,539,321,218,83,22,61,0.19,0.154,0.101,2704,20.107814,105,502,0.931354359925789
"11247",219259,"NORTHERN STATE UNIVERSITY",1,0,1998,480,276,204,66,16,50,0.181,0.138,0.078,2842,21.263195,96,404,0.841666666666667
"11248",219259,"NORTHERN STATE UNIVERSITY",1,0,1999,523,303,220,69,15,54,0.178,0.132,0.068,1750,21.878032,90,440,0.841300191204589
"11249",219259,"NORTHERN STATE UNIVERSITY",1,0,2000,446,257,189,61,10,51,0.198,0.137,0.053,1812,23.681801,92.5,399,0.894618834080718
"11250",219259,"NORTHERN STATE UNIVERSITY",1,0,2001,409,244,165,61,14,47,0.193,0.149,0.085,1872,24.852053,95,363,0.887530562347188
"11251",219259,"NORTHERN STATE UNIVERSITY",1,0,2002,376,214,162,51,12,39,0.182,0.136,0.074,1950,26.440137,98,343,0.912234042553192
"11252",219259,"NORTHERN STATE UNIVERSITY",1,0,2003,380,210,170,59,16,43,0.205,0.155,0.094,2163,27.127744,98,297,0.781578947368421
"11253",219259,"NORTHERN STATE UNIVERSITY",1,0,2004,384,238,146,53,12,41,0.172,0.138,0.082,2223,27.613909,100,321,0.8359375
"11254",219259,"Northern State University",1,0,2005,368,197,171,47,13,34,0.173,0.128,0.076,2290,28.638193,94,329,0.894021739130435
"11255",219259,"Northern State University",1,0,2006,367,178,189,50,14,36,0.202,0.136,0.074,2382,28.94993,93,315,0.858310626702997
"11256",219259,"Northern State University",1,0,2007,340,203,137,70,15,55,0.271,0.206,0.109,2478,30.035081,92,302,0.888235294117647
"11257",219259,"Northern State University",1,0,2008,389,204,185,67,16,51,0.25,0.172,0.086,2646,31.537527,91,347,0.892030848329049
"11258",219259,"Northern State University",1,0,2009,317,197,120,65,16,49,0.249,0.205,0.133,2751,34.580155,96,273,0.861198738170347
"11259",219259,"Northern State University",1,0,2010,380,208,172,84,25,59,0.284,0.221,0.145,2994,35.577202,96,324,0.852631578947368
"11260",219356,"SOUTH DAKOTA STATE UNIVERSITY",1,0,1991,1306,657,649,189,77,112,0.17,0.145,0.119,2045,79.856335,355,1278,0.978560490045942
"11261",219356,"SOUTH DAKOTA STATE UNIVERSITY",1,0,1992,1495,701,794,293,112,181,0.258,0.196,0.141,2146,87.839336,354,1458,0.975250836120401
"11262",219356,"SOUTH DAKOTA STATE UNIVERSITY",1,0,1993,1670,831,839,320,128,192,0.231,0.192,0.153,2252,96.371273,367,1631,0.976646706586826
"11263",219356,"SOUTH DAKOTA STATE UNIVERSITY",1,0,1995,1659,813,846,359,135,224,0.276,0.216,0.16,2705,96.107272,375,1615,0.973477998794455
"11264",219356,"SOUTH DAKOTA STATE UNIVERSITY",1,0,1996,1481,733,748,303,129,174,0.237,0.205,0.172,2784,101.291777,367,1437,0.970290344361918
"11265",219356,"SOUTH DAKOTA STATE UNIVERSITY",1,0,1997,1531,741,790,346,130,216,0.292,0.226,0.165,2912,103.145561,361,1444,0.943174395819726
"11266",219356,"SOUTH DAKOTA STATE UNIVERSITY",1,0,1998,1510,766,744,384,147,237,0.309,0.254,0.198,3128,112.860757,371,1444,0.956291390728477
"11267",219356,"SOUTH DAKOTA STATE UNIVERSITY",1,0,1999,1457,714,743,342,127,215,0.301,0.235,0.171,1867,120.445632,355,1313,0.901166781056966
"11268",219356,"SOUTH DAKOTA STATE UNIVERSITY",1,0,2000,1446,740,706,327,129,198,0.268,0.226,0.183,1933,122.61015,350.5,1363,0.942600276625173
"11269",219356,"SOUTH DAKOTA STATE UNIVERSITY",1,0,2001,1495,751,744,316,105,211,0.281,0.211,0.141,1997,131.874849,346,1396,0.933779264214047
"11270",219356,"SOUTH DAKOTA STATE UNIVERSITY",1,0,2002,1767,864,903,348,140,208,0.241,0.197,0.155,2080,136.88842,367,1671,0.945670628183362
"11271",219356,"SOUTH DAKOTA STATE UNIVERSITY",1,0,2003,1993,957,1036,427,176,251,0.262,0.214,0.17,2307,145.235732,397,1881,0.943803311590567
"11272",219356,"SOUTH DAKOTA STATE UNIVERSITY",1,0,2004,1993,1011,982,485,194,291,0.288,0.243,0.198,2371,157.470833,408,1824,0.915203211239338
"11273",219356,"South Dakota State University",1,0,2005,1784,893,891,528,213,315,0.353,0.296,0.239,2443,170.118404,411,1646,0.922645739910314
"11274",219356,"South Dakota State University",1,0,2006,1833,922,911,484,173,311,0.337,0.264,0.19,2382,173.985776,423,1688,0.920894708128751
"11275",219356,"South Dakota State University",1,0,2007,1933,950,983,495,183,312,0.328,0.256,0.186,2478,188.308218,493,1764,0.912571132953958
"11276",219356,"South Dakota State University",1,0,2008,2008,987,1021,563,237,326,0.33,0.28,0.232,2646,207.866695,478,1886,0.939243027888446
"11277",219356,"South Dakota State University",1,0,2009,2043,1032,1011,602,247,355,0.344,0.295,0.244,2751,224.897436,476,1889,0.924620655898189
"11278",219356,"South Dakota State University",1,0,2010,2157,1051,1106,613,270,343,0.326,0.284,0.244,2994,241.09201,479,1985,0.920259619842374
"11279",219471,"UNIVERSITY OF SOUTH DAKOTA",1,0,1991,1150,661,489,223,78,145,0.219,0.194,0.16,1977,63.500907,329,1110,0.965217391304348
"11280",219471,"UNIVERSITY OF SOUTH DAKOTA",1,0,1992,1228,686,542,239,79,160,0.233,0.195,0.146,2073,70.357188,345,1153,0.938925081433225
"11281",219471,"UNIVERSITY OF SOUTH DAKOTA",1,0,1993,1227,704,523,247,79,168,0.239,0.201,0.151,2294,76.307124,361,1166,0.950285248573757
"11282",219471,"UNIVERSITY OF SOUTH DAKOTA",1,0,1995,1160,660,500,224,60,164,0.249,0.193,0.12,2803,78.902286,339,1095,0.943965517241379
"11283",219471,"UNIVERSITY OF SOUTH DAKOTA",1,0,1996,875,489,386,175,62,113,0.231,0.2,0.161,2885,83.019531,318,833,0.952
"11284",219471,"UNIVERSITY OF SOUTH DAKOTA",1,0,1997,896,503,393,213,80,133,0.264,0.238,0.204,2918,80.101903,328,842,0.939732142857143
"11285",219471,"UNIVERSITY OF SOUTH DAKOTA",1,0,1998,894,500,394,180,58,122,0.244,0.201,0.147,3216,86.745775,323,824,0.921700223713647
"11286",219471,"UNIVERSITY OF SOUTH DAKOTA",1,0,1999,868,493,375,176,53,123,0.25,0.203,0.141,1867,89.187424,322,781,0.899769585253456
"11287",219471,"UNIVERSITY OF SOUTH DAKOTA",1,0,2000,918,504,414,199,62,137,0.272,0.217,0.15,1933,90.373426,297,811,0.883442265795207
"11288",219471,"UNIVERSITY OF SOUTH DAKOTA",1,0,2001,932,578,354,196,45,151,0.261,0.21,0.127,1997,96.471169,272,843,0.90450643776824
"11289",219471,"UNIVERSITY OF SOUTH DAKOTA",1,0,2002,976,544,432,186,74,112,0.206,0.191,0.171,2080,100.472528,312,876,0.897540983606557
"11290",219471,"UNIVERSITY OF SOUTH DAKOTA",1,0,2003,982,539,443,186,76,110,0.204,0.189,0.172,2307,109.739793,327,855,0.870672097759674
"11291",219471,"UNIVERSITY OF SOUTH DAKOTA",1,0,2004,945,538,407,220,80,140,0.26,0.233,0.197,2371,115.395513,336,841,0.88994708994709
"11292",219471,"University of South Dakota",1,0,2005,1030,621,409,236,74,162,0.261,0.229,0.181,2443,123.355714,285,908,0.881553398058252
"11293",219471,"University of South Dakota",1,0,2006,1109,674,435,237,88,149,0.221,0.214,0.202,2541,126.192875,287,998,0.899909828674482
"11294",219471,"University of South Dakota",1,0,2007,1030,612,418,282,105,177,0.289,0.274,0.251,2643,145.156773,254,810,0.786407766990291
"11295",219471,"University of South Dakota",1,0,2008,1023,597,426,295,111,184,0.308,0.288,0.261,2646,151.72046,310,835,0.81622678396872
"11296",219471,"University of South Dakota",1,0,2009,971,559,412,286,91,195,0.349,0.295,0.221,2751,153.248035,309,791,0.814624098867147
"11297",219471,"University of South Dakota",1,0,2010,1034,622,412,313,114,199,0.32,0.303,0.277,2994,162.124744,299,840,0.812379110251451
"11298",219602,"AUSTIN PEAY STATE UNIVERSITY",1,0,1991,771,492,279,70,14,56,0.114,0.091,0.05,1628,36.290052,208,563,0.730220492866407
"11299",219602,"AUSTIN PEAY STATE UNIVERSITY",1,0,1992,752,471,281,164,46,118,0.25,0.218,0.164,1726,37.591529,229,577,0.767287234042553
"11300",219602,"AUSTIN PEAY STATE UNIVERSITY",1,0,1993,788,474,314,152,50,102,0.215,0.193,0.159,1800,43.317422,253,587,0.74492385786802
"11301",219602,"AUSTIN PEAY STATE UNIVERSITY",1,0,1995,776,457,319,105,26,79,0.173,0.135,0.082,1946,49.310878,268,591,0.76159793814433
"11302",219602,"AUSTIN PEAY STATE UNIVERSITY",1,0,1996,777,498,279,156,38,118,0.237,0.201,0.136,2108,50.882681,276,609,0.783783783783784
"11303",219602,"AUSTIN PEAY STATE UNIVERSITY",1,0,1997,788,503,285,144,40,104,0.207,0.183,0.14,2280,51.86845,272,595,0.75507614213198
"11304",219602,"AUSTIN PEAY STATE UNIVERSITY",1,0,1998,846,518,328,76,20,56,0.108,0.09,0.061,2470,53.433232,267,612,0.723404255319149
"11305",219602,"AUSTIN PEAY STATE UNIVERSITY",1,0,1999,715,432,283,66,22,44,0.102,0.092,0.078,2584,58.788625,269,506,0.707692307692308
"11306",219602,"AUSTIN PEAY STATE UNIVERSITY",1,0,2000,870,554,316,101,29,72,0.13,0.116,0.092,2222,61.06747,275,630,0.724137931034483
"11307",219602,"AUSTIN PEAY STATE UNIVERSITY",1,0,2001,900,569,331,77,20,57,0.1,0.086,0.06,2556,63.052656,281,642,0.713333333333333
"11308",219602,"AUSTIN PEAY STATE UNIVERSITY",1,0,2002,986,636,350,126,37,89,0.14,0.128,0.106,2748,67.43336,269,662,0.671399594320487
"11309",219602,"AUSTIN PEAY STATE UNIVERSITY",1,0,2003,967,609,358,118,33,85,0.14,0.122,0.092,3132,67.785126,261,677,0.700103412616339
"11310",219602,"AUSTIN PEAY STATE UNIVERSITY",1,0,2004,1196,714,482,173,64,109,0.153,0.145,0.133,3352,70.348339,262,837,0.699832775919732
"11311",219602,"Austin Peay State University",1,0,2005,1226,708,518,175,70,105,0.148,0.143,0.135,3678,79.50216,290,869,0.708809135399674
"11312",219602,"Austin Peay State University",1,0,2006,1210,731,479,188,56,132,0.181,0.155,0.117,3828,85.589343,294,809,0.668595041322314
"11313",219602,"Austin Peay State University",1,0,2007,1188,683,505,178,55,123,0.18,0.15,0.109,4058,95.595163,286,739,0.622053872053872
"11314",219602,"Austin Peay State University",1,0,2008,1326,806,520,208,70,138,0.171,0.157,0.135,4302,106.999483,302,858,0.647058823529412
"11315",219602,"Austin Peay State University",1,0,2009,1465,897,568,214,74,140,0.156,0.146,0.13,4584,109.969629,310,1038,0.708532423208191
"11316",219602,"Austin Peay State University",1,0,2010,1478,903,575,252,88,164,0.182,0.171,0.153,4824,112.330096,327,981,0.663734776725304
"11317",219709,"BELMONT UNIVERSITY",1,0,1991,238,146,92,68,21,47,0.322,0.286,0.228,6100,20.657121,132,223,0.936974789915966
"11318",219709,"BELMONT UNIVERSITY",1,0,1992,285,158,127,93,41,52,0.329,0.326,0.323,6480,24.326694,132,264,0.926315789473684
"11319",219709,"BELMONT UNIVERSITY",1,0,1993,328,182,146,137,58,79,0.434,0.418,0.397,7300,27.419394,150,307,0.935975609756098
"11320",219709,"BELMONT UNIVERSITY",1,0,1995,347,221,126,14,3,11,0.05,0.04,0.024,8750,32.630225,154,313,0.902017291066282
"11321",219709,"BELMONT UNIVERSITY",1,0,1996,418,262,156,185,66,119,0.454,0.443,0.423,9500,35.203853,158,389,0.930622009569378
"11322",219709,"BELMONT UNIVERSITY",1,0,1997,399,248,151,197,67,130,0.524,0.494,0.444,10300,40.278942,164,365,0.914786967418546
"11323",219709,"BELMONT UNIVERSITY",1,0,1998,413,254,159,201,73,128,0.504,0.487,0.459,11050,44.292064,187,377,0.912832929782082
"11324",219709,"BELMONT UNIVERSITY",1,0,1999,487,300,187,266,91,175,0.583,0.546,0.487,11300,43.672805,184,447,0.917864476386037
"11325",219709,"BELMONT UNIVERSITY",1,0,2000,516,309,207,278,108,170,0.55,0.539,0.522,11990,43.4297,175,479,0.928294573643411
"11326",219709,"BELMONT UNIVERSITY",1,0,2001,502,309,193,284,121,163,0.527,0.566,0.627,13040,47.852266,166,455,0.906374501992032
"11327",219709,"BELMONT UNIVERSITY",1,0,2002,524,320,204,264,91,173,0.541,0.504,0.446,13690,53.089186,195,476,0.908396946564885
"11328",219709,"BELMONT UNIVERSITY",1,0,2003,599,360,239,312,110,202,0.561,0.521,0.46,15164,55.105276,208,555,0.926544240400668
"11329",219709,"BELMONT UNIVERSITY",1,0,2004,727,442,285,429,168,261,0.591,0.59,0.589,15360,63.719038,203,661,0.909215955983494
"11330",219709,"Belmont University",1,0,2005,791,488,303,483,180,303,0.621,0.611,0.594,16360,69.638784,214,715,0.903919089759798
"11331",219709,"Belmont University",1,0,2006,763,439,324,422,160,262,0.597,0.553,0.494,17470,75.545161,227,679,0.889908256880734
"11332",219709,"Belmont University",1,0,2007,799,453,346,449,187,262,0.578,0.562,0.54,18780,79.768477,243,706,0.88360450563204
"11333",219709,"Belmont University",1,0,2008,928,519,409,520,217,303,0.584,0.56,0.531,20070,93.622312,273,800,0.862068965517241
"11334",219709,"Belmont University",1,0,2009,986,558,428,561,222,339,0.608,0.569,0.519,21770,102.875904,276,870,0.882352941176471
"11335",219709,"Belmont University",1,0,2010,1013,581,432,597,247,350,0.602,0.589,0.572,22530,103.408923,290,877,0.865745310957552
"11336",219718,"BETHEL COLLEGE",1,0,1991,107,68,39,12,6,6,0.088,0.112,0.154,4350,5.152243,25,98,0.91588785046729
"11337",219718,"BETHEL COLLEGE",1,0,1992,104,65,39,12,6,6,0.092,0.115,0.154,5250,5.205393,26,86,0.826923076923077
"11338",219718,"BETHEL COLLEGE",1,0,1993,125,43,82,15,4,11,0.256,0.12,0.049,6200,6.064687,27,97,0.776
"11339",219718,"BETHEL COLLEGE",1,0,1995,149,52,97,17,5,12,0.231,0.114,0.052,7000,6.302309,28,125,0.838926174496644
"11340",219718,"BETHEL COLLEGE",1,0,1996,180,82,98,24,6,18,0.22,0.133,0.061,6990,7.303909,29,156,0.866666666666667
"11341",219718,"BETHEL COLLEGE",1,0,1997,65,26,39,8,2,6,0.231,0.123,0.051,6990,7.005585,30,60,0.923076923076923
"11342",219718,"BETHEL COLLEGE",1,0,1998,82,29,53,16,6,10,0.345,0.195,0.113,6990,7.088196,35,70,0.853658536585366
"11343",219718,"BETHEL COLLEGE",1,0,1999,142,42,100,17,10,7,0.167,0.12,0.1,7800,8.598689,34,110,0.774647887323944
"11344",219718,"BETHEL COLLEGE",1,0,2000,137,44,93,17,7,10,0.227,0.124,0.075,7860,9.969952,35.5,104,0.759124087591241
"11345",219718,"BETHEL COLLEGE",1,0,2001,141,63,78,21,3,18,0.286,0.149,0.038,8180,11.544378,37,103,0.730496453900709
"11346",219718,"BETHEL COLLEGE",1,0,2002,139,53,86,16,5,11,0.208,0.115,0.058,8180,13.819414,38,85,0.611510791366906
"11347",219718,"BETHEL COLLEGE",1,0,2003,129,59,70,27,10,17,0.288,0.209,0.143,9360,16.05358,36,90,0.697674418604651
"11348",219718,"BETHEL COLLEGE",1,0,2004,252,97,155,40,15,25,0.258,0.159,0.097,9360,18.618417,58,149,0.591269841269841
"11349",219718,"Bethel College",1,0,2005,234,108,126,29,9,20,0.185,0.124,0.071,10016,22.347585,66,139,0.594017094017094
"11350",219718,"Bethel College",1,0,2006,243,94,149,26,13,13,0.138,0.107,0.087,10516,26.10079,61,144,0.592592592592593
"11351",219718,"Bethel College",1,0,2007,255,115,140,27,13,14,0.122,0.106,0.093,11040,23.534141,84,145,0.568627450980392
"11352",219718,"Bethel College",1,0,2008,268,122,146,57,19,38,0.312,0.213,0.13,11592,26.119732,87,168,0.626865671641791
"11353",219718,"Bethel University",1,0,2009,351,151,200,90,36,54,0.358,0.256,0.18,11592,29.951844,97,195,0.555555555555556
"11354",219718,"Bethel University",1,0,2010,377,133,244,51,27,24,0.181,0.135,0.111,12288,34.035022,110,265,0.702917771883289
"11355",219949,"CUMBERLAND UNIVERSITY",1,0,1991,165,88,77,26,13,13,0.148,0.158,0.169,4700,4.996815,31,153,0.927272727272727
"11356",219949,"CUMBERLAND UNIVERSITY",1,0,1992,173,80,93,40,18,22,0.275,0.231,0.194,5000,5.265942,32,147,0.84971098265896
"11357",219949,"CUMBERLAND UNIVERSITY",1,0,1993,169,106,63,37,6,31,0.292,0.219,0.095,5500,6.082368,33,134,0.792899408284024
"11358",219949,"CUMBERLAND UNIVERSITY",1,0,1995,171,64,107,38,17,21,0.328,0.222,0.159,6950,7.916141,63,137,0.801169590643275
"11359",219949,"CUMBERLAND UNIVERSITY",1,0,1996,154,78,76,37,10,27,0.346,0.24,0.132,7440,9.235819,66,128,0.831168831168831
"11360",219949,"CUMBERLAND UNIVERSITY",1,0,1997,186,91,95,42,10,32,0.352,0.226,0.105,8590,10.993691,66,149,0.801075268817204
"11361",219949,"CUMBERLAND UNIVERSITY",1,0,1998,236,111,125,44,8,36,0.324,0.186,0.064,9000,12.842366,55,197,0.834745762711864
"11362",219949,"CUMBERLAND UNIVERSITY",1,0,1999,174,67,107,36,19,17,0.254,0.207,0.178,9850,14.55596,52,141,0.810344827586207
"11363",219949,"CUMBERLAND UNIVERSITY",1,0,2000,189,78,111,28,9,19,0.244,0.148,0.081,10530,11.738123,58,145,0.767195767195767
"11364",219949,"CUMBERLAND UNIVERSITY",1,0,2001,200,92,108,39,15,24,0.261,0.195,0.139,10950,12.906791,64,164,0.82
"11365",219949,"CUMBERLAND UNIVERSITY",1,0,2002,164,74,90,35,6,29,0.392,0.213,0.067,11660,13.040698,70,128,0.780487804878049
"11366",219949,"CUMBERLAND UNIVERSITY",1,0,2003,149,76,73,24,9,15,0.197,0.161,0.123,12130,13.396581,63,113,0.758389261744966
"11367",219949,"CUMBERLAND UNIVERSITY",1,0,2004,203,104,99,37,15,22,0.212,0.182,0.152,12130,13.533703,54,159,0.783251231527094
"11368",219949,"Cumberland University",1,0,2005,217,107,110,44,17,27,0.252,0.203,0.155,13344,14.379162,50,178,0.820276497695853
"11369",219949,"Cumberland University",1,0,2006,189,75,114,34,8,26,0.347,0.18,0.07,14010,15.010919,48,138,0.73015873015873
"11370",219949,"Cumberland University",1,0,2007,210,75,135,43,22,21,0.28,0.205,0.163,14710,15.474511,40,158,0.752380952380952
"11371",219949,"Cumberland University",1,0,2008,194,82,112,43,20,23,0.28,0.222,0.179,15820,16.411147,36,154,0.793814432989691
"11372",219949,"Cumberland University",1,0,2009,200,101,99,62,25,37,0.366,0.31,0.253,16530,17.135262,39,160,0.8
"11373",219949,"Cumberland University",1,0,2010,163,67,96,56,29,27,0.403,0.344,0.302,17356,17.990519,48,130,0.797546012269939
"11374",220075,"EAST TENNESSEE STATE UNIVERSITY",1,0,1991,1599,950,649,149,47,102,0.107,0.093,0.072,1456,100.619274,450,1481,0.92620387742339
"11375",220075,"EAST TENNESSEE STATE UNIVERSITY",1,0,1992,1610,971,639,150,37,113,0.116,0.093,0.058,1554,106.13694,474,1450,0.900621118012422
"11376",220075,"EAST TENNESSEE STATE UNIVERSITY",1,0,1993,1289,757,532,128,51,77,0.102,0.099,0.096,1680,116.070983,486,1159,0.899146625290923
"11377",220075,"EAST TENNESSEE STATE UNIVERSITY",1,0,1995,1505,867,638,178,59,119,0.137,0.118,0.092,1878,135.472106,496,1371,0.910963455149502
"11378",220075,"EAST TENNESSEE STATE UNIVERSITY",1,0,1996,1532,894,638,186,62,124,0.139,0.121,0.097,1928,146.474484,442,1392,0.908616187989556
"11379",220075,"EAST TENNESSEE STATE UNIVERSITY",1,0,1997,1487,853,634,192,70,122,0.143,0.129,0.11,2100,154.380282,481,1339,0.900470746469402
"11380",220075,"EAST TENNESSEE STATE UNIVERSITY",1,0,1998,1507,880,627,204,64,140,0.159,0.135,0.102,2384,164.613607,482,1357,0.900464499004645
"11381",220075,"EAST TENNESSEE STATE UNIVERSITY",1,0,1999,1466,821,645,217,62,155,0.189,0.148,0.096,2020,177.652282,476,1313,0.895634379263301
"11382",220075,"EAST TENNESSEE STATE UNIVERSITY",1,0,2000,1483,824,659,244,73,171,0.208,0.165,0.111,2222,174.512558,474.5,1321,0.890761968981794
"11383",220075,"EAST TENNESSEE STATE UNIVERSITY",1,0,2001,1472,838,634,255,79,176,0.21,0.173,0.125,2556,206.12221,473,1322,0.898097826086957
"11384",220075,"EAST TENNESSEE STATE UNIVERSITY",1,0,2002,1473,831,642,262,76,186,0.224,0.178,0.118,2748,200.972045,490,1325,0.899524779361847
"11385",220075,"EAST TENNESSEE STATE UNIVERSITY",1,0,2003,1563,921,642,301,99,202,0.219,0.193,0.154,3132,205.584799,500,1433,0.916826615483045
"11386",220075,"EAST TENNESSEE STATE UNIVERSITY",1,0,2004,1479,846,633,259,76,183,0.216,0.175,0.12,3352,204.04297,462,1311,0.886409736308316
"11387",220075,"East Tennessee State University",1,0,2005,1565,897,668,308,102,206,0.23,0.197,0.153,3678,219.625382,469,1404,0.897124600638978
"11388",220075,"East Tennessee State University",1,0,2006,1712,966,746,279,106,173,0.179,0.163,0.142,3828,234.510343,479,1495,0.873247663551402
"11389",220075,"East Tennessee State University",1,0,2007,1918,1063,855,330,110,220,0.207,0.172,0.129,4058,247.158316,499,1669,0.870177267987487
"11390",220075,"East Tennessee State University",1,0,2008,1932,1069,863,380,133,247,0.231,0.197,0.154,4302,276.595688,505,1665,0.861801242236025
"11391",220075,"East Tennessee State University",1,0,2009,2063,1144,919,415,146,269,0.235,0.201,0.159,4584,291.493653,516,1785,0.865244789142026
"11392",220075,"East Tennessee State University",1,0,2010,2052,1165,887,406,147,259,0.222,0.198,0.166,4824,297.431531,536,1714,0.835282651072125
"11393",220215,"FREED-HARDEMAN UNIVERSITY",1,0,1991,295,147,148,80,38,42,0.286,0.271,0.257,5040,14.260591,70,275,0.932203389830508
"11394",220215,"FREED-HARDEMAN UNIVERSITY",1,0,1992,286,156,130,92,32,60,0.385,0.322,0.246,5560,14.583932,65,269,0.940559440559441
"11395",220215,"FREED-HARDEMAN UNIVERSITY",1,0,1993,296,169,127,83,31,52,0.308,0.28,0.244,5605,15.372086,75,276,0.932432432432432
"11396",220215,"FREED-HARDEMAN UNIVERSITY",1,0,1995,294,170,124,90,37,53,0.312,0.306,0.298,6620,17.101661,79,279,0.948979591836735
"11397",220215,"FREED-HARDEMAN UNIVERSITY",1,0,1996,314,194,120,107,30,77,0.397,0.341,0.25,7120,18.140125,83,298,0.949044585987261
"11398",220215,"FREED-HARDEMAN UNIVERSITY",1,0,1997,294,181,113,100,40,60,0.332,0.34,0.354,7524,15.274645,84,279,0.948979591836735
"11399",220215,"FREED-HARDEMAN UNIVERSITY",1,0,1998,358,199,159,116,53,63,0.317,0.324,0.333,7894,15.66514,87,339,0.946927374301676
"11400",220215,"FREED-HARDEMAN UNIVERSITY",1,0,1999,322,187,135,125,59,66,0.353,0.388,0.437,7328,19.805562,95,287,0.891304347826087
"11401",220215,"FREED-HARDEMAN UNIVERSITY",1,0,2000,357,198,159,132,60,72,0.364,0.37,0.377,7696,22.777371,94,336,0.941176470588235
"11402",220215,"FREED-HARDEMAN UNIVERSITY",1,0,2001,346,191,155,146,58,88,0.461,0.422,0.374,8080,23.783654,93,317,0.916184971098266
"11403",220215,"FREED-HARDEMAN UNIVERSITY",1,0,2002,414,231,183,181,73,108,0.468,0.437,0.399,8568,25.144579,94,385,0.929951690821256
"11404",220215,"FREED-HARDEMAN UNIVERSITY",1,0,2003,374,211,163,138,53,85,0.403,0.369,0.325,9300,26.745,97,347,0.927807486631016
"11405",220215,"FREED-HARDEMAN UNIVERSITY",1,0,2004,371,205,166,145,54,91,0.444,0.391,0.325,10080,28.647074,99,342,0.921832884097035
"11406",220215,"Freed-Hardeman University",1,0,2005,373,203,170,139,61,78,0.384,0.373,0.359,10500,31.057661,106,340,0.911528150134048
"11407",220215,"Freed-Hardeman University",1,0,2006,358,206,152,145,48,97,0.471,0.405,0.316,11100,34.224788,112,331,0.924581005586592
"11408",220215,"Freed-Hardeman University",1,0,2007,385,222,163,148,58,90,0.405,0.384,0.356,11100,35.027312,108,346,0.898701298701299
"11409",220215,"Freed-Hardeman University",1,0,2008,405,220,185,154,61,93,0.423,0.38,0.33,11700,36.19703,113,368,0.908641975308642
"11410",220215,"Freed-Hardeman University",1,0,2009,405,240,165,177,72,105,0.438,0.437,0.436,12060,37.149297,106,358,0.883950617283951
"11411",220215,"Freed-Hardeman University",1,0,2010,370,214,156,164,62,102,0.477,0.443,0.397,12840,34.897339,97,328,0.886486486486487
"11412",220613,"LEE COLLEGE",1,0,1991,368,185,183,62,24,38,0.205,0.168,0.131,4418,13.62484,73,336,0.91304347826087
"11413",220613,"LEE COLLEGE",1,0,1992,359,207,152,63,20,43,0.208,0.175,0.132,4282,14.421178,75,278,0.774373259052925
"11414",220613,"LEE COLLEGE",1,0,1993,395,205,190,87,37,50,0.244,0.22,0.195,4560,15.881982,74,337,0.853164556962025
"11415",220613,"LEE COLLEGE",1,0,1995,493,287,206,115,37,78,0.272,0.233,0.18,5132,17.656985,94,479,0.971602434077079
"11416",220613,"LEE COLLEGE",1,0,1996,525,304,221,128,45,83,0.273,0.244,0.204,5472,20.304452,87,504,0.96
"11417",220613,"LEE UNIVERSITY",1,0,1997,655,379,276,149,50,99,0.261,0.227,0.181,5636,23.215392,94,627,0.957251908396947
"11418",220613,"LEE UNIVERSITY",1,0,1998,722,417,305,193,62,131,0.314,0.267,0.203,5966,24.896337,99,640,0.886426592797784
"11419",220613,"LEE UNIVERSITY",1,0,1999,690,400,290,213,80,133,0.332,0.309,0.276,6118,27.74747,119,626,0.907246376811594
"11420",220613,"LEE UNIVERSITY",1,0,2000,711,435,276,204,72,132,0.303,0.287,0.261,6700,31.771151,125.5,594,0.835443037974684
"11421",220613,"LEE UNIVERSITY",1,0,2001,663,405,258,204,57,147,0.363,0.308,0.221,7336,29.285298,132,588,0.886877828054299
"11422",220613,"LEE UNIVERSITY",1,0,2002,705,423,282,195,60,135,0.319,0.277,0.213,8040,31.970058,133,610,0.865248226950355
"11423",220613,"LEE UNIVERSITY",1,0,2003,646,393,253,197,66,131,0.333,0.305,0.261,8520,35.345508,152,548,0.848297213622291
"11424",220613,"LEE UNIVERSITY",1,0,2004,723,430,293,223,67,156,0.363,0.308,0.229,8950,38.473194,142,621,0.858921161825726
"11425",220613,"Lee University",1,0,2005,755,454,301,297,99,198,0.436,0.393,0.329,9400,40.047494,168,629,0.833112582781457
"11426",220613,"Lee University",1,0,2006,810,473,337,270,77,193,0.408,0.333,0.228,9888,44.124462,169,648,0.8
"11427",220613,"Lee University",1,0,2007,783,437,346,271,88,183,0.419,0.346,0.254,10392,47.141815,174,624,0.796934865900383
"11428",220613,"Lee University",1,0,2008,848,501,347,333,103,230,0.459,0.393,0.297,10824,49.241492,160,705,0.831367924528302
"11429",220613,"Lee University",1,0,2009,829,507,322,288,80,208,0.41,0.347,0.248,11100,50.610343,148,692,0.834740651387214
"11430",220613,"Lee University",1,0,2010,851,494,357,288,93,195,0.395,0.338,0.261,11660,51.085315,161,678,0.796709753231492
"11431",220631,"LINCOLN MEMORIAL UNIVERSITY",1,0,1991,311,209,102,126,40,86,0.412,0.405,0.392,4790,11.438653,55,290,0.932475884244373
"11432",220631,"LINCOLN MEMORIAL UNIVERSITY",1,0,1992,328,207,121,127,47,80,0.386,0.387,0.388,5250,12.426145,61,302,0.920731707317073
"11433",220631,"LINCOLN MEMORIAL UNIVERSITY",1,0,1993,217,134,83,59,23,36,0.269,0.272,0.277,5530,12.421374,69,197,0.907834101382488
"11434",220631,"LINCOLN MEMORIAL UNIVERSITY",1,0,1995,204,131,73,31,9,22,0.168,0.152,0.123,6550,12.876442,70,185,0.906862745098039
"11435",220631,"LINCOLN MEMORIAL UNIVERSITY",1,0,1996,212,134,78,58,23,35,0.261,0.274,0.295,6950,12.873655,72,186,0.877358490566038
"11436",220631,"LINCOLN MEMORIAL UNIVERSITY",1,0,1997,134,88,46,39,15,24,0.273,0.291,0.326,7400,12.696345,72,110,0.82089552238806
"11437",220631,"LINCOLN MEMORIAL UNIVERSITY",1,0,1998,179,122,57,31,10,21,0.172,0.173,0.175,8100,12.922259,77,156,0.871508379888268
"11438",220631,"LINCOLN MEMORIAL UNIVERSITY",1,0,1999,113,80,33,35,9,26,0.325,0.31,0.273,8520,13.770334,74,102,0.902654867256637
"11439",220631,"LINCOLN MEMORIAL UNIVERSITY",1,0,2000,168,104,64,50,21,29,0.279,0.298,0.328,9600,14.188035,76.5,146,0.869047619047619
"11440",220631,"LINCOLN MEMORIAL UNIVERSITY",1,0,2001,153,101,52,34,12,22,0.218,0.222,0.231,10800,15.281064,79,124,0.810457516339869
"11441",220631,"LINCOLN MEMORIAL UNIVERSITY",1,0,2002,151,109,42,33,8,25,0.229,0.219,0.19,11760,14.664559,80,135,0.894039735099338
"11442",220631,"LINCOLN MEMORIAL UNIVERSITY",1,0,2003,183,129,54,33,7,26,0.202,0.18,0.13,11760,18.086463,91,160,0.87431693989071
"11443",220631,"LINCOLN MEMORIAL UNIVERSITY",1,0,2004,201,138,63,50,18,32,0.232,0.249,0.286,12600,19.458793,94,143,0.711442786069652
"11444",220631,"Lincoln Memorial University",1,0,2005,139,90,49,25,6,19,0.211,0.18,0.122,13104,21.963725,101,105,0.755395683453237
"11445",220631,"Lincoln Memorial University",1,0,2006,219,135,84,3,0,3,0.022,0.014,0,13752,25.115333,113,185,0.844748858447489
"11446",220631,"Lincoln Memorial University",1,0,2007,230,159,71,23,19,4,0.025,0.1,0.268,14400,29.486288,116,198,0.860869565217391
"11447",220631,"Lincoln Memorial University",1,0,2008,256,169,87,31,10,21,0.124,0.121,0.115,15120,37.139969,120,209,0.81640625
"11448",220631,"Lincoln Memorial University",1,0,2009,314,218,96,61,15,46,0.211,0.194,0.156,15120,53.419004,138,243,0.773885350318471
"11449",220631,"Lincoln Memorial University",1,0,2010,352,232,120,115,46,69,0.297,0.327,0.383,16200,56.501941,150,254,0.721590909090909
"11450",220710,"MARYVILLE COLLEGE",1,0,1991,154,80,74,50,16,34,0.425,0.325,0.216,8400,10.319141,47,128,0.831168831168831
"11451",220710,"MARYVILLE COLLEGE",1,0,1992,194,94,100,67,23,44,0.468,0.345,0.23,9580,11.249799,50,172,0.88659793814433
"11452",220710,"MARYVILLE COLLEGE",1,0,1993,175,73,102,56,28,28,0.384,0.32,0.275,10428,12.895505,50,161,0.92
"11453",220710,"MARYVILLE COLLEGE",1,0,1995,217,106,111,86,32,54,0.509,0.396,0.288,12246,15.796479,51,197,0.907834101382488
"11454",220710,"MARYVILLE COLLEGE",1,0,1996,259,134,125,134,54,80,0.597,0.517,0.432,13030,18.183268,57,231,0.891891891891892
"11455",220710,"MARYVILLE COLLEGE",1,0,1997,245,117,128,99,44,55,0.47,0.404,0.344,14425,13.487322,61,227,0.926530612244898
"11456",220710,"MARYVILLE COLLEGE",1,0,1998,228,132,96,96,35,61,0.462,0.421,0.365,15425,14.341171,61,206,0.903508771929825
"11457",220710,"MARYVILLE COLLEGE",1,0,1999,313,174,139,141,50,91,0.523,0.45,0.36,15600,15.211762,58,285,0.910543130990415
"11458",220710,"MARYVILLE COLLEGE",1,0,2000,269,132,137,135,54,81,0.614,0.502,0.394,16224,16.287094,58.5,244,0.907063197026022
"11459",220710,"MARYVILLE COLLEGE",1,0,2001,288,166,122,133,35,98,0.59,0.462,0.287,16985,17.406011,59,257,0.892361111111111
"11460",220710,"MARYVILLE COLLEGE",1,0,2002,246,127,119,103,44,59,0.465,0.419,0.37,18260,18.450827,64,208,0.845528455284553
"11461",220710,"MARYVILLE COLLEGE",1,0,2003,293,140,153,133,51,82,0.586,0.454,0.333,19180,19.848705,65,270,0.921501706484642
"11462",220710,"MARYVILLE COLLEGE",1,0,2004,317,169,148,155,56,99,0.586,0.489,0.378,20465,21.854631,66,292,0.921135646687697
"11463",220710,"Maryville College",1,0,2005,333,163,170,158,67,91,0.558,0.474,0.394,21624,22.079983,67,292,0.876876876876877
"11464",220710,"Maryville College",1,0,2006,298,163,135,123,49,74,0.454,0.413,0.363,23125,23.873063,79,265,0.889261744966443
"11465",220710,"Maryville College",1,0,2007,317,158,159,148,49,99,0.627,0.467,0.308,24675,26.728965,80,271,0.854889589905363
"11466",220710,"Maryville College",1,0,2008,297,146,151,120,50,70,0.48,0.404,0.331,26272,28.385028,95,262,0.882154882154882
"11467",220710,"Maryville College",1,0,2009,304,154,150,56,46,10,0.065,0.184,0.307,27296,28.072635,79,260,0.855263157894737
"11468",220710,"Maryville College",1,0,2010,277,126,151,129,53,76,0.603,0.466,0.351,28798,28.359496,79,226,0.815884476534296
"11469",221351,"RHODES COLLEGE",1,0,1991,379,208,171,258,108,150,0.721,0.681,0.632,12958,30.782669,104,345,0.910290237467018
"11470",221351,"RHODES COLLEGE",1,0,1992,360,202,158,256,113,143,0.708,0.711,0.715,13950,33.046371,109,330,0.916666666666667
"11471",221351,"RHODES COLLEGE",1,0,1993,385,215,170,284,124,160,0.744,0.738,0.729,14916,34.922069,110,350,0.909090909090909
"11472",221351,"RHODES COLLEGE",1,0,1995,373,204,169,256,105,151,0.74,0.686,0.621,15920,35.905507,109,340,0.911528150134048
"11473",221351,"RHODES COLLEGE",1,0,1996,375,196,179,264,128,136,0.694,0.704,0.715,16550,40.214671,116,357,0.952
"11474",221351,"RHODES COLLEGE",1,0,1997,422,239,183,301,128,173,0.724,0.713,0.699,17518,32.224838,115,370,0.876777251184834
"11475",221351,"RHODES COLLEGE",1,0,1998,383,206,177,291,128,163,0.791,0.76,0.723,18196,35.568598,119,343,0.89556135770235
"11476",221351,"RHODES COLLEGE",1,0,1999,438,251,187,338,143,195,0.777,0.772,0.765,18561,37.215756,114,382,0.872146118721461
"11477",221351,"RHODES COLLEGE",1,0,2000,396,227,169,296,125,171,0.753,0.747,0.74,19303,38.215657,125.5,352,0.888888888888889
"11478",221351,"RHODES COLLEGE",1,0,2001,417,249,168,292,107,185,0.743,0.7,0.637,20366,41.270522,137,359,0.860911270983213
"11479",221351,"RHODES COLLEGE",1,0,2002,439,238,201,306,136,170,0.714,0.697,0.677,21366,44.011755,139,379,0.863325740318907
"11480",221351,"RHODES COLLEGE",1,0,2003,456,274,182,343,140,203,0.741,0.752,0.769,22628,46.725832,149,397,0.870614035087719
"11481",221351,"RHODES COLLEGE",1,0,2004,474,269,205,360,144,216,0.803,0.759,0.702,23964,48.40488,148,424,0.894514767932489
"11482",221351,"Rhodes College",1,0,2005,440,255,185,313,131,182,0.714,0.711,0.708,26175,51.023346,157,375,0.852272727272727
"11483",221351,"Rhodes College",1,0,2006,451,272,179,363,141,222,0.816,0.805,0.788,27450,55.441308,147,375,0.831485587583149
"11484",221351,"Rhodes College",1,0,2007,452,252,200,335,148,187,0.742,0.741,0.74,30342,57.943836,149,357,0.789823008849557
"11485",221351,"Rhodes College",1,0,2008,475,276,199,353,143,210,0.761,0.743,0.719,32136,59.573707,155,342,0.72
"11486",221351,"Rhodes College",1,0,2009,427,236,191,320,133,187,0.792,0.749,0.696,33400,61.795049,159,297,0.695550351288056
"11487",221351,"Rhodes College",1,0,2010,500,307,193,382,139,243,0.792,0.764,0.72,34270,62.975442,164,390,0.78
"11488",221519,"THE UNIVERSITY OF THE SOUTH",1,0,1991,327,159,168,236,118,118,0.742,0.722,0.702,13505,31.052787,97,297,0.908256880733945
"11489",221519,"UNIVERSITY OF THE SOUTH",1,0,1992,338,171,167,230,111,119,0.696,0.68,0.665,14060,37.082047,95,317,0.937869822485207
"11490",221519,"UNIVERSITY OF THE SOUTH",1,0,1993,322,157,165,250,131,119,0.758,0.776,0.794,14910,41.009883,99,315,0.978260869565217
"11491",221519,"UNIVERSITY OF THE SOUTH",1,0,1995,370,197,173,275,120,155,0.787,0.743,0.694,16140,41.230691,107,356,0.962162162162162
"11492",221519,"UNIVERSITY OF THE SOUTH",1,0,1996,365,205,160,264,115,149,0.727,0.723,0.719,16790,46.394898,111,339,0.928767123287671
"11493",221519,"UNIVERSITY OF THE SOUTH",1,0,1997,364,195,169,285,130,155,0.795,0.783,0.769,17555,46.40753,114,343,0.942307692307692
"11494",221519,"UNIVERSITY OF THE SOUTH",1,0,1998,382,198,184,284,124,160,0.808,0.743,0.674,18350,50.317296,121,357,0.934554973821989
"11495",221519,"UNIVERSITY OF THE SOUTH",1,0,1999,391,227,164,308,123,185,0.815,0.788,0.75,18900,52.766575,122,358,0.915601023017903
"11496",221519,"UNIVERSITY OF THE SOUTH",1,0,2000,385,203,182,276,126,150,0.739,0.717,0.692,19940,54.318397,124,357,0.927272727272727
"11497",221519,"UNIVERSITY OF THE SOUTH",1,0,2001,353,185,168,259,117,142,0.768,0.734,0.696,21140,57.10397,126,319,0.903682719546742
"11498",221519,"UNIVERSITY OF THE SOUTH",1,0,2002,368,198,170,270,116,154,0.778,0.734,0.682,22370,58.130976,122,327,0.888586956521739
"11499",221519,"SEWANEE-THE UNIVERSITY OF THE SOUTH",1,0,2003,426,239,187,318,142,176,0.736,0.746,0.759,23930,58.817116,135,382,0.896713615023474
"11500",221519,"SEWANEE: THE UNIVERSITY OF THE SOUTH",1,0,2004,397,207,190,309,142,167,0.807,0.778,0.747,25374,60.797559,128,361,0.909319899244333
"11501",221519,"Sewanee:  The University of the South",1,0,2005,420,241,179,337,144,193,0.801,0.802,0.804,26874,64.087783,132,383,0.911904761904762
"11502",221519,"Sewanee:  The University of the South",1,0,2006,412,202,210,305,150,155,0.767,0.74,0.714,28528,66.395423,138,357,0.866504854368932
"11503",221519,"Sewanee:  The University of the South",1,0,2007,401,235,166,303,115,188,0.8,0.756,0.693,30438,72.56819,136,352,0.877805486284289
"11504",221519,"Sewanee:  The University of the South",1,0,2008,409,199,210,310,149,161,0.809,0.758,0.71,32488,75.749062,129,354,0.865525672371638
"11505",221519,"Sewanee-The University of the South",1,0,2009,401,203,198,296,140,156,0.768,0.738,0.707,33900,79.335297,133,331,0.825436408977556
"11506",221519,"Sewanee-The University of the South",1,0,2010,401,216,185,317,138,179,0.829,0.791,0.746,35590,77.182884,136,338,0.842892768079801
"11507",221731,"TENNESSEE WESLEYAN COLLEGE",1,0,1991,90,38,52,18,6,12,0.316,0.2,0.115,5564,6.368621,26,74,0.822222222222222
"11508",221731,"TENNESSEE WESLEYAN COLLEGE",1,0,1992,74,20,54,13,3,10,0.5,0.176,0.056,5990,6.104527,32,54,0.72972972972973
"11509",221731,"TENNESSEE WESLEYAN COLLEGE",1,0,1993,90,28,62,8,2,6,0.214,0.089,0.032,6430,5.757532,35,66,0.733333333333333
"11510",221731,"TENNESSEE WESLEYAN COLLEGE",1,0,1995,90,49,41,29,7,22,0.449,0.322,0.171,6100,5.457126,28,71,0.788888888888889
"11511",221731,"TENNESSEE WESLEYAN COLLEGE",1,0,1996,145,98,47,2,0,2,0.02,0.014,0,6300,5.592372,30,132,0.910344827586207
"11512",221731,"TENNESSEE WESLEYAN COLLEGE",1,0,1997,96,61,35,35,12,23,0.377,0.365,0.343,6500,4.704851,28,94,0.979166666666667
"11513",221731,"TENNESSEE WESLEYAN COLLEGE",1,0,1998,105,61,44,28,8,20,0.328,0.267,0.182,6950,4.992975,31,102,0.971428571428571
"11514",221731,"TENNESSEE WESLEYAN COLLEGE",1,0,1999,140,93,47,22,3,19,0.204,0.157,0.064,7400,5.377397,40,130,0.928571428571429
"11515",221731,"TENNESSEE WESLEYAN COLLEGE",1,0,2000,134,72,62,35,9,26,0.361,0.261,0.145,7900,5.981054,41,121,0.902985074626866
"11516",221731,"TENNESSEE WESLEYAN COLLEGE",1,0,2001,119,69,50,33,9,24,0.348,0.277,0.18,8500,6.909945,42,111,0.932773109243697
"11517",221731,"TENNESSEE WESLEYAN COLLEGE",1,0,2002,128,79,49,34,5,29,0.367,0.266,0.102,10000,7.168694,43,112,0.875
"11518",221731,"TENNESSEE WESLEYAN COLLEGE",1,0,2003,106,63,43,33,4,29,0.46,0.311,0.093,11000,7.311993,44,86,0.811320754716981
"11519",221731,"TENNESSEE WESLEYAN COLLEGE",1,0,2004,163,102,61,49,11,38,0.372,0.301,0.18,12000,7.903122,42,124,0.760736196319018
"11520",221731,"Tennessee Wesleyan College",1,0,2005,167,100,67,52,14,38,0.38,0.311,0.209,13000,8.611311,45,122,0.730538922155689
"11521",221731,"Tennessee Wesleyan College",1,0,2006,160,88,72,42,10,32,0.364,0.262,0.139,14000,9.529464,46,132,0.825
"11522",221731,"Tennessee Wesleyan College",1,0,2007,153,86,67,49,19,30,0.349,0.32,0.284,15000,10.840119,49,138,0.901960784313726
"11523",221731,"Tennessee Wesleyan College",1,0,2008,251,141,110,77,30,47,0.333,0.307,0.273,16500,12.748823,46,215,0.856573705179283
"11524",221731,"Tennessee Wesleyan College",1,0,2009,246,163,83,75,22,53,0.325,0.305,0.265,18000,13.352432,52,218,0.886178861788618
"11525",221731,"Tennessee Wesleyan College",1,0,2010,218,142,76,70,20,50,0.352,0.321,0.263,18500,14.694446,51,180,0.825688073394495
"11526",221847,"TENNESSEE TECHNOLOGICAL UNIVERSITY",1,0,1991,1362,637,725,185,57,128,0.201,0.136,0.079,1485,69.347636,371,1288,0.945668135095448
"11527",221847,"TENNESSEE TECHNOLOGICAL UNIVERSITY",1,0,1992,1381,584,797,267,113,154,0.264,0.193,0.142,1634,70.59911,369,1294,0.937002172338885
"11528",221847,"TENNESSEE TECHNOLOGICAL UNIVERSITY",1,0,1993,1330,608,722,172,55,117,0.192,0.129,0.076,1710,72.798527,376,1257,0.945112781954887
"11529",221847,"TENNESSEE TECHNOLOGICAL UNIVERSITY",1,0,1995,1113,513,600,130,37,93,0.181,0.117,0.062,1840,76.699321,386,1052,0.945193171608266
"11530",221847,"TENNESSEE TECHNOLOGICAL UNIVERSITY",1,0,1996,1130,497,633,134,39,95,0.191,0.119,0.062,1890,79.171431,371,1053,0.931858407079646
"11531",221847,"TENNESSEE TECHNOLOGICAL UNIVERSITY",1,0,1997,1089,466,623,100,33,67,0.144,0.092,0.053,2116,80.036948,362,1005,0.922865013774105
"11532",221847,"TENNESSEE TECHNOLOGICAL UNIVERSITY",1,0,1998,1044,460,584,124,38,86,0.187,0.119,0.065,2306,80.597073,363,956,0.915708812260536
"11533",221847,"TENNESSEE TECHNOLOGICAL UNIVERSITY",1,0,1999,1175,524,651,67,63,4,0.008,0.057,0.097,2020,86.644554,369,1087,0.925106382978723
"11534",221847,"TENNESSEE TECHNOLOGICAL UNIVERSITY",1,0,2000,1305,609,696,241,85,156,0.256,0.185,0.122,2222,86.410696,365,1183,0.906513409961686
"11535",221847,"TENNESSEE TECHNOLOGICAL UNIVERSITY",1,0,2001,1289,529,760,230,108,122,0.231,0.178,0.142,2556,92.361251,361,1173,0.910007757951901
"11536",221847,"TENNESSEE TECHNOLOGICAL UNIVERSITY",1,0,2002,1376,585,791,251,99,152,0.26,0.182,0.125,2748,94.800172,371,1228,0.892441860465116
"11537",221847,"TENNESSEE TECHNOLOGICAL UNIVERSITY",1,0,2003,1374,577,797,300,133,167,0.289,0.218,0.167,3132,101.931139,362,1221,0.888646288209607
"11538",221847,"TENNESSEE TECHNOLOGICAL UNIVERSITY",1,0,2004,1476,611,865,312,122,190,0.311,0.211,0.141,3352,102.459162,372,1258,0.85230352303523
"11539",221847,"Tennessee Technological University",1,0,2005,1409,623,786,321,121,200,0.321,0.228,0.154,3678,108.950224,358,1239,0.879347054648687
"11540",221847,"Tennessee Technological University",1,0,2006,1515,653,862,301,127,174,0.266,0.199,0.147,3828,116.049869,372,1337,0.882508250825083
"11541",221847,"Tennessee Technological University",1,0,2007,1649,730,919,371,157,214,0.293,0.225,0.171,4058,122.712716,373,1469,0.890842935112189
"11542",221847,"Tennessee Technological University",1,0,2008,1659,736,923,379,165,214,0.291,0.228,0.179,4302,132.966099,368,1414,0.852320675105485
"11543",221847,"Tennessee Technological University",1,0,2009,1879,884,995,476,181,295,0.334,0.253,0.182,4584,140.66403,371,1676,0.89196381053752
"11544",221847,"Tennessee Technological University",1,0,2010,1898,846,1052,468,177,291,0.344,0.247,0.168,4824,135.704657,380,1662,0.875658587987355
"11545",221892,"TREVECCA NAZARENE COLLEGE",1,0,1991,193,113,80,46,23,23,0.204,0.238,0.288,5720,13.963307,86,154,0.797927461139896
"11546",221892,"TREVECCA NAZARENE COLLEGE",1,0,1992,180,96,84,27,10,17,0.177,0.15,0.119,6220,12.299799,53,158,0.877777777777778
"11547",221892,"TREVECCA NAZARENE COLLEGE",1,0,1993,139,84,55,25,9,16,0.19,0.18,0.164,6721,12.413736,57,125,0.899280575539568
"11548",221892,"TREVECCA NAZARENE UNIVERSITY",1,0,1995,214,113,101,43,14,29,0.257,0.201,0.139,7856,13.526449,64,196,0.91588785046729
"11549",221892,"TREVECCA NAZARENE UNIVERSITY",1,0,1996,189,108,81,37,9,28,0.259,0.196,0.111,8644,17.532893,65,166,0.878306878306878
"11550",221892,"TREVECCA NAZARENE UNIVERSITY",1,0,1997,179,100,79,30,9,21,0.21,0.168,0.114,8660,14.751769,64,164,0.916201117318436
"11551",221892,"TREVECCA NAZARENE UNIVERSITY",1,0,1998,187,111,76,40,16,24,0.216,0.214,0.211,9536,16.302178,63,176,0.941176470588235
"11552",221892,"TREVECCA NAZARENE UNIVERSITY",1,0,1999,192,119,73,43,14,29,0.244,0.224,0.192,10016,17.786478,64,178,0.927083333333333
"11553",221892,"TREVECCA NAZARENE UNIVERSITY",1,0,2000,220,130,90,80,24,56,0.431,0.364,0.267,10528,18.990876,67.5,198,0.9
"11554",221892,"TREVECCA NAZARENE UNIVERSITY",1,0,2001,216,112,104,82,36,46,0.411,0.38,0.346,10848,19.16597,71,199,0.921296296296296
"11555",221892,"TREVECCA NAZARENE UNIVERSITY",1,0,2002,198,134,64,75,24,51,0.381,0.379,0.375,11390,22.17056,74,180,0.909090909090909
"11556",221892,"TREVECCA NAZARENE UNIVERSITY",1,0,2003,219,126,93,82,31,51,0.405,0.374,0.333,11960,23.054288,77,195,0.89041095890411
"11557",221892,"TREVECCA NAZARENE UNIVERSITY",1,0,2004,237,119,118,84,38,46,0.387,0.354,0.322,12792,24.283195,77,208,0.877637130801688
"11558",221892,"Trevecca Nazarene University",1,0,2005,239,124,115,95,40,55,0.444,0.397,0.348,13432,26.133735,73,207,0.866108786610879
"11559",221892,"Trevecca Nazarene University",1,0,2006,240,147,93,97,32,65,0.442,0.404,0.344,14774,28.956296,79,211,0.879166666666667
"11560",221892,"Trevecca Nazarene University",1,0,2007,238,139,99,85,31,54,0.388,0.357,0.313,15512,30.119911,76,209,0.878151260504202
"11561",221892,"Trevecca Nazarene University",1,0,2008,218,125,93,86,31,55,0.44,0.394,0.333,16288,33.0145,80,183,0.839449541284404
"11562",221892,"Trevecca Nazarene University",1,0,2009,240,145,95,96,35,61,0.421,0.4,0.368,16776,34.965064,87,203,0.845833333333333
"11563",221892,"Trevecca Nazarene University",1,0,2010,234,142,92,92,33,59,0.416,0.393,0.359,18318,36.703703,87,180,0.769230769230769
"11564",222178,"ABILENE CHRISTIAN UNIVERSITY",1,0,1991,656,338,318,176,75,101,0.299,0.268,0.236,6510,43.533076,175,546,0.832317073170732
"11565",222178,"ABILENE CHRISTIAN UNIVERSITY",1,0,1992,672,323,349,168,66,102,0.316,0.25,0.189,6900,43.503275,165,436,0.648809523809524
"11566",222178,"ABILENE CHRISTIAN UNIVERSITY",1,0,1993,650,343,307,165,66,99,0.289,0.254,0.215,7170,45.915332,160,441,0.678461538461538
"11567",222178,"ABILENE CHRISTIAN UNIVERSITY",1,0,1995,917,506,411,250,93,157,0.31,0.273,0.226,7800,48.996677,168,771,0.840785169029444
"11568",222178,"ABILENE CHRISTIAN UNIVERSITY",1,0,1996,898,478,420,241,97,144,0.301,0.268,0.231,8660,54.79,186,761,0.847438752783964
"11569",222178,"ABILENE CHRISTIAN UNIVERSITY",1,0,1997,964,530,434,259,97,162,0.306,0.269,0.224,9180,51.636819,189,813,0.843360995850622
"11570",222178,"ABILENE CHRISTIAN UNIVERSITY",1,0,1998,988,541,447,280,110,170,0.314,0.283,0.246,9710,54.49255,201,857,0.867408906882591
"11571",222178,"ABILENE CHRISTIAN UNIVERSITY",1,0,1999,924,533,391,335,120,215,0.403,0.363,0.307,9810,58.781324,208,749,0.810606060606061
"11572",222178,"ABILENE CHRISTIAN UNIVERSITY",1,0,2000,1023,565,458,355,139,216,0.382,0.347,0.303,10410,63.394052,218,856,0.836754643206256
"11573",222178,"ABILENE CHRISTIAN UNIVERSITY",1,0,2001,1031,598,433,387,127,260,0.435,0.375,0.293,11130,67.786813,228,845,0.819592628516004
"11574",222178,"ABILENE CHRISTIAN UNIVERSITY",1,0,2002,942,536,406,360,112,248,0.463,0.382,0.276,11910,69.288405,226,761,0.807855626326964
"11575",222178,"ABILENE CHRISTIAN UNIVERSITY",1,0,2003,948,489,459,369,125,244,0.499,0.389,0.272,12750,75.387557,227,763,0.804852320675105
"11576",222178,"ABILENE CHRISTIAN UNIVERSITY",1,0,2004,1018,553,465,377,127,250,0.452,0.37,0.273,13650,76.79275,216,808,0.793713163064833
"11577",222178,"Abilene Christian University",1,0,2005,1030,560,470,393,150,243,0.434,0.382,0.319,14610,82.289465,211,821,0.797087378640777
"11578",222178,"Abilene Christian University",1,0,2006,961,526,435,394,147,247,0.47,0.41,0.338,15630,84.755981,216,777,0.808532778355879
"11579",222178,"Abilene Christian University",1,0,2007,887,476,411,324,113,211,0.443,0.365,0.275,16710,94.725437,222,683,0.770011273957159
"11580",222178,"Abilene Christian University",1,0,2008,971,518,453,434,167,267,0.515,0.447,0.369,17880,96.699114,221,761,0.783728115345005
"11581",222178,"Abilene Christian University",1,0,2009,979,520,459,406,136,270,0.519,0.415,0.296,19200,105.210745,228,730,0.745658835546476
"11582",222178,"Abilene Christian University",1,0,2010,977,526,451,465,194,271,0.515,0.476,0.43,21510,105.447044,241,785,0.803480040941658
"11583",222983,"AUSTIN COLLEGE",1,0,1991,307,173,134,187,77,110,0.636,0.609,0.575,9465,21.179276,85,251,0.817589576547231
"11584",222983,"AUSTIN COLLEGE",1,0,1992,289,144,145,165,76,89,0.618,0.571,0.524,10085,21.034697,84,219,0.757785467128028
"11585",222983,"AUSTIN COLLEGE",1,0,1993,294,175,119,165,57,108,0.617,0.561,0.479,10740,21.673607,84,218,0.741496598639456
"11586",222983,"AUSTIN COLLEGE",1,0,1995,293,155,138,195,90,105,0.677,0.666,0.652,12070,23.186011,87,215,0.733788395904437
"11587",222983,"AUSTIN COLLEGE",1,0,1996,344,181,163,254,106,148,0.818,0.738,0.65,12675,23.987153,87,289,0.840116279069767
"11588",222983,"AUSTIN COLLEGE",1,0,1997,317,150,167,215,103,112,0.747,0.678,0.617,13435,23.980161,83,246,0.77602523659306
"11589",222983,"AUSTIN COLLEGE",1,0,1998,347,190,157,242,97,145,0.763,0.697,0.618,14205,25.577304,83,262,0.755043227665706
"11590",222983,"AUSTIN COLLEGE",1,0,1999,324,188,136,222,74,148,0.787,0.685,0.544,14785,26.198158,79,254,0.783950617283951
"11591",222983,"AUSTIN COLLEGE",1,0,2000,347,186,161,249,106,143,0.769,0.718,0.658,15177,29.149969,82,280,0.806916426512968
"11592",222983,"AUSTIN COLLEGE",1,0,2001,312,174,138,220,91,129,0.741,0.705,0.659,15792,31.706561,85,235,0.753205128205128
"11593",222983,"AUSTIN COLLEGE",1,0,2002,347,191,156,245,104,141,0.738,0.706,0.667,16392,32.305065,91,261,0.752161383285303
"11594",222983,"AUSTIN COLLEGE",1,0,2003,338,193,145,228,86,142,0.736,0.675,0.593,17740,33.837568,94,257,0.760355029585799
"11595",222983,"AUSTIN COLLEGE",1,0,2004,370,193,177,274,121,153,0.793,0.741,0.684,18980,34.789396,97,283,0.764864864864865
"11596",222983,"Austin College",1,0,2005,347,171,176,239,103,136,0.795,0.689,0.585,20310,34.323755,91,253,0.729106628242075
"11597",222983,"Austin College",1,0,2006,340,175,165,251,113,138,0.789,0.738,0.685,23355,37.696935,92,241,0.708823529411765
"11598",222983,"Austin College",1,0,2007,333,174,159,223,91,132,0.759,0.67,0.572,24760,41.484227,95,233,0.6996996996997
"11599",222983,"Austin College",1,0,2008,318,191,127,229,88,141,0.738,0.72,0.693,26370,42.41726,94,203,0.638364779874214
"11600",222983,"Austin College",1,0,2009,413,213,200,295,129,166,0.779,0.714,0.645,27690,42.820598,95,260,0.62953995157385
"11601",222983,"Austin College",1,0,2010,318,173,145,220,90,130,0.751,0.692,0.621,29075,45.039125,93,195,0.613207547169811
"11602",223232,"BAYLOR UNIVERSITY",1,0,1991,2150,1240,910,947,347,600,0.484,0.44,0.381,6110,126.056325,598,1763,0.82
"11603",223232,"BAYLOR UNIVERSITY",1,0,1992,2363,1400,963,930,336,594,0.424,0.394,0.349,6590,135.961964,589,1879,0.795175624206517
"11604",223232,"BAYLOR UNIVERSITY",1,0,1993,2426,1420,1006,978,350,628,0.442,0.403,0.348,7070,141.750472,601,1958,0.807089859851608
"11605",223232,"BAYLOR UNIVERSITY",1,0,1995,2329,1390,939,1004,337,667,0.48,0.431,0.359,8444,155.565685,600,1796,0.771146414770288
"11606",223232,"BAYLOR UNIVERSITY",1,0,1996,2463,1444,1019,1062,350,712,0.493,0.431,0.343,8806,170.90175,606,1895,0.769386926512383
"11607",223232,"BAYLOR UNIVERSITY",1,0,1997,2404,1416,988,967,300,667,0.471,0.402,0.304,9478,155.260528,606,1856,0.772046589018303
"11608",223232,"BAYLOR UNIVERSITY",1,0,1998,2933,1712,1221,1261,405,856,0.5,0.43,0.332,10316,165.708,629,2204,0.75144902829867
"11609",223232,"BAYLOR UNIVERSITY",1,0,1999,2766,1668,1098,1272,379,893,0.535,0.46,0.345,9870,184.579,676,2107,0.76174981923355
"11610",223232,"BAYLOR UNIVERSITY",1,0,2000,2822,1666,1156,1388,442,946,0.568,0.492,0.382,10650,203.612,700.5,2229,0.789865343727853
"11611",223232,"BAYLOR UNIVERSITY",1,0,2001,2790,1664,1126,1340,434,906,0.545,0.48,0.385,11370,218.818,725,2198,0.787813620071685
"11612",223232,"BAYLOR UNIVERSITY",1,0,2002,2601,1558,1043,1323,439,884,0.567,0.509,0.421,15700,245.846,756,1992,0.765859284890427
"11613",223232,"BAYLOR UNIVERSITY",1,0,2003,2667,1673,994,1266,347,919,0.549,0.475,0.349,16750,273.524,777,1945,0.72928383952006
"11614",223232,"BAYLOR UNIVERSITY",1,0,2004,2772,1674,1098,1398,488,910,0.544,0.504,0.444,17900,286.458,770,1924,0.694083694083694
"11615",223232,"Baylor University",1,0,2005,3158,1867,1291,1641,582,1059,0.567,0.52,0.451,19050,304.128,755,2156,0.682710576314123
"11616",223232,"Baylor University",1,0,2006,2775,1713,1062,1550,494,1056,0.617,0.559,0.465,20574,317.203,767,2065,0.744144144144144
"11617",223232,"Baylor University",1,0,2007,2721,1618,1103,1556,552,1004,0.62,0.572,0.5,22220,343.325,813,1897,0.697170158030136
"11618",223232,"Baylor University",1,0,2008,3054,1801,1253,1669,594,1075,0.597,0.546,0.474,23664,378.168,823,2041,0.6683038637852
"11619",223232,"Baylor University",1,0,2009,3097,1825,1272,1672,592,1080,0.592,0.54,0.465,25320,410.67,859,1947,0.628672909267033
"11620",223232,"Baylor University",1,0,2010,3254,1913,1341,1897,668,1229,0.642,0.583,0.498,26966,421.837,870,2050,0.6299938537185
"11621",224004,"CONCORDIA LUTHERAN COLLEGE",1,0,1991,116,72,44,26,7,19,0.264,0.224,0.159,6090,6.118097,26,94,0.810344827586207
"11622",224004,"CONCORDIA LUTHERAN COLLEGE",1,0,1992,115,65,50,16,2,14,0.215,0.139,0.04,6360,6.806372,27,95,0.826086956521739
"11623",224004,"CONCORDIA LUTHERAN COLLEGE",1,0,1993,107,62,45,26,7,19,0.306,0.243,0.156,6760,6.90863,31,87,0.813084112149533
"11624",224004,"CONCORDIA UNIVERSITY AT AUSTIN",1,0,1995,90,55,35,18,5,13,0.236,0.2,0.143,7980,7.566046,33,73,0.811111111111111
"11625",224004,"CONCORDIA UNIVERSITY AT AUSTIN",1,0,1996,121,74,47,42,12,30,0.405,0.347,0.255,8680,8.647886,33,101,0.834710743801653
"11626",224004,"CONCORDIA UNIVERSITY AT AUSTIN",1,0,1997,125,57,68,15,7,8,0.14,0.12,0.103,9500,7.54976,34,89,0.712
"11627",224004,"CONCORDIA UNIVERSITY AT AUSTIN",1,0,1998,127,75,52,23,8,15,0.2,0.181,0.154,10500,7.936158,38,99,0.779527559055118
"11628",224004,"CONCORDIA UNIVERSITY AT AUSTIN",1,0,1999,134,66,68,15,10,5,0.076,0.112,0.147,11500,8.331781,43,93,0.694029850746269
"11629",224004,"CONCORDIA UNIVERSITY AT AUSTIN",1,0,2000,130,73,57,24,8,16,0.219,0.185,0.14,12500,9.040809,40.5,88,0.676923076923077
"11630",224004,"CONCORDIA UNIVERSITY AT AUSTIN",1,0,2001,189,104,85,28,10,18,0.173,0.148,0.118,13120,10.218103,38,139,0.735449735449735
"11631",224004,"CONCORDIA UNIVERSITY AT AUSTIN",1,0,2002,166,85,81,12,9,3,0.035,0.072,0.111,14300,11.216787,40,120,0.72289156626506
"11632",224004,"CONCORDIA UNIVERSITY AT AUSTIN",1,0,2003,154,83,71,26,13,13,0.157,0.169,0.183,15300,12.088083,37,101,0.655844155844156
"11633",224004,"CONCORDIA UNIVERSITY AT AUSTIN",1,0,2004,149,84,65,21,10,11,0.131,0.141,0.154,16050,12.299804,44,98,0.657718120805369
"11634",224004,"Concordia University at Austin",1,0,2005,196,96,100,40,12,28,0.292,0.204,0.12,16740,13.859297,37,136,0.693877551020408
"11635",224004,"Concordia University at Austin",1,0,2006,191,89,102,37,16,21,0.236,0.194,0.157,17800,14.851804,38,133,0.696335078534031
"11636",224004,"Concordia University Texas",1,0,2007,160,87,73,29,9,20,0.23,0.181,0.123,18600,17.466907,44,100,0.625
"11637",224004,"Concordia University Texas",1,0,2008,229,129,100,44,16,28,0.217,0.192,0.16,20100,24.134473,51,144,0.62882096069869
"11638",224004,"Concordia University Texas",1,0,2009,225,122,103,58,22,36,0.295,0.258,0.214,20800,26.027069,55,146,0.648888888888889
"11639",224004,"Concordia University-Texas",1,0,2010,235,157,78,54,11,43,0.274,0.23,0.141,21700,28.431989,55,137,0.582978723404255
"11640",224323,"UNIVERSITY OF DALLAS",1,0,1991,280,163,117,138,50,88,0.54,0.493,0.427,8600,24.655726,99,209,0.746428571428571
"11641",224323,"UNIVERSITY OF DALLAS",1,0,1992,251,137,114,114,42,72,0.525,0.454,0.368,9400,26.179295,102,169,0.673306772908366
"11642",224323,"UNIVERSITY OF DALLAS",1,0,1993,246,138,108,118,56,62,0.449,0.48,0.519,10200,30.603705,108,171,0.695121951219512
"11643",224323,"UNIVERSITY OF DALLAS",1,0,1995,244,146,98,134,58,76,0.52,0.549,0.592,11375,30.971836,104,183,0.75
"11644",224323,"UNIVERSITY OF DALLAS",1,0,1996,251,157,94,141,46,95,0.605,0.562,0.489,12113,33.438779,104,190,0.756972111553785
"11645",224323,"UNIVERSITY OF DALLAS",1,0,1997,261,160,101,136,47,89,0.556,0.521,0.465,12790,30.306025,106,175,0.670498084291188
"11646",224323,"UNIVERSITY OF DALLAS",1,0,1998,291,188,103,207,67,140,0.745,0.711,0.65,13672,33.886297,118,217,0.745704467353952
"11647",224323,"UNIVERSITY OF DALLAS",1,0,1999,309,191,118,188,67,121,0.634,0.608,0.568,14354,35.819746,125,206,0.666666666666667
"11648",224323,"UNIVERSITY OF DALLAS",1,0,2000,279,168,111,167,59,108,0.643,0.599,0.532,15028,38.748389,127,184,0.659498207885305
"11649",224323,"UNIVERSITY OF DALLAS",1,0,2001,310,180,130,170,77,93,0.517,0.548,0.592,15824,42.497034,129,192,0.619354838709677
"11650",224323,"UNIVERSITY OF DALLAS",1,0,2002,307,185,122,142,52,90,0.486,0.463,0.426,16694,44.320894,130,207,0.674267100977199
"11651",224323,"UNIVERSITY OF DALLAS",1,0,2003,299,189,110,185,58,127,0.672,0.619,0.527,17612,45.712515,125,190,0.635451505016722
"11652",224323,"UNIVERSITY OF DALLAS",1,0,2004,243,126,117,153,65,88,0.698,0.63,0.556,18582,41.011022,121,158,0.650205761316872
"11653",224323,"University of Dallas",1,0,2005,256,165,91,160,53,107,0.648,0.625,0.582,19604,40.963345,116,200,0.78125
"11654",224323,"University of Dallas",1,0,2006,315,169,146,189,82,107,0.633,0.6,0.562,20780,44.019665,121,209,0.663492063492063
"11655",224323,"University of Dallas",1,0,2007,362,200,162,201,85,116,0.58,0.555,0.525,21819,45.496865,125,245,0.676795580110497
"11656",224323,"University of Dallas",1,0,2008,341,168,173,216,104,112,0.667,0.633,0.601,23250,47.737154,125,236,0.69208211143695
"11657",224323,"University of Dallas",1,0,2009,319,169,150,212,96,116,0.686,0.665,0.64,24646,50.720469,125,179,0.561128526645768
"11658",224323,"University of Dallas",1,0,2010,375,207,168,223,89,134,0.647,0.595,0.53,27815,48.921015,135,257,0.685333333333333
"11659",225432,"UNIVERSITY OF HOUSTON-DOWNTOWN",1,0,1991,570,299,271,10,6,4,0.013,0.018,0.022,1150,29.205171,149,95,0.166666666666667
"11660",225432,"UNIVERSITY OF HOUSTON-DOWNTOWN",1,0,1992,540,275,265,3,1,2,0.007,0.006,0.004,1358,30.770811,153,85,0.157407407407407
"11661",225432,"UNIVERSITY OF HOUSTON-DOWNTOWN",1,0,1993,666,362,304,8,2,6,0.017,0.012,0.007,1506,31.859179,153,103,0.154654654654655
"11662",225432,"UNIVERSITY OF HOUSTON-DOWNTOWN",1,0,1995,624,351,273,10,3,7,0.02,0.016,0.011,1646,33.899868,166,86,0.137820512820513
"11663",225432,"UNIVERSITY OF HOUSTON-DOWNTOWN",1,0,1996,638,385,253,13,5,8,0.021,0.02,0.02,1866,39.30493,166,69,0.108150470219436
"11664",225432,"UNIVERSITY OF HOUSTON-DOWNTOWN",1,0,1997,679,374,305,14,2,12,0.032,0.021,0.007,2046,39.937975,175,85,0.125184094256259
"11665",225432,"UNIVERSITY OF HOUSTON-DOWNTOWN",1,0,1998,696,406,290,8,3,5,0.012,0.011,0.01,2106,41.720776,181,89,0.127873563218391
"11666",225432,"UNIVERSITY OF HOUSTON-DOWNTOWN",1,0,1999,729,418,311,10,3,7,0.017,0.014,0.01,1140,48.974301,191,58,0.0795610425240055
"11667",225432,"UNIVERSITY OF HOUSTON-DOWNTOWN",1,0,2000,794,437,357,16,6,10,0.023,0.02,0.017,1200,51.12873,205,94,0.118387909319899
"11668",225432,"UNIVERSITY OF HOUSTON-DOWNTOWN",1,0,2001,869,481,388,19,5,14,0.029,0.022,0.013,1200,63.802192,219,97,0.111622554660529
"11669",225432,"UNIVERSITY OF HOUSTON-DOWNTOWN",1,0,2002,905,498,407,14,4,10,0.02,0.015,0.01,2220,73.022216,243,76,0.0839779005524862
"11670",225432,"UNIVERSITY OF HOUSTON-DOWNTOWN",1,0,2003,1012,559,453,16,5,11,0.02,0.016,0.011,2088,89.697386,236,115,0.113636363636364
"11671",225432,"UNIVERSITY OF HOUSTON-DOWNTOWN",1,0,2004,964,541,423,10,5,5,0.009,0.01,0.012,3170,75.117307,246,99,0.102697095435685
"11672",225432,"University of Houston-Downtown",1,0,2005,889,487,402,20,8,12,0.025,0.022,0.02,2700,81.865875,261,86,0.0967379077615298
"11673",225432,"University of Houston-Downtown",1,0,2006,840,452,388,12,7,5,0.011,0.014,0.018,2898,88.147771,289,79,0.094047619047619
"11674",225432,"University of Houston-Downtown",1,0,2007,831,438,393,22,7,15,0.034,0.026,0.018,3240,91.616377,281,73,0.0878459687123947
"11675",225432,"University of Houston-Downtown",1,0,2008,699,400,299,20,9,11,0.028,0.029,0.03,3240,102.228338,281,71,0.101573676680973
"11676",225432,"University of Houston-Downtown",1,0,2009,722,378,344,10,6,4,0.011,0.014,0.017,3360,112.063061,290,71,0.0983379501385042
"11677",225432,"University of Houston-Downtown",1,0,2010,824,453,371,11,3,8,0.018,0.013,0.008,3552,131.239396,291,51,0.0618932038834951
"11678",225548,"HOWARD PAYNE UNIVERSITY",1,0,1991,266,125,141,42,14,28,0.224,0.158,0.099,4160,10.858576,73,203,0.763157894736842
"11679",225548,"HOWARD PAYNE UNIVERSITY",1,0,1992,265,123,142,60,31,29,0.236,0.226,0.218,4430,11.798349,70,219,0.826415094339623
"11680",225548,"HOWARD PAYNE UNIVERSITY",1,0,1993,322,133,189,56,31,25,0.188,0.174,0.164,5070,12.411483,84,259,0.804347826086957
"11681",225548,"HOWARD PAYNE UNIVERSITY",1,0,1995,325,170,155,82,28,54,0.318,0.252,0.181,5940,14.973776,90,267,0.821538461538462
"11682",225548,"HOWARD PAYNE UNIVERSITY",1,0,1996,335,151,184,83,27,56,0.371,0.248,0.147,6450,16.421124,93,265,0.791044776119403
"11683",225548,"HOWARD PAYNE UNIVERSITY",1,0,1997,323,112,211,66,32,34,0.304,0.204,0.152,7109,14.064788,90,237,0.73374613003096
"11684",225548,"HOWARD PAYNE UNIVERSITY",1,0,1998,315,143,172,66,25,41,0.287,0.21,0.145,8460,14.628053,85,255,0.80952380952381
"11685",225548,"HOWARD PAYNE UNIVERSITY",1,0,1999,286,137,149,10,3,7,0.051,0.035,0.02,8400,16.06291,90,228,0.797202797202797
"11686",225548,"HOWARD PAYNE UNIVERSITY",1,0,2000,355,175,180,82,28,54,0.309,0.231,0.156,8400,18.334931,82,301,0.847887323943662
"11687",225548,"HOWARD PAYNE UNIVERSITY",1,0,2001,319,152,167,80,34,46,0.303,0.251,0.204,9200,20.363976,74,241,0.755485893416928
"11688",225548,"HOWARD PAYNE UNIVERSITY",1,0,2002,325,157,168,78,24,54,0.344,0.24,0.143,9700,19.825928,70,241,0.741538461538462
"11689",225548,"HOWARD PAYNE UNIVERSITY",1,0,2003,293,136,157,76,27,49,0.36,0.259,0.172,10300,19.541644,71,217,0.74061433447099
"11690",225548,"HOWARD PAYNE UNIVERSITY",1,0,2004,285,126,159,62,29,33,0.262,0.218,0.182,11000,19.337158,75,209,0.733333333333333
"11691",225548,"Howard Payne University",1,0,2005,281,146,135,104,41,63,0.432,0.37,0.304,11500,20.922996,72,206,0.733096085409253
"11692",225548,"Howard Payne University",1,0,2006,318,130,188,109,46,63,0.485,0.343,0.245,13440,21.367351,78,238,0.748427672955975
"11693",225548,"Howard Payne University",1,0,2007,255,103,152,77,31,46,0.447,0.302,0.204,15000,18.979312,78,159,0.623529411764706
"11694",225548,"Howard Payne University",1,0,2008,304,128,176,107,48,59,0.461,0.352,0.273,16350,19.447741,76,222,0.730263157894737
"11695",225548,"Howard Payne University",1,0,2009,209,84,125,74,31,43,0.512,0.354,0.248,17600,19.22712,77,126,0.602870813397129
"11696",225548,"Howard Payne University",1,0,2010,318,149,169,88,32,56,0.376,0.277,0.189,18850,19.812044,82,224,0.70440251572327
"11697",225627,"INCARNATE WORD COLLEGE",1,0,1991,330,246,84,35,4,31,0.126,0.106,0.048,7200,21.509222,100,97,0.293939393939394
"11698",225627,"INCARNATE WORD COLLEGE",1,0,1992,310,224,86,33,4,29,0.13,0.106,0.047,7800,21.621433,123,82,0.264516129032258
"11699",225627,"INCARNATE WORD COLLEGE",1,0,1993,297,202,95,29,8,21,0.104,0.098,0.084,8250,23.913648,136,81,0.272727272727273
"11700",225627,"UNIVERSITY OF THE INCARNATE WORD",1,0,1995,370,259,111,50,11,39,0.151,0.135,0.099,9690,27.266249,134,101,0.272972972972973
"11701",225627,"UNIVERSITY OF THE INCARNATE WORD",1,0,1996,404,288,116,46,6,40,0.139,0.114,0.052,10150,31.191369,124,106,0.262376237623762
"11702",225627,"UNIVERSITY OF THE INCARNATE WORD",1,0,1997,341,233,108,47,10,37,0.159,0.138,0.093,10600,27.209229,122,91,0.266862170087977
"11703",225627,"UNIVERSITY OF THE INCARNATE WORD",1,0,1998,375,265,110,59,10,49,0.185,0.157,0.091,11200,29.41042,129,101,0.269333333333333
"11704",225627,"UNIVERSITY OF THE INCARNATE WORD",1,0,1999,380,253,127,51,9,42,0.166,0.134,0.071,11850,33.633413,123,87,0.228947368421053
"11705",225627,"UNIVERSITY OF THE INCARNATE WORD",1,0,2000,388,253,135,77,20,57,0.225,0.198,0.148,12470,36.181057,122.5,102,0.262886597938144
"11706",225627,"UNIVERSITY OF THE INCARNATE WORD",1,0,2001,416,285,131,66,10,56,0.196,0.159,0.076,13220,39.701936,122,93,0.223557692307692
"11707",225627,"UNIVERSITY OF THE INCARNATE WORD",1,0,2002,395,244,151,58,18,40,0.164,0.147,0.119,14000,45.163544,130,105,0.265822784810127
"11708",225627,"UNIVERSITY OF THE INCARNATE WORD",1,0,2003,396,280,116,70,18,52,0.186,0.177,0.155,14800,51.020422,138,95,0.23989898989899
"11709",225627,"UNIVERSITY OF THE INCARNATE WORD",1,0,2004,474,331,143,61,12,49,0.148,0.129,0.084,15600,48.814764,148,107,0.225738396624473
"11710",225627,"University of the Incarnate Word",1,0,2005,571,394,177,114,23,91,0.231,0.2,0.13,16500,51.584776,160,131,0.229422066549912
"11711",225627,"University of the Incarnate Word",1,0,2006,613,439,174,119,23,96,0.219,0.194,0.132,17400,56.296767,175,129,0.210440456769984
"11712",225627,"University of the Incarnate Word",1,0,2007,715,463,252,138,41,97,0.21,0.193,0.163,18400,63.826951,183,146,0.204195804195804
"11713",225627,"University of the Incarnate Word",1,0,2008,880,553,327,157,39,118,0.213,0.178,0.119,19400,73.057044,200,193,0.219318181818182
"11714",225627,"University of the Incarnate Word",1,0,2009,717,469,248,178,49,129,0.275,0.248,0.198,20400,84.725638,219,156,0.217573221757322
"11715",225627,"University of the Incarnate Word",1,0,2010,871,571,300,257,70,187,0.328,0.295,0.233,21000,89.034955,245,169,0.194029850746269
"11716",226231,"LETOURNEAU UNIVERSITY",1,0,1991,207,26,181,51,44,7,0.269,0.246,0.243,7350,11.48636,49,181,0.8743961352657
"11717",226231,"LETOURNEAU UNIVERSITY",1,0,1992,182,26,156,37,30,7,0.269,0.203,0.192,7940,16.113934,50,157,0.862637362637363
"11718",226231,"LETOURNEAU UNIVERSITY",1,0,1993,202,33,169,46,36,10,0.303,0.228,0.213,8460,16.278602,50,180,0.891089108910891
"11719",226231,"LETOURNEAU UNIVERSITY",1,0,1995,218,66,152,68,42,26,0.394,0.312,0.276,9430,21.97955,55,195,0.894495412844037
"11720",226231,"LETOURNEAU UNIVERSITY",1,0,1996,163,35,128,26,19,7,0.2,0.16,0.148,10220,23.479969,56,146,0.895705521472393
"11721",226231,"LETOURNEAU UNIVERSITY",1,0,1997,209,50,159,65,45,20,0.4,0.311,0.283,10724,20.06613,52,182,0.870813397129187
"11722",226231,"LETOURNEAU UNIVERSITY",1,0,1998,257,55,202,72,48,24,0.436,0.28,0.238,11264,21.455921,58,236,0.918287937743191
"11723",226231,"LETOURNEAU UNIVERSITY",1,0,1999,259,58,201,75,52,23,0.397,0.29,0.259,11570,26.020742,59,229,0.884169884169884
"11724",226231,"LETOURNEAU UNIVERSITY",1,0,2000,286,79,207,96,58,38,0.481,0.336,0.28,12090,27.923172,59,261,0.912587412587413
"11725",226231,"LETOURNEAU UNIVERSITY",1,0,2001,242,66,176,74,47,27,0.409,0.306,0.267,12670,27.239022,59,211,0.871900826446281
"11726",226231,"LETOURNEAU UNIVERSITY",1,0,2002,243,55,188,68,46,22,0.4,0.28,0.245,13240,31.920969,62,214,0.880658436213992
"11727",226231,"LETOURNEAU UNIVERSITY",1,0,2003,333,94,239,93,52,41,0.436,0.279,0.218,14010,35.788155,66,294,0.882882882882883
"11728",226231,"LETOURNEAU UNIVERSITY",1,0,2004,327,92,235,98,58,40,0.435,0.3,0.247,14850,37.732591,70,272,0.831804281345566
"11729",226231,"LeTourneau University",1,0,2005,317,74,243,95,66,29,0.392,0.3,0.272,15710,39.762452,72,276,0.870662460567823
"11730",226231,"LeTourneau University",1,0,2006,309,88,221,130,75,55,0.625,0.421,0.339,16720,43.068589,72,271,0.877022653721683
"11731",226231,"LeTourneau University",1,0,2007,322,97,225,108,71,37,0.381,0.335,0.316,17710,47.509611,84,263,0.816770186335404
"11732",226231,"LeTourneau University",1,0,2008,340,106,234,118,76,42,0.396,0.347,0.325,18940,51.793415,85,283,0.832352941176471
"11733",226231,"LeTourneau University",1,0,2009,341,109,232,123,83,40,0.367,0.361,0.358,20100,52.27752,79,265,0.777126099706745
"11734",226231,"LeTourneau University",1,0,2010,425,169,256,152,85,67,0.396,0.358,0.332,21510,49.428883,87,244,0.574117647058824
"11735",226833,"MIDWESTERN STATE UNIVERSITY",1,0,1991,708,332,376,14,8,6,0.018,0.02,0.021,1359,26.955568,154,569,0.803672316384181
"11736",226833,"MIDWESTERN STATE UNIVERSITY",1,0,1992,641,313,328,43,16,27,0.086,0.067,0.049,1474,28.067093,155,509,0.794071762870515
"11737",226833,"MIDWESTERN STATE UNIVERSITY",1,0,1993,553,284,269,49,23,26,0.092,0.089,0.086,1666,30.874481,163,440,0.795660036166365
"11738",226833,"MIDWESTERN STATE UNIVERSITY",1,0,1995,578,276,302,49,16,33,0.12,0.085,0.053,1870,33.912458,178,458,0.792387543252595
"11739",226833,"MIDWESTERN STATE UNIVERSITY",1,0,1996,602,312,290,52,17,35,0.112,0.086,0.059,1477,38.482073,180,482,0.800664451827243
"11740",226833,"MIDWESTERN STATE UNIVERSITY",1,0,1997,668,329,339,37,13,24,0.073,0.055,0.038,1498,42.5023,188,505,0.755988023952096
"11741",226833,"MIDWESTERN STATE UNIVERSITY",1,0,1998,685,350,335,74,26,48,0.137,0.108,0.078,1789,43.715426,192,531,0.775182481751825
"11742",226833,"MIDWESTERN STATE UNIVERSITY",1,0,1999,732,409,323,67,21,46,0.112,0.092,0.065,1140,46.293775,197,550,0.751366120218579
"11743",226833,"MIDWESTERN STATE UNIVERSITY",1,0,2000,696,355,341,64,33,31,0.087,0.092,0.097,1200,53.216812,198,495,0.711206896551724
"11744",226833,"MIDWESTERN STATE UNIVERSITY",1,0,2001,668,376,292,69,22,47,0.125,0.103,0.075,1260,52.00426,199,480,0.718562874251497
"11745",226833,"MIDWESTERN STATE UNIVERSITY",1,0,2002,624,327,297,66,23,43,0.132,0.106,0.077,1320,52.289881,200,461,0.738782051282051
"11746",226833,"MIDWESTERN STATE UNIVERSITY",1,0,2003,613,302,311,41,18,23,0.076,0.067,0.058,1380,56.179928,200,438,0.714518760195759
"11747",226833,"MIDWESTERN STATE UNIVERSITY",1,0,2004,611,301,310,35,13,22,0.073,0.057,0.042,1152,55.905381,215,391,0.639934533551555
"11748",226833,"Midwestern State University",1,0,2005,818,447,371,100,27,73,0.163,0.122,0.073,1200,58.960245,203,544,0.665036674816626
"11749",226833,"Midwestern State University",1,0,2006,657,355,302,108,33,75,0.211,0.164,0.109,1200,65.426356,216,481,0.732115677321157
"11750",226833,"Midwestern State University",1,0,2007,735,384,351,118,43,75,0.195,0.161,0.123,1200,69.988028,213,542,0.737414965986395
"11751",226833,"Midwestern State University",1,0,2008,706,405,301,119,44,75,0.185,0.169,0.146,1200,73.077027,212,490,0.694050991501416
"11752",226833,"Midwestern State University",1,0,2009,701,386,315,139,40,99,0.256,0.198,0.127,1200,76.396886,225,487,0.69472182596291
"11753",226833,"Midwestern State University",1,0,2010,742,380,362,141,39,102,0.268,0.19,0.108,1200,86.464611,226,511,0.688679245283019
"11754",227216,"UNIVERSITY OF NORTH TEXAS",1,0,1991,2085,1169,916,210,62,148,0.127,0.101,0.068,1046,172.947061,782,1655,0.793764988009592
"11755",227216,"UNIVERSITY OF NORTH TEXAS",1,0,1992,1794,1014,780,191,41,150,0.148,0.106,0.053,1196,183.753197,762,1382,0.770345596432553
"11756",227216,"UNIVERSITY OF NORTH TEXAS",1,0,1993,1872,1045,827,211,63,148,0.142,0.113,0.076,1273,197.91132,751,1457,0.778311965811966
"11757",227216,"UNIVERSITY OF NORTH TEXAS",1,0,1995,2134,1180,954,201,50,151,0.128,0.094,0.052,1439,203.698685,733,1597,0.748359887535145
"11758",227216,"UNIVERSITY OF NORTH TEXAS",1,0,1996,2268,1304,964,256,70,186,0.143,0.113,0.073,1705,211.00219,735,1630,0.718694885361552
"11759",227216,"UNIVERSITY OF NORTH TEXAS",1,0,1997,2292,1310,982,303,83,220,0.168,0.132,0.085,1776,217.04399,725,1646,0.718150087260035
"11760",227216,"UNIVERSITY OF NORTH TEXAS",1,0,1998,2449,1400,1049,363,105,258,0.184,0.148,0.1,2075,232.442596,729,1772,0.723560636994692
"11761",227216,"UNIVERSITY OF NORTH TEXAS",1,0,1999,2687,1550,1137,410,111,299,0.193,0.153,0.098,1656,245.743878,729,1903,0.708224786006699
"11762",227216,"UNIVERSITY OF NORTH TEXAS",1,0,2000,2841,1664,1177,515,142,373,0.224,0.181,0.121,1824,266.650173,752,2003,0.705033438929954
"11763",227216,"UNIVERSITY OF NORTH TEXAS",1,0,2001,2803,1665,1138,466,146,320,0.192,0.166,0.128,2016,307.283688,775,2005,0.715305030324652
"11764",227216,"UNIVERSITY OF NORTH TEXAS",1,0,2002,2912,1683,1229,523,147,376,0.223,0.18,0.12,2288,324.81857,808,2044,0.701923076923077
"11765",227216,"UNIVERSITY OF NORTH TEXAS",1,0,2003,3320,1945,1375,632,194,438,0.225,0.19,0.141,2392,328.331659,786,2310,0.69578313253012
"11766",227216,"UNIVERSITY OF NORTH TEXAS",1,0,2004,3216,1872,1344,611,180,431,0.23,0.19,0.134,3444,339.440111,824,2234,0.694651741293532
"11767",227216,"University of North Texas",1,0,2005,3557,2008,1549,760,214,546,0.272,0.214,0.138,3144,364.641039,838,2363,0.664323868428451
"11768",227216,"University of North Texas",1,0,2006,3599,2039,1560,784,252,532,0.261,0.218,0.162,3372,380.301742,836,2385,0.662684078910809
"11769",227216,"University of North Texas",1,0,2007,3495,1996,1499,862,254,608,0.305,0.247,0.169,4035,389.77723,871,2236,0.639771101573677
"11770",227216,"University of North Texas",1,0,2008,3442,1928,1514,891,271,620,0.322,0.259,0.179,4528,431.777404,898,2187,0.635386403253922
"11771",227216,"University of North Texas",1,0,2009,3255,1832,1423,881,271,610,0.333,0.271,0.19,5060,476.020312,960,1888,0.580030721966206
"11772",227216,"University of North Texas",1,0,2010,3534,1908,1626,1009,345,664,0.348,0.286,0.212,5363,537.279494,1004,1857,0.525466893039049
"11773",227331,"OUR LADY OF THE LAKE UNIVERSITY SAN ANTONIO",1,0,1991,361,278,83,38,6,32,0.115,0.105,0.072,6472,19.243646,92,34,0.0941828254847645
"11774",227331,"OUR LADY OF THE LAKE UNIVERSITY SAN ANTONIO",1,0,1992,315,241,74,40,8,32,0.133,0.127,0.108,7564,21.892542,95,39,0.123809523809524
"11775",227331,"OUR LADY OF THE LAKE UNIVERSITY-SAN ANTONIO",1,0,1993,291,224,67,29,0,29,0.13,0.1,0,8160,24.409168,101,31,0.106529209621993
"11776",227331,"OUR LADY OF THE LAKE UNIVERSITY-SAN ANTONIO",1,0,1995,258,189,69,34,8,26,0.138,0.132,0.116,9134,30.176842,102,24,0.0930232558139535
"11777",227331,"OUR LADY OF THE LAKE UNIVERSITY-SAN ANTONIO",1,0,1996,355,257,98,66,12,54,0.21,0.186,0.122,9674,30.668404,109,47,0.132394366197183
"11778",227331,"OUR LADY OF THE LAKE UNIVERSITY-SAN ANTONIO",1,0,1997,372,293,79,59,10,49,0.167,0.159,0.127,10366,27.132316,121,58,0.155913978494624
"11779",227331,"OUR LADY OF THE LAKE UNIVERSITY-SAN ANTONIO",1,0,1998,310,251,59,50,2,48,0.191,0.161,0.034,10872,30.333403,124,49,0.158064516129032
"11780",227331,"OUR LADY OF THE LAKE UNIVERSITY-SAN ANTONIO",1,0,1999,308,241,67,44,10,34,0.141,0.143,0.149,11150,32.008226,128,36,0.116883116883117
"11781",227331,"OUR LADY OF THE LAKE UNIVERSITY-SAN ANTONIO",1,0,2000,267,205,62,42,7,35,0.171,0.157,0.113,11708,34.494742,128,24,0.0898876404494382
"11782",227331,"OUR LADY OF THE LAKE UNIVERSITY-SAN ANTONIO",1,0,2001,401,323,78,49,7,42,0.13,0.122,0.09,12528,37.820802,128,37,0.0922693266832918
"11783",227331,"OUR LADY OF THE LAKE UNIVERSITY-SAN ANTONIO",1,0,2002,331,241,90,55,11,44,0.183,0.166,0.122,13404,40.969279,129,27,0.081570996978852
"11784",227331,"OUR LADY OF THE LAKE UNIVERSITY-SAN ANTONIO",1,0,2003,322,238,84,60,10,50,0.21,0.186,0.119,14650,42.833219,83,53,0.164596273291925
"11785",227331,"OUR LADY OF THE LAKE UNIVERSITY-SAN ANTONIO",1,0,2004,216,171,45,30,3,27,0.158,0.139,0.067,15594,44.987228,125,28,0.12962962962963
"11786",227331,"Our Lady of the Lake University-San Antonio",1,0,2005,269,204,65,1,1,0,0,0.004,0.015,17048,45.144969,118,28,0.104089219330855
"11787",227331,"Our Lady of the Lake University-San Antonio",1,0,2006,262,195,67,27,6,21,0.108,0.103,0.09,17900,44.739842,97,24,0.0916030534351145
"11788",227331,"Our Lady of the Lake University-San Antonio",1,0,2007,283,189,94,51,13,38,0.201,0.18,0.138,18616,44.541263,112,25,0.088339222614841
"11789",227331,"Our Lady of the Lake University-San Antonio",1,0,2008,306,213,93,67,14,53,0.249,0.219,0.151,19732,42.494973,111,30,0.0980392156862745
"11790",227331,"Our Lady of the Lake University-San Antonio",1,0,2009,246,170,76,54,14,40,0.235,0.22,0.184,20324,42.753777,108,21,0.0853658536585366
"11791",227331,"Our Lady of the Lake University-San Antonio",1,0,2010,299,219,80,77,18,59,0.269,0.258,0.225,21400,43.867877,112,46,0.153846153846154
"11792",227526,"PRAIRIE VIEW A & M UNIVERSITY",1,0,1991,1116,534,582,91,24,67,0.126,0.082,0.041,1148,57.222185,234,13,0.0116487455197133
"11793",227526,"PRAIRIE VIEW A & M UNIVERSITY",1,0,1992,1194,579,615,261,97,164,0.283,0.219,0.158,1316,65.521054,245,24,0.0201005025125628
"11794",227526,"PRAIRIE VIEW A & M UNIVERSITY",1,0,1993,1208,610,598,110,27,83,0.136,0.091,0.045,1537,71.62102,232,32,0.0264900662251656
"11795",227526,"PRAIRIE VIEW A & M UNIVERSITY",1,0,1995,1114,536,578,105,29,76,0.142,0.094,0.05,1926,72.611315,235,20,0.0179533213644524
"11796",227526,"PRAIRIE VIEW A & M UNIVERSITY",1,0,1996,1166,568,598,133,48,85,0.15,0.114,0.08,2146,80.03708,234,21,0.0180102915951973
"11797",227526,"PRAIRIE VIEW A & M UNIVERSITY",1,0,1997,1183,670,513,127,34,93,0.139,0.107,0.066,2436,80.278261,235,10,0.0084530853761623
"11798",227526,"PRAIRIE VIEW A & M UNIVERSITY",1,0,1998,1197,626,571,132,42,90,0.144,0.11,0.074,2496,82.621703,236,11,0.00918964076858814
"11799",227526,"PRAIRIE VIEW A & M UNIVERSITY",1,0,1999,967,504,463,113,33,80,0.159,0.117,0.071,1140,90.688011,289,5,0.00517063081695967
"11800",227526,"PRAIRIE VIEW A & M UNIVERSITY",1,0,2000,1230,657,573,163,46,117,0.178,0.133,0.08,1200,97.338866,273.5,21,0.0170731707317073
"11801",227526,"PRAIRIE VIEW A & M UNIVERSITY",1,0,2001,1380,771,609,182,62,120,0.156,0.132,0.102,1260,102.038833,258,17,0.0123188405797101
"11802",227526,"PRAIRIE VIEW A & M UNIVERSITY",1,0,2002,1431,769,662,222,74,148,0.192,0.155,0.112,1320,99.871231,280,22,0.0153738644304682
"11803",227526,"PRAIRIE VIEW A & M UNIVERSITY",1,0,2003,1553,820,733,175,71,104,0.127,0.113,0.097,1380,114.213079,343,17,0.0109465550547328
"11804",227526,"PRAIRIE VIEW A & M UNIVERSITY",1,0,2004,1573,823,750,156,56,100,0.122,0.099,0.075,1440,121.024856,334,17,0.0108073744437381
"11805",227526,"Prairie View A & M University",1,0,2005,1155,668,487,126,39,87,0.13,0.109,0.08,1500,134.845367,327,18,0.0155844155844156
"11806",227526,"Prairie View A & M University",1,0,2006,1231,689,542,121,28,93,0.135,0.098,0.052,3765,151.769792,341,11,0.00893582453290008
"11807",227526,"Prairie View A & M University",1,0,2007,1391,784,607,155,36,119,0.152,0.111,0.059,4350,153.728597,333,18,0.01294033069734
"11808",227526,"Prairie View A & M University",1,0,2008,1290,761,529,355,112,243,0.319,0.275,0.212,4590,172.439694,340,35,0.0271317829457364
"11809",227526,"Prairie View A & M University",1,0,2009,1638,957,681,180,42,138,0.144,0.11,0.062,4884,180.428255,341,21,0.0128205128205128
"11810",227526,"Prairie View A & M University",1,0,2010,1731,1046,685,154,43,111,0.106,0.089,0.063,5077,186.491247,347,24,0.0138648180242634
"11811",227757,"RICE UNIVERSITY",1,0,1991,625,257,368,437,239,198,0.77,0.699,0.649,7700,159.911,421,416,0.6656
"11812",227757,"RICE UNIVERSITY",1,0,1992,598,266,332,437,221,216,0.812,0.731,0.666,8500,169.541,416,416,0.695652173913043
"11813",227757,"RICE UNIVERSITY",1,0,1993,639,281,358,440,228,212,0.754,0.689,0.637,9644,175.404,422,421,0.658841940532081
"11814",227757,"RICE UNIVERSITY",1,0,1995,688,338,350,472,213,259,0.766,0.686,0.609,11122,196.747,449,409,0.594476744186046
"11815",227757,"RICE UNIVERSITY",1,0,1996,668,314,354,499,240,259,0.825,0.747,0.678,12031,206.849,435,354,0.529940119760479
"11816",227757,"RICE UNIVERSITY",1,0,1997,703,334,369,516,248,268,0.802,0.734,0.672,13094,197.401,436,451,0.64153627311522
"11817",227757,"RICE UNIVERSITY",1,0,1998,642,320,322,489,228,261,0.816,0.762,0.708,14131,206.452,455,403,0.627725856697819
"11818",227757,"RICE UNIVERSITY",1,0,1999,670,325,345,512,251,261,0.803,0.764,0.728,15350,221.204,463,393,0.586567164179104
"11819",227757,"RICE UNIVERSITY",1,0,2000,628,290,338,498,249,249,0.859,0.793,0.737,15438,240.152614,467,423,0.673566878980892
"11820",227757,"RICE UNIVERSITY",1,0,2001,657,326,331,509,247,262,0.804,0.775,0.746,16300,259.349905,471,343,0.5220700152207
"11821",227757,"RICE UNIVERSITY",1,0,2002,700,318,382,570,301,269,0.846,0.814,0.788,16925,287.789,503,388,0.554285714285714
"11822",227757,"RICE UNIVERSITY",1,0,2003,716,364,352,591,279,312,0.857,0.825,0.793,17800,315.703,530,393,0.548882681564246
"11823",227757,"RICE UNIVERSITY",1,0,2004,725,380,345,574,259,315,0.829,0.792,0.751,18863,334.114,545,416,0.573793103448276
"11824",227757,"Rice University",1,0,2005,722,337,385,571,279,292,0.867,0.791,0.725,21203,350.287,567,386,0.534626038781163
"11825",227757,"Rice University",1,0,2006,713,357,356,597,282,315,0.882,0.837,0.792,23786,371.338,567,338,0.474053295932679
"11826",227757,"Rice University",1,0,2007,742,346,396,585,288,297,0.858,0.788,0.727,26633,396.099,583,340,0.45822102425876
"11827",227757,"Rice University",1,0,2008,777,386,391,636,307,329,0.852,0.819,0.785,29188,424.186,598,339,0.436293436293436
"11828",227757,"Rice University",1,0,2009,887,427,460,710,342,368,0.862,0.8,0.743,31303,467.279,619,355,0.400225479143179
"11829",227757,"Rice University",1,0,2010,944,453,491,783,376,407,0.898,0.829,0.766,33120,498.393,627,416,0.440677966101695
"11830",227845,"SAINT EDWARD'S UNIVERSITY",1,0,1991,347,198,149,67,22,45,0.227,0.193,0.148,7764,24.062579,81,168,0.484149855907781
"11831",227845,"SAINT EDWARD'S UNIVERSITY",1,0,1992,337,196,141,57,27,30,0.153,0.169,0.191,8376,26.352351,80,169,0.501483679525223
"11832",227845,"SAINT EDWARDS UNIVERSITY",1,0,1993,370,235,135,98,32,66,0.281,0.265,0.237,8902,28.640744,83,194,0.524324324324324
"11833",227845,"SAINT EDWARDS UNIVERSITY",1,0,1995,387,230,157,119,37,82,0.356,0.307,0.236,9950,31.507383,91,199,0.51421188630491
"11834",227845,"SAINT EDWARDS UNIVERSITY",1,0,1996,373,239,134,107,35,72,0.301,0.287,0.261,10400,32.266361,93,197,0.528150134048257
"11835",227845,"SAINT EDWARDS UNIVERSITY",1,0,1997,359,216,143,98,38,60,0.278,0.273,0.266,10730,26.563479,92,197,0.54874651810585
"11836",227845,"SAINT EDWARDS UNIVERSITY",1,0,1998,367,212,155,95,34,61,0.288,0.259,0.219,11160,28.126643,91,192,0.523160762942779
"11837",227845,"SAINT EDWARDSS UNIVERSITY",1,0,1999,357,184,173,101,35,66,0.359,0.283,0.202,11438,30.822459,99,182,0.509803921568627
"11838",227845,"SAINT EDWARD'S UNIVERSITY",1,0,2000,397,207,190,118,42,76,0.367,0.297,0.221,11896,34.151644,108.5,223,0.561712846347607
"11839",227845,"SAINT EDWARD'S UNIVERSITY",1,0,2001,413,254,159,131,37,94,0.37,0.317,0.233,12728,40.356858,118,220,0.532687651331719
"11840",227845,"SAINT EDWARD'S UNIVERSITY",1,0,2002,445,255,190,164,60,104,0.408,0.369,0.316,13620,48.037789,125,256,0.575280898876405
"11841",227845,"SAINT EDWARD'S UNIVERSITY",1,0,2003,544,327,217,239,78,161,0.492,0.439,0.359,14710,54.396344,139,296,0.544117647058823
"11842",227845,"SAINT EDWARD'S UNIVERSITY",1,0,2004,600,371,229,291,97,194,0.523,0.485,0.424,15960,58.933367,141,334,0.556666666666667
"11843",227845,"Saint Edward's University",1,0,2005,646,401,245,333,109,224,0.559,0.515,0.445,17320,64.190115,155,341,0.527863777089783
"11844",227845,"Saint Edward's University",1,0,2006,698,423,275,372,144,228,0.539,0.533,0.524,18800,71.554008,169,387,0.554441260744986
"11845",227845,"Saint Edward's University",1,0,2007,725,437,288,372,127,245,0.561,0.513,0.441,20400,77.088343,182,413,0.569655172413793
"11846",227845,"Saint Edward's University",1,0,2008,741,480,261,397,121,276,0.575,0.536,0.464,22150,83.413485,188,406,0.547908232118758
"11847",227845,"Saint Edward's University",1,0,2009,755,470,285,383,123,260,0.553,0.507,0.432,24040,88.520278,187,400,0.529801324503311
"11848",227845,"Saint Edward's University",1,0,2010,770,505,265,403,122,281,0.556,0.523,0.46,26084,93.142107,198,361,0.468831168831169
"11849",227863,"UNIVERSITY OF SAINT THOMAS",1,0,1991,170,114,56,64,22,42,0.368,0.376,0.393,6830,11.561315,86,79,0.464705882352941
"11850",227863,"UNIVERSITY OF SAINT THOMAS",1,0,1992,173,123,50,2,0,2,0.016,0.012,0,7442,14.001532,88,79,0.456647398843931
"11851",227863,"UNIVERSITY OF SAINT THOMAS",1,0,1993,192,129,63,53,13,40,0.31,0.276,0.206,8042,16.304907,91,90,0.46875
"11852",227863,"UNIVERSITY OF SAINT THOMAS",1,0,1995,232,145,87,58,17,41,0.283,0.25,0.195,9423,18.918664,97,102,0.439655172413793
"11853",227863,"UNIVERSITY OF SAINT THOMAS",1,0,1996,222,136,86,55,19,36,0.265,0.248,0.221,9975,20.545759,114,102,0.459459459459459
"11854",227863,"UNIVERSITY OF SAINT THOMAS",1,0,1997,235,155,80,58,19,39,0.252,0.247,0.238,10577,19.770635,98,105,0.446808510638298
"11855",227863,"UNIVERSITY OF SAINT THOMAS",1,0,1998,231,153,78,65,12,53,0.346,0.281,0.154,11210,21.781016,101,93,0.402597402597403
"11856",227863,"UNIVERSITY OF ST THOMAS",1,0,1999,215,128,87,50,16,34,0.266,0.233,0.184,11700,23.589187,102,102,0.474418604651163
"11857",227863,"UNIVERSITY OF ST THOMAS",1,0,2000,303,207,96,72,19,53,0.256,0.238,0.198,12300,25.206606,107,98,0.323432343234323
"11858",227863,"UNIVERSITY OF ST THOMAS",1,0,2001,272,166,106,68,23,45,0.271,0.25,0.217,13050,28.321685,112,102,0.375
"11859",227863,"UNIVERSITY OF ST THOMAS",1,0,2002,276,174,102,65,15,50,0.287,0.236,0.147,13800,32.116735,117,98,0.355072463768116
"11860",227863,"UNIVERSITY OF ST THOMAS",1,0,2003,292,172,120,87,33,54,0.314,0.298,0.275,15000,32.231019,114,116,0.397260273972603
"11861",227863,"UNIVERSITY OF ST THOMAS",1,0,2004,297,189,108,80,24,56,0.296,0.269,0.222,16200,35.162072,117,116,0.390572390572391
"11862",227863,"University of St Thomas",1,0,2005,289,185,104,75,27,48,0.26,0.26,0.26,16950,37.158277,121,108,0.373702422145329
"11863",227863,"University of St Thomas",1,0,2006,291,187,104,93,26,67,0.358,0.32,0.25,17700,39.698104,129,103,0.353951890034364
"11864",227863,"University of St Thomas",1,0,2007,288,179,109,77,25,52,0.291,0.267,0.229,18900,43.870268,131,98,0.340277777777778
"11865",227863,"University of St Thomas",1,0,2008,293,187,106,101,30,71,0.38,0.345,0.283,20190,46.968129,132,86,0.293515358361775
"11866",227863,"University of St Thomas",1,0,2009,284,181,103,106,34,72,0.398,0.373,0.33,21510,49.244191,125,104,0.366197183098592
"11867",227863,"University of St Thomas",1,0,2010,191,127,64,63,14,49,0.386,0.33,0.219,23160,48.314427,135,58,0.303664921465969
"11868",228042,"SCHREINER COLLEGE",1,0,1991,156,79,77,27,15,12,0.152,0.173,0.195,7385,8.576732,35,114,0.730769230769231
"11869",228042,"SCHREINER COLLEGE",1,0,1992,140,75,65,12,3,9,0.12,0.086,0.046,7975,8.862399,35,99,0.707142857142857
"11870",228042,"SCHREINER COLLEGE",1,0,1993,134,77,57,26,10,16,0.208,0.194,0.175,8610,9.759594,40,98,0.73134328358209
"11871",228042,"SCHREINER COLLEGE",1,0,1995,221,107,114,35,15,20,0.187,0.158,0.132,9335,10.540832,33,148,0.669683257918552
"11872",228042,"SCHREINER COLLEGE",1,0,1996,180,112,68,34,10,24,0.214,0.189,0.147,9735,11.726044,39,148,0.822222222222222
"11873",228042,"SCHREINER COLLEGE",1,0,1997,194,116,78,40,16,24,0.207,0.206,0.205,9900,9.331404,39,150,0.77319587628866
"11874",228042,"SCHREINER COLLEGE",1,0,1998,198,118,80,39,17,22,0.186,0.197,0.212,10490,9.54325,43,157,0.792929292929293
"11875",228042,"SCHREINER COLLEGE",1,0,1999,225,148,77,44,7,37,0.25,0.196,0.091,10990,11.307096,41,174,0.773333333333333
"11876",228042,"SCHREINER COLLEGE",1,0,2000,207,124,83,40,16,24,0.194,0.193,0.193,11540,12.26407,43,171,0.826086956521739
"11877",228042,"SCHREINER UNIVERSITY",1,0,2001,180,110,70,46,12,34,0.309,0.256,0.171,12118,17.470123,45,146,0.811111111111111
"11878",228042,"SCHREINER UNIVERSITY",1,0,2002,165,80,85,45,18,27,0.338,0.273,0.212,12118,16.780747,49,119,0.721212121212121
"11879",228042,"SCHREINER UNIVERSITY",1,0,2003,168,88,80,40,14,26,0.296,0.238,0.175,13240,16.899283,47,132,0.785714285714286
"11880",228042,"SCHREINER UNIVERSITY",1,0,2004,204,122,82,53,20,33,0.27,0.26,0.244,14040,15.463017,53,154,0.754901960784314
"11881",228042,"Schreiner University",1,0,2005,167,92,75,50,19,31,0.337,0.299,0.253,14742,16.396678,51,105,0.62874251497006
"11882",228042,"Schreiner University",1,0,2006,243,128,115,57,20,37,0.289,0.235,0.174,15479,17.975255,54,173,0.711934156378601
"11883",228042,"Schreiner University",1,0,2007,262,135,127,92,36,56,0.415,0.351,0.283,16408,17.435034,56,179,0.683206106870229
"11884",228042,"Schreiner University",1,0,2008,266,145,121,84,34,50,0.345,0.316,0.281,17392,18.731031,59,183,0.68796992481203
"11885",228042,"Schreiner University",1,0,2009,289,155,134,98,44,54,0.348,0.339,0.328,18132,19.864017,60,190,0.657439446366782
"11886",228042,"Schreiner University",1,0,2010,253,150,103,106,40,66,0.44,0.419,0.388,18948,21.552816,59,163,0.644268774703557
"11887",228149,"SAINT MARY'S UNIVERSITY",1,0,1991,429,260,169,131,43,88,0.338,0.305,0.254,7170,38.588757,159,103,0.24009324009324
"11888",228149,"SAINT MARY'S UNIVERSITY",1,0,1992,491,285,206,139,43,96,0.337,0.283,0.209,8000,42.430628,149,116,0.236252545824847
"11889",228149,"SAINT MARYS UNIVERSITY",1,0,1993,402,231,171,125,34,91,0.394,0.311,0.199,8276,45.105206,169,114,0.283582089552239
"11890",228149,"SAINT MARYS UNIVERSITY",1,0,1995,452,254,198,123,34,89,0.35,0.272,0.172,9527,53.204615,177,113,0.25
"11891",228149,"ST MARYS UNIVERSITY",1,0,1996,507,312,195,177,56,121,0.388,0.349,0.287,9934,50.59905,180,122,0.240631163708087
"11892",228149,"ST MARYS UNIVERSITY",1,0,1997,507,311,196,170,50,120,0.386,0.335,0.255,10668,48.115461,182,105,0.207100591715976
"11893",228149,"ST MARYS UNIVERSITY",1,0,1998,499,313,186,147,49,98,0.313,0.295,0.263,11280,52.022283,178,114,0.228456913827655
"11894",228149,"ST MARYS UNIVERSITY",1,0,1999,485,277,208,165,54,111,0.401,0.34,0.26,11500,50.651917,191,101,0.208247422680412
"11895",228149,"ST MARYS UNIVERSITY",1,0,2000,656,399,257,201,60,141,0.353,0.306,0.233,12160,53.544885,187,143,0.217987804878049
"11896",228149,"ST MARYS UNIVERSITY",1,0,2001,534,299,235,181,72,109,0.365,0.339,0.306,12980,57.856915,183,92,0.172284644194757
"11897",228149,"ST MARYS UNIVERSITY",1,0,2002,667,397,270,214,63,151,0.38,0.321,0.233,14727,61.66982,185,136,0.203898050974513
"11898",228149,"ST MARYS UNIVERSITY",1,0,2003,470,292,178,147,41,106,0.363,0.313,0.23,15992,67.603298,189,107,0.227659574468085
"11899",228149,"ST MARYS UNIVERSITY",1,0,2004,463,277,186,159,51,108,0.39,0.343,0.274,17256,69.720367,190,93,0.200863930885529
"11900",228149,"St Marys University",1,0,2005,494,314,180,147,38,109,0.347,0.298,0.211,18274,71.00437,184,73,0.147773279352227
"11901",228149,"St Marys University",1,0,2006,548,347,201,187,39,148,0.426,0.341,0.194,19334,71.982818,183,99,0.180656934306569
"11902",228149,"St Marys University",1,0,2007,565,334,231,187,54,133,0.398,0.331,0.234,20300,73.452126,187,110,0.194690265486726
"11903",228149,"St Marys University",1,0,2008,535,335,200,237,63,174,0.519,0.443,0.315,20600,78.363433,192,87,0.162616822429907
"11904",228149,"St Marys University",1,0,2009,530,335,195,270,76,194,0.579,0.509,0.39,21320,80.413342,197,99,0.186792452830189
"11905",228149,"St Marys University",1,0,2010,585,358,227,249,85,164,0.458,0.426,0.374,21980,84.772635,196,84,0.143589743589744
"11906",228246,"SOUTHERN METHODIST UNIVERSITY",1,0,1991,1229,652,577,671,289,382,0.586,0.546,0.501,11768,150.722,490,1004,0.816924328722539
"11907",228246,"SOUTHERN METHODIST UNIVERSITY",1,0,1992,1221,634,587,663,274,389,0.614,0.543,0.467,12688,159.447,484,961,0.787059787059787
"11908",228246,"SOUTHERN METHODIST UNIVERSITY",1,0,1993,1161,630,531,657,265,392,0.622,0.566,0.499,13580,165.979,483,861,0.741602067183463
"11909",228246,"SOUTHERN METHODIST UNIVERSITY",1,0,1995,1228,662,566,743,287,456,0.689,0.605,0.507,15228,180.395,485,963,0.784201954397394
"11910",228246,"SOUTHERN METHODIST UNIVERSITY",1,0,1996,1217,663,554,687,270,417,0.629,0.565,0.487,15990,186.298,493,936,0.769104354971241
"11911",228246,"SOUTHERN METHODIST UNIVERSITY",1,0,1997,1247,686,561,702,282,420,0.612,0.563,0.503,16790,181.058,502,977,0.783480352846832
"11912",228246,"SOUTHERN METHODIST UNIVERSITY",1,0,1998,1306,720,586,689,249,440,0.611,0.528,0.425,17628,200.242,500,975,0.746554364471669
"11913",228246,"SOUTHERN METHODIST UNIVERSITY",1,0,1999,1331,688,643,656,262,394,0.573,0.493,0.407,16422,225.03,519,1002,0.752817430503381
"11914",228246,"SOUTHERN METHODIST UNIVERSITY",1,0,2000,1276,713,563,736,280,456,0.64,0.577,0.497,17406,248.689,519.5,981,0.768808777429467
"11915",228246,"SOUTHERN METHODIST UNIVERSITY",1,0,2001,1353,713,640,751,297,454,0.637,0.555,0.464,18450,253.317,520,1073,0.793052475979305
"11916",228246,"SOUTHERN METHODIST UNIVERSITY",1,0,2002,1380,764,616,811,315,496,0.649,0.588,0.511,19466,254.145,535,1080,0.782608695652174
"11917",228246,"SOUTHERN METHODIST UNIVERSITY",1,0,2003,1383,772,611,853,324,529,0.685,0.617,0.53,20926,265.405,563,1049,0.758496023138106
"11918",228246,"SOUTHERN METHODIST UNIVERSITY",1,0,2004,1313,717,596,789,310,479,0.668,0.601,0.52,22496,281.996,575,1015,0.773038842345773
"11919",228246,"Southern Methodist University",1,0,2005,1401,754,647,846,345,501,0.665,0.604,0.533,23846,299.859,603,1120,0.7994289793005
"11920",228246,"Southern Methodist University",1,0,2006,1369,753,616,937,377,560,0.744,0.684,0.612,25400,315.857,609,1069,0.780861943024105
"11921",228246,"Southern Methodist University",1,0,2007,1306,697,609,870,359,511,0.733,0.666,0.589,27400,346.441,633,1042,0.797856049004594
"11922",228246,"Southern Methodist University",1,0,2008,1397,751,646,941,404,537,0.715,0.674,0.625,29430,367.195,656,1050,0.751610594130279
"11923",228246,"Southern Methodist University",1,0,2009,1325,702,623,886,374,512,0.729,0.669,0.6,31200,406.929,660,958,0.723018867924528
"11924",228246,"Southern Methodist University",1,0,2010,1476,786,690,1008,429,579,0.737,0.683,0.622,33040,394.227,668,1003,0.679539295392954
"11925",228343,"SOUTHWESTERN UNIVERSITY",1,0,1991,324,173,151,191,89,102,0.59,0.59,0.589,9400,22.624494,81,269,0.830246913580247
"11926",228343,"SOUTHWESTERN UNIVERSITY",1,0,1992,317,176,141,175,62,113,0.642,0.552,0.44,10300,23.732846,81,249,0.785488958990536
"11927",228343,"SOUTHWESTERN UNIVERSITY",1,0,1993,351,207,144,218,79,139,0.672,0.621,0.549,11000,24.472185,87,275,0.783475783475784
"11928",228343,"SOUTHWESTERN UNIVERSITY",1,0,1995,326,188,138,188,69,119,0.633,0.577,0.5,12700,27.397451,85,257,0.788343558282209
"11929",228343,"SOUTHWESTERN UNIVERSITY",1,0,1996,310,198,112,179,60,119,0.601,0.577,0.536,13400,28.685911,92,245,0.790322580645161
"11930",228343,"SOUTHWESTERN UNIVERSITY",1,0,1997,332,177,155,201,85,116,0.655,0.605,0.548,14000,29.667457,91,278,0.837349397590361
"11931",228343,"SOUTHWESTERN UNIVERSITY",1,0,1998,378,218,160,227,74,153,0.702,0.601,0.462,14600,32.191399,95,331,0.875661375661376
"11932",228343,"SOUTHWESTERN UNIVERSITY",1,0,1999,354,210,144,236,83,153,0.729,0.667,0.576,15000,35.325304,97,288,0.813559322033898
"11933",228343,"SOUTHWESTERN UNIVERSITY",1,0,2000,355,195,160,230,91,139,0.713,0.648,0.569,15750,39.255034,103.5,270,0.76056338028169
"11934",228343,"SOUTHWESTERN UNIVERSITY",1,0,2001,327,174,153,196,77,119,0.684,0.599,0.503,16650,41.894349,110,260,0.795107033639144
"11935",228343,"SOUTHWESTERN UNIVERSITY",1,0,2002,342,217,125,227,76,151,0.696,0.664,0.608,17570,44.023485,115,244,0.713450292397661
"11936",228343,"SOUTHWESTERN UNIVERSITY",1,0,2003,343,196,147,234,80,154,0.786,0.682,0.544,18870,44.274879,114,261,0.760932944606414
"11937",228343,"SOUTHWESTERN UNIVERSITY",1,0,2004,366,221,145,228,68,160,0.724,0.623,0.469,20220,44.724206,121,283,0.773224043715847
"11938",228343,"Southwestern University",1,0,2005,327,192,135,223,87,136,0.708,0.682,0.644,21900,48.006533,118,262,0.801223241590214
"11939",228343,"Southwestern University",1,0,2006,345,221,124,231,74,157,0.71,0.67,0.597,23650,51.346535,120,267,0.773913043478261
"11940",228343,"Southwestern University",1,0,2007,371,232,139,242,84,158,0.681,0.652,0.604,25740,52.696159,122,286,0.77088948787062
"11941",228343,"Southwestern University",1,0,2008,349,216,133,227,78,149,0.69,0.65,0.586,27940,53.644745,121,252,0.722063037249284
"11942",228343,"Southwestern University",1,0,2009,375,231,144,257,88,169,0.732,0.685,0.611,30220,55.130102,125,284,0.757333333333333
"11943",228343,"Southwestern University",1,0,2010,383,224,159,252,98,154,0.688,0.658,0.616,31630,58.887234,124,268,0.699738903394256
"11944",228431,"STEPHEN F AUSTIN STATE UNIVERSITY",1,0,1991,2047,1234,813,353,74,279,0.226,0.172,0.091,1042,81.893182,403,1841,0.899364924279433
"11945",228431,"STEPHEN F AUSTIN STATE UNIVERSITY",1,0,1992,2183,1255,928,332,95,237,0.189,0.152,0.102,1338,85.61685,408,1923,0.880897846999542
"11946",228431,"STEPHEN F AUSTIN STATE UNIVERSITY",1,0,1993,2247,1255,992,308,81,227,0.181,0.137,0.082,1515,92.487124,391,1946,0.866043613707165
"11947",228431,"STEPHEN F AUSTIN STATE UNIVERSITY",1,0,1995,1714,986,728,275,69,206,0.209,0.16,0.095,1907,98.017166,378,1481,0.864060676779463
"11948",228431,"STEPHEN F AUSTIN STATE UNIVERSITY",1,0,1996,2007,1188,819,332,71,261,0.22,0.165,0.087,2127,99.049077,383,1632,0.813153961136024
"11949",228431,"STEPHEN F AUSTIN STATE UNIVERSITY",1,0,1997,2360,1422,938,358,71,287,0.202,0.152,0.076,2247,103.833622,402,1854,0.785593220338983
"11950",228431,"STEPHEN F AUSTIN STATE UNIVERSITY",1,0,1998,2348,1432,916,388,69,319,0.223,0.165,0.075,2408,109.577554,406,1830,0.7793867120954
"11951",228431,"STEPHEN F AUSTIN STATE UNIVERSITY",1,0,1999,2255,1353,902,339,92,247,0.183,0.15,0.102,1140,119.77498,412,1719,0.762305986696231
"11952",228431,"STEPHEN F AUSTIN STATE UNIVERSITY",1,0,2000,2210,1371,839,370,88,282,0.206,0.167,0.105,960,121.068522,411.5,1624,0.734841628959276
"11953",228431,"STEPHEN F AUSTIN STATE UNIVERSITY",1,0,2001,2191,1370,821,360,90,270,0.197,0.164,0.11,1728,124.909658,411,1521,0.694203560018256
"11954",228431,"STEPHEN F AUSTIN STATE UNIVERSITY",1,0,2002,2006,1229,777,314,83,231,0.188,0.157,0.107,1848,128.089814,442,1452,0.72382851445663
"11955",228431,"STEPHEN F AUSTIN STATE UNIVERSITY",1,0,2003,1839,1148,691,348,88,260,0.226,0.189,0.127,2088,134.207608,430,1322,0.718868950516585
"11956",228431,"STEPHEN F AUSTIN STATE UNIVERSITY",1,0,2004,1736,1091,645,381,95,286,0.262,0.219,0.147,2688,132.385124,417,1257,0.724078341013825
"11957",228431,"Stephen F Austin State University",1,0,2005,1967,1199,768,441,125,316,0.264,0.224,0.163,3024,132.558081,431,1343,0.682765632943569
"11958",228431,"Stephen F Austin State University",1,0,2006,2305,1420,885,538,132,406,0.286,0.233,0.149,3240,147.781955,432,1515,0.657266811279826
"11959",228431,"Stephen F Austin State University",1,0,2007,2268,1375,893,521,156,365,0.266,0.23,0.175,3528,165.056073,429,1421,0.626543209876543
"11960",228431,"Stephen F Austin State University",1,0,2008,2480,1545,935,590,131,459,0.297,0.238,0.14,3744,177.039213,432,1416,0.570967741935484
"11961",228431,"Stephen F Austin State University",1,0,2009,2553,1613,940,576,135,441,0.273,0.226,0.144,3864,186.147103,451,1440,0.564042303172738
"11962",228431,"Stephen F Austin State University",1,0,2010,2280,1473,807,556,128,428,0.291,0.244,0.159,4076,198.398044,447,1192,0.52280701754386
"11963",228459,"SOUTHWEST TEXAS STATE UNIVERSITY",1,0,1991,2916,1634,1282,201,61,140,0.086,0.069,0.048,1130,130.468332,625,2010,0.689300411522634
"11964",228459,"SOUTHWEST TEXAS STATE UNIVERSITY",1,0,1992,2310,1372,938,229,59,170,0.124,0.099,0.063,1406,141.567888,608,1690,0.731601731601732
"11965",228459,"SOUTHWEST TEXAS STATE UNIVERSITY",1,0,1993,2281,1358,923,248,62,186,0.137,0.109,0.067,1578,151.307807,641,1647,0.722051731696624
"11966",228459,"SOUTHWEST TEXAS STATE UNIVERSITY",1,0,1995,2426,1461,965,309,80,229,0.157,0.127,0.083,1588,160.430316,625,1802,0.742786479802143
"11967",228459,"SOUTHWEST TEXAS STATE UNIVERSITY",1,0,1996,2396,1472,924,408,88,320,0.217,0.17,0.095,2022,164.208432,625,1753,0.731636060100167
"11968",228459,"SOUTHWEST TEXAS STATE UNIVERSITY",1,0,1997,2331,1399,932,413,107,306,0.219,0.177,0.115,2214,172.908365,607,1737,0.745173745173745
"11969",228459,"SOUTHWEST TEXAS STATE UNIVERSITY",1,0,1998,2592,1546,1046,458,127,331,0.214,0.177,0.121,2388,184.818455,616,1923,0.741898148148148
"11970",228459,"SOUTHWEST TEXAS STATE UNIVERSITY",1,0,1999,2447,1479,968,504,130,374,0.253,0.206,0.134,1140,196.082904,635,1806,0.738046587658357
"11971",228459,"SOUTHWEST TEXAS STATE UNIVERSITY",1,0,2000,2531,1553,978,522,122,400,0.258,0.206,0.125,1200,215.742093,661.5,1873,0.740023706045042
"11972",228459,"SOUTHWEST TEXAS STATE UNIVERSITY",1,0,2001,2469,1508,961,553,134,419,0.278,0.224,0.139,1260,237.370082,688,1872,0.75820170109356
"11973",228459,"SOUTHWEST TEXAS STATE UNIVERSITY",1,0,2002,2674,1665,1009,587,140,447,0.268,0.22,0.139,2640,243.934789,693,1997,0.746821241585639
"11974",228459,"TEXAS STATE UNIVERSITY-SAN MARCOS",1,0,2003,2818,1681,1137,667,195,472,0.281,0.237,0.172,2208,279.646155,707,2104,0.746628814762243
"11975",228459,"TEXAS STATE UNIVERSITY-SAN MARCOS",1,0,2004,2783,1616,1167,691,187,504,0.312,0.248,0.16,2616,281.844471,736,2067,0.742723679482573
"11976",228459,"Texas State University-San Marcos",1,0,2005,3053,1786,1267,825,235,590,0.33,0.27,0.185,3024,299.589753,779,2172,0.711431378971503
"11977",228459,"Texas State University-San Marcos",1,0,2006,2975,1746,1229,815,250,565,0.324,0.274,0.203,3312,308.573489,833,2038,0.685042016806723
"11978",228459,"Texas State University-San Marcos",1,0,2007,3237,1900,1337,983,288,695,0.366,0.304,0.215,3840,367.634779,870,2148,0.663577386468953
"11979",228459,"Texas State University-San Marcos",1,0,2008,3444,2051,1393,916,289,627,0.306,0.266,0.207,4080,376.312167,934,2253,0.65418118466899
"11980",228459,"Texas State University-San Marcos",1,0,2009,3804,2260,1544,985,271,714,0.316,0.259,0.176,4368,430.605309,983,2371,0.6232912723449
"11981",228459,"Texas State University-San Marcos",1,0,2010,4033,2403,1630,1091,306,785,0.327,0.271,0.188,4584,463.135262,1053,2323,0.575998016364989
"11982",228501,"SUL ROSS STATE UNIVERSITY",1,0,1991,335,123,212,19,9,10,0.081,0.057,0.042,946,16.143323,91,154,0.459701492537313
"11983",228501,"SUL ROSS STATE UNIVERSITY",1,0,1992,278,124,154,17,6,11,0.089,0.061,0.039,1108,17.09829,90,130,0.467625899280576
"11984",228501,"SUL ROSS STATE UNIVERSITY",1,0,1993,317,107,210,23,9,14,0.131,0.073,0.043,1224,20.444199,95,145,0.457413249211356
"11985",228501,"SUL ROSS STATE UNIVERSITY",1,0,1995,393,140,253,34,16,18,0.129,0.087,0.063,1508,22.830552,102,205,0.521628498727735
"11986",228501,"SUL ROSS STATE UNIVERSITY",1,0,1996,355,135,220,22,8,14,0.104,0.062,0.036,1642,26.476051,106,175,0.492957746478873
"11987",228501,"SUL ROSS STATE UNIVERSITY",1,0,1997,280,113,167,20,12,8,0.071,0.071,0.072,1750,32.924034,117,138,0.492857142857143
"11988",228501,"SUL ROSS STATE UNIVERSITY",1,0,1998,316,113,203,26,10,16,0.142,0.082,0.049,1834,31.410202,118,148,0.468354430379747
"11989",228501,"SUL ROSS STATE UNIVERSITY",1,0,1999,227,95,132,25,11,14,0.147,0.11,0.083,912,30.107775,121,117,0.515418502202643
"11990",228501,"SUL ROSS STATE UNIVERSITY",1,0,2000,263,105,158,13,7,6,0.057,0.049,0.044,960,33.202508,116,130,0.494296577946768
"11991",228501,"SUL ROSS STATE UNIVERSITY",1,0,2001,333,124,209,28,7,21,0.169,0.084,0.033,1536,35.00788,111,139,0.417417417417417
"11992",228501,"SUL ROSS STATE UNIVERSITY",1,0,2002,315,130,185,14,3,11,0.085,0.044,0.016,1632,40.864015,117,98,0.311111111111111
"11993",228501,"SUL ROSS STATE UNIVERSITY",1,0,2003,357,163,194,30,11,19,0.117,0.084,0.057,1824,40.655116,118,127,0.355742296918768
"11994",228501,"SUL ROSS STATE UNIVERSITY",1,0,2004,275,113,162,25,11,14,0.124,0.091,0.068,2064,41.944331,118,115,0.418181818181818
"11995",228501,"Sul Ross State University",1,0,2005,329,127,202,31,19,12,0.094,0.094,0.094,2256,43.711019,121,132,0.401215805471125
"11996",228501,"Sul Ross State University",1,0,2006,192,73,119,22,8,14,0.192,0.115,0.067,2400,50.340754,125,81,0.421875
"11997",228501,"Sul Ross State University",1,0,2007,242,92,150,34,6,28,0.304,0.14,0.04,2688,50.282332,123,84,0.347107438016529
"11998",228501,"Sul Ross State University",1,0,2008,315,124,191,43,18,25,0.202,0.137,0.094,2784,53.331359,128,109,0.346031746031746
"11999",228501,"Sul Ross State University",1,0,2009,374,135,239,36,15,21,0.156,0.096,0.063,2928,53.907277,128,112,0.299465240641711
"12000",228501,"Sul Ross State University",1,0,2010,322,146,176,42,17,25,0.171,0.13,0.097,3072,57.673374,127,95,0.295031055900621
"12001",228529,"TARLETON STATE UNIVERSITY",1,0,1991,924,421,503,88,35,53,0.126,0.095,0.07,992,34.591335,196,806,0.872294372294372
"12002",228529,"TARLETON STATE UNIVERSITY",1,0,1992,942,428,514,69,28,41,0.096,0.073,0.054,1104,37.391181,198,833,0.884288747346072
"12003",228529,"TARLETON STATE UNIVERSITY",1,0,1993,923,432,491,82,24,58,0.134,0.089,0.049,1184,41.897391,204,829,0.898158179848321
"12004",228529,"TARLETON STATE UNIVERSITY",1,0,1995,1021,531,490,140,52,88,0.166,0.137,0.106,1566,41.781675,221,935,0.915768854064642
"12005",228529,"TARLETON STATE UNIVERSITY",1,0,1996,919,455,464,117,35,82,0.18,0.127,0.075,1774,43.688228,203,850,0.924918389553863
"12006",228529,"TARLETON STATE UNIVERSITY",1,0,1997,595,306,289,98,38,60,0.196,0.165,0.131,2331,45.852405,228,546,0.917647058823529
"12007",228529,"TARLETON STATE UNIVERSITY",1,0,1998,605,296,309,102,44,58,0.196,0.169,0.142,2412,52.001336,234,562,0.928925619834711
"12008",228529,"TARLETON STATE UNIVERSITY",1,0,1999,585,303,282,109,45,64,0.211,0.186,0.16,1488,53.278517,255,547,0.935042735042735
"12009",228529,"TARLETON STATE UNIVERSITY",1,0,2000,475,238,237,100,40,60,0.252,0.211,0.169,1608,66.696154,274.5,421,0.886315789473684
"12010",228529,"TARLETON STATE UNIVERSITY",1,0,2001,783,411,372,126,37,89,0.216,0.161,0.099,1728,74.596926,294,701,0.895274584929757
"12011",228529,"TARLETON STATE UNIVERSITY",1,0,2002,974,507,467,148,46,102,0.201,0.152,0.099,1920,81.138437,278,862,0.885010266940452
"12012",228529,"TARLETON STATE UNIVERSITY",1,0,2003,1277,686,591,201,62,139,0.203,0.157,0.105,2136,83.993663,281,1118,0.87548942834769
"12013",228529,"TARLETON STATE UNIVERSITY",1,0,2004,1178,655,523,200,59,141,0.215,0.17,0.113,2400,86.677793,284,1041,0.883701188455008
"12014",228529,"Tarleton State University",1,0,2005,1188,678,510,212,65,147,0.217,0.178,0.127,2640,91.914897,304,1013,0.852693602693603
"12015",228529,"Tarleton State University",1,0,2006,1256,667,589,230,94,136,0.204,0.183,0.16,2880,100.277431,315,1066,0.848726114649682
"12016",228529,"Tarleton State University",1,0,2007,1190,685,505,259,86,173,0.253,0.218,0.17,3120,109.010891,320,1011,0.849579831932773
"12017",228529,"Tarleton State University",1,0,2008,1274,722,552,276,92,184,0.255,0.217,0.167,3324,118.275543,359,1053,0.826530612244898
"12018",228529,"Tarleton State University",1,0,2009,1207,668,539,293,96,197,0.295,0.243,0.178,3324,133.205162,345,991,0.821043910521955
"12019",228529,"Tarleton State University",1,0,2010,1435,858,577,339,98,241,0.281,0.236,0.17,3455,142.869434,344,1129,0.786759581881533
"12020",228705,"TEXAS A & I UNIVERSITY",1,0,1991,979,465,514,49,16,33,0.071,0.05,0.031,882,42.780583,188,224,0.228804902962206
"12021",228705,"TEXAS A & I UNIVERSITY",1,0,1992,987,484,503,72,20,52,0.107,0.073,0.04,882,45.864114,188,234,0.237082066869301
"12022",228705,"TEXAS A & I UNIVERSITY",1,0,1993,1012,481,531,50,19,31,0.064,0.049,0.036,882,49.837504,192,268,0.264822134387352
"12023",228705,"TEXAS A & M UNIVERSITY-KINGSVILLE",1,0,1995,893,420,473,40,17,23,0.055,0.045,0.036,1418,53.63955,198,210,0.235162374020157
"12024",228705,"TEXAS A & M UNIVERSITY-KINGSVILLE",1,0,1996,916,406,510,55,22,33,0.081,0.06,0.043,1634,56.377022,186,253,0.276200873362445
"12025",228705,"TEXAS A & M UNIVERSITY-KINGSVILLE",1,0,1997,898,402,496,47,15,32,0.08,0.052,0.03,1774,63.690333,204,193,0.214922048997773
"12026",228705,"TEXAS A & M UNIVERSITY-KINGSVILLE",1,0,1998,872,375,497,73,34,39,0.104,0.084,0.068,1822,69.242104,202,225,0.25802752293578
"12027",228705,"TEXAS A & M UNIVERSITY-KINGSVILLE",1,0,1999,736,293,443,53,24,29,0.099,0.072,0.054,1140,70.485661,202,176,0.239130434782609
"12028",228705,"TEXAS A & M UNIVERSITY-KINGSVILLE",1,0,2000,819,332,487,79,33,46,0.139,0.096,0.068,1200,78.834019,245.5,224,0.273504273504274
"12029",228705,"TEXAS A & M UNIVERSITY-KINGSVILLE",1,0,2001,820,388,432,66,28,38,0.098,0.08,0.065,1260,70.877576,289,233,0.284146341463415
"12030",228705,"TEXAS A & M UNIVERSITY-KINGSVILLE",1,0,2002,962,401,561,135,75,60,0.15,0.14,0.134,1320,89.40907,209,226,0.234927234927235
"12031",228705,"TEXAS A & M UNIVERSITY-KINGSVILLE",1,0,2003,828,370,458,60,24,36,0.097,0.072,0.052,1104,90.476637,214,200,0.241545893719807
"12032",228705,"TEXAS A & M UNIVERSITY-KINGSVILLE",1,0,2004,741,328,413,80,29,51,0.156,0.108,0.07,1440,90.668003,211,171,0.230769230769231
"12033",228705,"Texas A & M University-Kingsville",1,0,2005,606,244,362,83,40,43,0.176,0.137,0.11,2448,94.882289,284,155,0.255775577557756
"12034",228705,"Texas A & M University-Kingsville",1,0,2006,731,297,434,95,32,63,0.212,0.13,0.074,2640,98.185915,294,189,0.258549931600547
"12035",228705,"Texas A & M University-Kingsville",1,0,2007,651,251,400,115,58,57,0.227,0.177,0.145,2800,102.595181,300,140,0.21505376344086
"12036",228705,"Texas A & M University-Kingsville",1,0,2008,737,310,427,124,70,54,0.174,0.168,0.164,3104,112.837549,302,194,0.263229308005427
"12037",228705,"Texas A & M University-Kingsville",1,0,2009,971,414,557,165,75,90,0.217,0.17,0.135,3104,130.460266,340,193,0.198764160659114
"12038",228705,"Texas A & M University-Kingsville",1,0,2010,1287,539,748,196,70,126,0.234,0.152,0.094,4066,153.478201,360,213,0.165501165501166
"12039",228723,"TEXAS A & M UNIVERSITY",1,0,1991,6034,2816,3218,1454,510,944,0.335,0.241,0.158,1224,741.236563,1540,4915,0.814550878355983
"12040",228723,"TEXAS A & M UNIVERSITY",1,0,1992,5968,2872,3096,2475,953,1522,0.53,0.415,0.308,1488,763.395591,1550,4745,0.795073726541555
"12041",228723,"TEXAS A & M UNIVERSITY",1,0,1993,6341,3083,3258,1631,524,1107,0.359,0.257,0.161,1646,801.734928,1546,4975,0.784576565210535
"12042",228723,"TEXAS A & M UNIVERSITY",1,0,1995,5985,2986,2999,1643,498,1145,0.384,0.275,0.166,1988,871.462949,1505,4602,0.768922305764411
"12043",228723,"TEXAS A & M UNIVERSITY",1,0,1996,6326,3218,3108,1931,625,1306,0.406,0.305,0.201,1948,911.3475,1496,5154,0.814732848561492
"12044",228723,"TEXAS A & M UNIVERSITY",1,0,1997,6169,3158,3011,1953,619,1334,0.422,0.317,0.206,2740,965.338774,1637,5098,0.826390014589074
"12045",228723,"TEXAS A & M UNIVERSITY",1,0,1998,7322,3701,3621,2350,782,1568,0.424,0.321,0.216,2897,1025.992332,1651,6011,0.820950559956296
"12046",228723,"TEXAS A & M UNIVERSITY",1,0,1999,6659,3419,3240,2359,722,1637,0.479,0.354,0.223,2280,1084.891928,1753,5529,0.830304850578165
"12047",228723,"TEXAS A & M UNIVERSITY",1,0,2000,6591,3453,3138,2409,774,1635,0.474,0.365,0.247,2400,1202.553467,1667.5,5346,0.811106053709604
"12048",228723,"TEXAS A & M UNIVERSITY",1,0,2001,6271,3265,3006,2408,815,1593,0.488,0.384,0.271,2520,1159.092725,1582,5149,0.821081167277946
"12049",228723,"TEXAS A & M UNIVERSITY",1,0,2002,6589,3528,3061,2734,863,1871,0.53,0.415,0.282,2640,1383.198324,1775,5445,0.826377295492488
"12050",228723,"TEXAS A & M UNIVERSITY",1,0,2003,6389,3358,3031,2898,981,1917,0.571,0.454,0.324,2895,1430.61488,1813,5236,0.81953357332916
"12051",228723,"TEXAS A & M UNIVERSITY",1,0,2004,6645,3465,3180,3071,1049,2022,0.584,0.462,0.33,3675,1418.058537,1898,5276,0.79398043641836
"12052",228723,"Texas A & M University",1,0,2005,6713,3406,3307,3352,1259,2093,0.615,0.499,0.381,4110,1561.220143,1907,5099,0.759570981677342
"12053",228723,"Texas A & M University",1,0,2006,7472,3774,3698,3636,1358,2278,0.604,0.487,0.367,4371,1557.884423,2116,5620,0.752141327623126
"12054",228723,"Texas A & M University",1,0,2007,8025,4074,3951,3968,1491,2477,0.608,0.494,0.377,4680,1621.981725,2179,6107,0.760996884735202
"12055",228723,"Texas A & M University",1,0,2008,8038,3940,4098,3989,1575,2414,0.613,0.496,0.384,4898,1917.767483,2648,5754,0.715849713859169
"12056",228723,"Texas A & M University",1,0,2009,7933,3908,4025,4017,1602,2415,0.618,0.506,0.398,5152,1992.292362,2316,5630,0.709693684608597
"12057",228723,"Texas A & M University-College Station",1,0,2010,8033,3862,4171,4175,1709,2466,0.639,0.52,0.41,5297,2042.499187,2625,5544,0.690153118386655
"12058",228769,"UNIVERSITY OF TEXAS AT ARLINGTON",1,0,1991,1608,759,849,116,45,71,0.094,0.072,0.053,1054,139.673249,602,1077,0.669776119402985
"12059",228769,"UNIVERSITY OF TEXAS AT ARLINGTON",1,0,1992,1523,724,799,105,39,66,0.091,0.069,0.049,1236,144.962868,613,1010,0.663164806303349
"12060",228769,"THE UNIVERSITY OF TEXAS AT ARLINGTON",1,0,1993,1314,638,676,81,34,47,0.074,0.062,0.05,1159,153.453601,608,832,0.633181126331811
"12061",228769,"THE UNIVERSITY OF TEXAS AT ARLINGTON",1,0,1995,1243,623,620,117,47,70,0.112,0.094,0.076,1560,167.190503,655,777,0.62510056315366
"12062",228769,"THE UNIVERSITY OF TEXAS AT ARLINGTON",1,0,1996,1208,617,591,235,90,145,0.235,0.195,0.152,1859,181.349432,673,707,0.585264900662252
"12063",228769,"THE UNIVERSITY OF TEXAS AT ARLINGTON",1,0,1997,1270,644,626,250,105,145,0.225,0.197,0.168,2106,182.310532,618,716,0.563779527559055
"12064",228769,"THE UNIVERSITY OF TEXAS AT ARLINGTON",1,0,1998,1241,568,673,155,64,91,0.16,0.125,0.095,2398,190.205593,665,723,0.5825946817083
"12065",228769,"THE UNIVERSITY OF TEXAS AT ARLINGTON",1,0,1999,1402,714,688,214,95,119,0.167,0.153,0.138,1824,188.91149,636,775,0.552781740370899
"12066",228769,"THE UNIVERSITY OF TEXAS AT ARLINGTON",1,0,2000,1589,801,788,225,102,123,0.154,0.142,0.129,1920,201.126757,642.5,866,0.544996853366897
"12067",228769,"THE UNIVERSITY OF TEXAS AT ARLINGTON",1,0,2001,1838,914,924,271,104,167,0.183,0.147,0.113,2016,222.908472,649,1001,0.544613710554951
"12068",228769,"THE UNIVERSITY OF TEXAS AT ARLINGTON",1,0,2002,2126,1070,1056,269,112,157,0.147,0.127,0.106,2112,227.300316,678,1193,0.561147695202258
"12069",228769,"THE UNIVERSITY OF TEXAS AT ARLINGTON",1,0,2003,2431,1182,1249,364,144,220,0.186,0.15,0.115,2208,235.752367,743,1399,0.575483340189223
"12070",228769,"THE UNIVERSITY OF TEXAS AT ARLINGTON",1,0,2004,2009,1068,941,325,115,210,0.197,0.162,0.122,2904,245.138386,735,993,0.494275759084121
"12071",228769,"The University of Texas at Arlington",1,0,2005,2075,1069,1006,347,130,217,0.203,0.167,0.129,3306,280.671415,769,973,0.468915662650602
"12072",228769,"The University of Texas at Arlington",1,0,2006,1974,984,990,340,124,216,0.22,0.172,0.125,5930,303.739012,784,979,0.495947315096251
"12073",228769,"The University of Texas at Arlington",1,0,2007,2096,1041,1055,354,130,224,0.215,0.169,0.123,6464,324.675801,812,963,0.459446564885496
"12074",228769,"The University of Texas at Arlington",1,0,2008,2254,1106,1148,396,151,245,0.222,0.176,0.132,7780,354.947908,825,942,0.417923691215617
"12075",228769,"The University of Texas at Arlington",1,0,2009,2435,1261,1174,502,206,296,0.235,0.206,0.175,8186,368.102175,821,987,0.405338809034908
"12076",228769,"The University of Texas at Arlington",1,0,2010,2585,1319,1266,549,228,321,0.243,0.212,0.18,8500,410.32791,864,920,0.355899419729207
"12077",228778,"UNIVERSITY OF TEXAS AT AUSTIN",1,0,1991,5850,2743,3107,1722,723,999,0.364,0.294,0.233,1189,756.078928,2060,3881,0.663418803418803
"12078",228778,"UNIVERSITY OF TEXAS AT AUSTIN",1,0,1992,5633,2670,2963,1696,691,1005,0.376,0.301,0.233,1372,784.635408,2062,3696,0.656133499023611
"12079",228778,"THE UNIVERSITY OF TEXAS AT AUSTIN",1,0,1993,5872,2810,3062,1776,741,1035,0.368,0.302,0.242,1691,849.761808,2099,3737,0.636410081743869
"12080",228778,"THE UNIVERSITY OF TEXAS AT AUSTIN",1,0,1995,6212,3139,3073,2207,865,1342,0.428,0.355,0.281,2208,876.497407,2115,4001,0.64407598197038
"12081",228778,"THE UNIVERSITY OF TEXAS AT AUSTIN",1,0,1996,6281,3087,3194,2420,985,1435,0.465,0.385,0.308,2612,934.576356,2056,4071,0.648145199808948
"12082",228778,"THE UNIVERSITY OF TEXAS AT AUSTIN",1,0,1997,6945,3568,3377,2531,990,1541,0.432,0.364,0.293,2866,984.178962,2163,4638,0.667818574514039
"12083",228778,"THE UNIVERSITY OF TEXAS AT AUSTIN",1,0,1998,6598,3388,3210,2590,1036,1554,0.459,0.393,0.323,3004,1016.463627,2134,4305,0.652470445589573
"12084",228778,"THE UNIVERSITY OF TEXAS AT AUSTIN",1,0,1999,6925,3508,3417,2888,1186,1702,0.485,0.417,0.347,2280,1065.003213,2158,4370,0.631046931407942
"12085",228778,"THE UNIVERSITY OF TEXAS AT AUSTIN",1,0,2000,7551,3857,3694,3447,1403,2044,0.53,0.456,0.38,2400,1202.578024,2193,4727,0.626009800026487
"12086",228778,"THE UNIVERSITY OF TEXAS AT AUSTIN",1,0,2001,7198,3742,3456,3385,1392,1993,0.533,0.47,0.403,2520,1283.460962,2228,4383,0.608919144206724
"12087",228778,"THE UNIVERSITY OF TEXAS AT AUSTIN",1,0,2002,7842,4111,3731,3769,1531,2238,0.544,0.481,0.41,2640,1379.835805,2324,4828,0.615659270594236
"12088",228778,"THE UNIVERSITY OF TEXAS AT AUSTIN",1,0,2003,6477,3537,2940,3300,1309,1991,0.563,0.509,0.445,2760,1409.858902,2265,3831,0.591477535896248
"12089",228778,"THE UNIVERSITY OF TEXAS AT AUSTIN",1,0,2004,6741,3693,3048,3540,1426,2114,0.572,0.525,0.468,4260,1502.213159,2320,3874,0.574692182168818
"12090",228778,"The University of Texas at Austin",1,0,2005,6783,3630,3153,3572,1419,2153,0.593,0.527,0.45,6972,1545.502649,2450,3764,0.554916703523515
"12091",228778,"The University of Texas at Austin",1,0,2006,7369,4008,3361,3731,1482,2249,0.561,0.506,0.441,7630,1738.10835,2522,4001,0.542950196770254
"12092",228778,"The University of Texas at Austin",1,0,2007,7419,3973,3446,3776,1472,2304,0.58,0.509,0.427,7670,1807.343419,2448,3807,0.51314193287505
"12093",228778,"The University of Texas at Austin",1,0,2008,6679,3679,3000,3487,1358,2129,0.579,0.522,0.453,8532,2006.191894,2509,3491,0.522683036382692
"12094",228778,"The University of Texas at Austin",1,0,2009,7198,3853,3345,3746,1514,2232,0.579,0.52,0.453,8936,2126.069423,2593,3675,0.510558488469019
"12095",228778,"The University of Texas at Austin",1,0,2010,7232,3869,3363,3986,1608,2378,0.615,0.551,0.478,9416,2239.482204,2495,3445,0.476355088495575
"12096",228787,"UNIVERSITY OF TEXAS AT DALLAS",1,0,1991,99,50,49,21,10,11,0.22,0.212,0.204,1070,62.064277,199,54,0.545454545454545
"12097",228787,"UNIVERSITY OF TEXAS AT DALLAS",1,0,1992,93,34,59,21,9,12,0.353,0.226,0.153,1096,77.749523,205,62,0.666666666666667
"12098",228787,"THE UNIVERSITY OF TEXAS AT DALLAS",1,0,1993,414,156,258,125,76,49,0.314,0.302,0.295,1450,75.722163,207,297,0.717391304347826
"12099",228787,"THE UNIVERSITY OF TEXAS AT DALLAS",1,0,1995,351,154,197,113,45,68,0.442,0.322,0.228,2033,79.665493,207,211,0.601139601139601
"12100",228787,"THE UNIVERSITY OF TEXAS AT DALLAS",1,0,1996,451,199,252,138,59,79,0.397,0.306,0.234,2333,82.929927,218,300,0.665188470066519
"12101",228787,"THE UNIVERSITY OF TEXAS AT DALLAS",1,0,1997,444,183,261,143,77,66,0.361,0.322,0.295,2788,94.509851,230,279,0.628378378378378
"12102",228787,"THE UNIVERSITY OF TEXAS AT DALLAS",1,0,1998,494,213,281,187,98,89,0.418,0.379,0.349,3117,105.527847,244,308,0.623481781376518
"12103",228787,"THE UNIVERSITY OF TEXAS AT DALLAS",1,0,1999,603,242,361,180,88,92,0.38,0.299,0.244,1140,111.488294,256,376,0.623548922056385
"12104",228787,"THE UNIVERSITY OF TEXAS AT DALLAS",1,0,2000,801,303,498,248,127,121,0.399,0.31,0.255,960,126.09913,271.5,469,0.585518102372035
"12105",228787,"THE UNIVERSITY OF TEXAS AT DALLAS",1,0,2001,984,402,582,304,145,159,0.395,0.309,0.249,1008,142.228625,287,563,0.572154471544715
"12106",228787,"THE UNIVERSITY OF TEXAS AT DALLAS",1,0,2002,903,405,498,325,141,184,0.454,0.36,0.283,1056,179.832112,315,537,0.59468438538206
"12107",228787,"THE UNIVERSITY OF TEXAS AT DALLAS",1,0,2003,1043,420,623,446,242,204,0.486,0.428,0.388,1104,183.908913,453,647,0.62032598274209
"12108",228787,"THE UNIVERSITY OF TEXAS AT DALLAS",1,0,2004,1129,429,700,473,255,218,0.508,0.419,0.364,1152,289.044287,410,669,0.592559787422498
"12109",228787,"The University of Texas at Dallas",1,0,2005,1058,403,655,433,235,198,0.491,0.409,0.359,5904,215.695406,464,636,0.601134215500945
"12110",228787,"The University of Texas at Dallas",1,0,2006,1053,394,659,470,252,218,0.553,0.446,0.382,6940,237.863895,451,640,0.607787274453941
"12111",228787,"The University of Texas at Dallas",1,0,2007,1030,421,609,472,237,235,0.558,0.458,0.389,7356,278.067394,472,563,0.546601941747573
"12112",228787,"The University of Texas at Dallas",1,0,2008,1090,434,656,553,280,273,0.629,0.507,0.427,9050,281.907069,480,550,0.504587155963303
"12113",228787,"The University of Texas at Dallas",1,0,2009,1293,560,733,615,304,311,0.555,0.476,0.415,9510,308.980922,536,606,0.468677494199536
"12114",228787,"The University of Texas at Dallas",1,0,2010,1346,544,802,680,362,318,0.585,0.505,0.451,9886,361.018544,590,559,0.415304606240713
"12115",228796,"UNIVERSITY OF TEXAS AT EL PASO",1,0,1991,1897,1005,892,45,16,29,0.029,0.024,0.018,990,97.207738,398,352,0.185556141275698
"12116",228796,"UNIVERSITY OF TEXAS AT EL PASO",1,0,1992,1846,989,857,38,18,20,0.02,0.021,0.021,1318,106.492163,415,296,0.160346695557963
"12117",228796,"THE UNIVERSITY OF TEXAS AT EL PASO",1,0,1993,1948,1023,925,59,22,37,0.036,0.03,0.024,1480,119.979307,423,291,0.149383983572895
"12118",228796,"THE UNIVERSITY OF TEXAS AT EL PASO",1,0,1995,1618,887,731,36,12,24,0.027,0.022,0.016,1897,137.105362,480,192,0.118665018541409
"12119",228796,"THE UNIVERSITY OF TEXAS AT EL PASO",1,0,1996,1393,728,665,38,13,25,0.034,0.027,0.02,1981,138.878999,453,189,0.135678391959799
"12120",228796,"THE UNIVERSITY OF TEXAS AT EL PASO",1,0,1997,1482,750,732,36,15,21,0.028,0.024,0.02,2272,151.613121,510,158,0.106612685560054
"12121",228796,"THE UNIVERSITY OF TEXAS AT EL PASO",1,0,1998,1639,847,792,58,21,37,0.044,0.035,0.027,2336,161.221931,481,158,0.0964002440512508
"12122",228796,"THE UNIVERSITY OF TEXAS AT EL PASO",1,0,1999,1662,874,788,79,22,57,0.065,0.048,0.028,2040,170.374165,471,194,0.116726835138387
"12123",228796,"THE UNIVERSITY OF TEXAS AT EL PASO",1,0,2000,2018,1046,972,85,30,55,0.053,0.042,0.031,1776,192.329703,515,202,0.10009910802775
"12124",228796,"THE UNIVERSITY OF TEXAS AT EL PASO",1,0,2001,2156,1156,1000,89,30,59,0.051,0.041,0.03,1920,208.38221,559,208,0.0964749536178108
"12125",228796,"THE UNIVERSITY OF TEXAS AT EL PASO",1,0,2002,2279,1202,1077,101,41,60,0.05,0.044,0.038,2064,218.888199,590,190,0.0833698990785432
"12126",228796,"THE UNIVERSITY OF TEXAS AT EL PASO",1,0,2003,2386,1237,1149,111,46,65,0.052,0.047,0.04,2208,228.469731,577,179,0.0750209555741827
"12127",228796,"THE UNIVERSITY OF TEXAS AT EL PASO",1,0,2004,2296,1205,1091,174,58,116,0.096,0.076,0.053,3780,228.070419,612,170,0.0740418118466899
"12128",228796,"The University of Texas at El Paso",1,0,2005,2154,1085,1069,210,74,136,0.125,0.097,0.069,3930,252.116884,645,175,0.0812441968430826
"12129",228796,"The University of Texas at El Paso",1,0,2006,2446,1256,1190,269,95,174,0.138,0.11,0.08,4065,272.801768,643,161,0.0658217497955846
"12130",228796,"The University of Texas at El Paso",1,0,2007,2017,1046,971,245,94,151,0.144,0.121,0.097,4311,323.356816,632,152,0.075359444719881
"12131",228796,"The University of Texas at El Paso",1,0,2008,2060,1006,1054,251,83,168,0.167,0.122,0.079,4551,303.41581,654,132,0.0640776699029126
"12132",228796,"The University of Texas at El Paso",1,0,2009,2281,1153,1128,274,95,179,0.155,0.12,0.084,4806,324.883306,675,142,0.0622533976326173
"12133",228796,"The University of Texas at El Paso",1,0,2010,2450,1262,1188,363,134,229,0.182,0.148,0.113,5063,354.66976,676,207,0.0844897959183673
"12134",228875,"TEXAS CHRISTIAN UNIVERSITY",1,0,1991,1212,745,467,417,128,289,0.388,0.344,0.274,8166,108.819643,321,1068,0.881188118811881
"12135",228875,"TEXAS CHRISTIAN UNIVERSITY",1,0,1992,1261,746,515,506,161,345,0.462,0.401,0.313,8570,104.157072,329,1085,0.860428231562252
"12136",228875,"TEXAS CHRISTIAN UNIVERSITY",1,0,1993,1189,690,499,467,162,305,0.442,0.393,0.325,8970,108.942,336,991,0.833473507148865
"12137",228875,"TEXAS CHRISTIAN UNIVERSITY",1,0,1995,1325,813,512,511,146,365,0.449,0.386,0.285,10040,113.214,338,1099,0.829433962264151
"12138",228875,"TEXAS CHRISTIAN UNIVERSITY",1,0,1996,1238,735,503,502,181,321,0.437,0.405,0.36,10510,127.096,347,1008,0.81421647819063
"12139",228875,"TEXAS CHRISTIAN UNIVERSITY",1,0,1997,1463,885,578,563,167,396,0.448,0.385,0.289,11090,129.262,351,1204,0.822966507177033
"12140",228875,"TEXAS CHRISTIAN UNIVERSITY",1,0,1998,1397,839,558,587,177,410,0.489,0.42,0.317,11590,138.155,355,1211,0.866857551896922
"12141",228875,"TEXAS CHRISTIAN UNIVERSITY",1,0,1999,1427,869,558,678,208,470,0.541,0.475,0.373,10950,149.108,371,1202,0.842326559215137
"12142",228875,"TEXAS CHRISTIAN UNIVERSITY",1,0,2000,1493,902,591,671,210,461,0.511,0.449,0.355,11700,167.249,381.5,1219,0.816476892163429
"12143",228875,"TEXAS CHRISTIAN UNIVERSITY",1,0,2001,1514,894,620,761,251,510,0.571,0.503,0.405,15000,183.957,392,1241,0.819682959048877
"12144",228875,"TEXAS CHRISTIAN UNIVERSITY",1,0,2002,1450,904,546,719,207,512,0.566,0.496,0.379,16300,203.199,415,1172,0.808275862068966
"12145",228875,"TEXAS CHRISTIAN UNIVERSITY",1,0,2003,1598,1005,593,877,273,604,0.601,0.549,0.46,17590,217.208,420,1269,0.794117647058823
"12146",228875,"TEXAS CHRISTIAN UNIVERSITY",1,0,2004,1605,988,617,866,276,590,0.597,0.54,0.447,19700,236.45,442,1319,0.821806853582555
"12147",228875,"Texas Christian University",1,0,2005,1610,977,633,875,284,591,0.605,0.543,0.449,21280,216.059,463,1268,0.787577639751553
"12148",228875,"Texas Christian University",1,0,2006,1654,985,669,950,328,622,0.631,0.574,0.49,22980,233.566,479,1264,0.764207980652962
"12149",228875,"Texas Christian University",1,0,2007,1642,965,677,961,348,613,0.635,0.585,0.514,24820,236.737,487,1244,0.757612667478684
"12150",228875,"Texas Christian University",1,0,2008,1628,996,632,954,309,645,0.648,0.586,0.489,26900,265.458,505,1222,0.750614250614251
"12151",228875,"Texas Christian University",1,0,2009,1818,1142,676,1068,348,720,0.63,0.587,0.515,28250,274.071,521,1381,0.75962596259626
"12152",228875,"Texas Christian University",1,0,2010,1824,1104,720,1141,397,744,0.674,0.626,0.551,30000,291.417,532,1400,0.767543859649123
"12153",228981,"TEXAS LUTHERAN COLLEGE",1,0,1991,241,156,85,63,20,43,0.276,0.261,0.235,6340,12.785411,60,171,0.70954356846473
"12154",228981,"TEXAS LUTHERAN COLLEGE",1,0,1992,251,148,103,65,22,43,0.291,0.259,0.214,6840,13.698454,63,190,0.756972111553785
"12155",228981,"TEXAS LUTHERAN COLLEGE",1,0,1993,213,134,79,65,24,41,0.306,0.305,0.304,7460,14.506908,60,163,0.765258215962441
"12156",228981,"TEXAS LUTHERAN COLLEGE",1,0,1995,213,142,71,78,20,58,0.409,0.366,0.282,8626,15.139082,55,165,0.774647887323944
"12157",228981,"TEXAS LUTHERAN COLLEGE",1,0,1996,210,132,78,79,23,56,0.424,0.376,0.295,9450,16.341777,57,156,0.742857142857143
"12158",228981,"TEXAS LUTHERAN UNIVERSITY",1,0,1997,312,186,126,118,38,80,0.43,0.378,0.302,10370,16.720991,56,228,0.730769230769231
"12159",228981,"TEXAS LUTHERAN UNIVERSITY",1,0,1998,366,180,186,101,34,67,0.372,0.276,0.183,10876,18.379152,59,250,0.683060109289617
"12160",228981,"TEXAS LUTHERAN UNIVERSITY",1,0,1999,383,170,213,112,45,67,0.394,0.292,0.211,11374,20.699299,63,275,0.718015665796345
"12161",228981,"TEXAS LUTHERAN UNIVERSITY",1,0,2000,330,175,155,125,48,77,0.44,0.379,0.31,12500,21.265827,63,242,0.733333333333333
"12162",228981,"TEXAS LUTHERAN UNIVERSITY",1,0,2001,376,208,168,133,42,91,0.438,0.354,0.25,13440,21.881232,63,282,0.75
"12163",228981,"TEXAS LUTHERAN UNIVERSITY",1,0,2002,371,181,190,111,34,77,0.425,0.299,0.179,14450,21.590454,74,267,0.719676549865229
"12164",228981,"TEXAS LUTHERAN UNIVERSITY",1,0,2003,375,212,163,117,38,79,0.373,0.312,0.233,15470,22.93581,68,256,0.682666666666667
"12165",228981,"TEXAS LUTHERAN UNIVERSITY",1,0,2004,399,202,197,105,40,65,0.322,0.263,0.203,16480,24.255502,74,270,0.676691729323308
"12166",228981,"Texas Lutheran University",1,0,2005,379,182,197,106,35,71,0.39,0.28,0.178,17600,26.050317,66,275,0.725593667546174
"12167",228981,"Texas Lutheran University",1,0,2006,387,197,190,105,39,66,0.335,0.271,0.205,18720,26.990147,77,261,0.674418604651163
"12168",228981,"Texas Lutheran University",1,0,2007,365,177,188,114,39,75,0.424,0.312,0.207,19940,27.956393,73,228,0.624657534246575
"12169",228981,"Texas Lutheran University",1,0,2008,396,191,205,123,44,79,0.414,0.311,0.215,20840,28.574998,76,233,0.588383838383838
"12170",228981,"Texas Lutheran University",1,0,2009,345,171,174,104,43,61,0.357,0.301,0.247,21780,31.31882,68,198,0.573913043478261
"12171",228981,"Texas Lutheran University",1,0,2010,338,159,179,102,39,63,0.396,0.302,0.218,22760,30.371336,72,173,0.511834319526627
"12172",229018,"UNIVERSITY OF TEXAS OF THE PERMIAN BASIN",1,0,1991,46,26,20,5,4,1,0.038,0.109,0.2,1311,11.052697,65,34,0.739130434782609
"12173",229018,"UNIVERSITY OF TEXAS OF THE PERMIAN BASIN",1,0,1992,71,46,25,6,3,3,0.065,0.085,0.12,1275,11.894439,73,43,0.605633802816901
"12174",229018,"THE UNIVERSITY OF TEXAS OF THE PERMIAN BASIN",1,0,1993,78,41,37,8,3,5,0.122,0.103,0.081,1462,12.830006,76,49,0.628205128205128
"12175",229018,"THE UNIVERSITY OF TEXAS OF THE PERMIAN BASIN",1,0,1995,100,61,39,10,3,7,0.115,0.1,0.077,1830,15.460415,74,56,0.56
"12176",229018,"THE UNIVERSITY OF TEXAS OF THE PERMIAN BASIN",1,0,1996,108,58,50,10,6,4,0.069,0.093,0.12,1638,16.805295,80,56,0.518518518518518
"12177",229018,"THE UNIVERSITY OF TEXAS OF THE PERMIAN BASIN",1,0,1997,113,60,53,17,2,15,0.25,0.15,0.038,2106,16.939567,78,66,0.584070796460177
"12178",229018,"THE UNIVERSITY OF TEXAS OF THE PERMIAN BASIN",1,0,1998,112,69,43,19,7,12,0.174,0.17,0.163,2280,17.606593,77,54,0.482142857142857
"12179",229018,"THE UNIVERSITY OF TEXAS OF THE PERMIAN BASIN",1,0,1999,97,65,32,15,5,10,0.154,0.155,0.156,912,19.559503,75,62,0.639175257731959
"12180",229018,"THE UNIVERSITY OF TEXAS OF THE PERMIAN BASIN",1,0,2000,144,86,58,23,8,15,0.174,0.16,0.138,960,23.863035,79.5,67,0.465277777777778
"12181",229018,"THE UNIVERSITY OF TEXAS OF THE PERMIAN BASIN",1,0,2001,165,104,61,36,9,27,0.26,0.218,0.148,1800,26.323926,84,88,0.533333333333333
"12182",229018,"THE UNIVERSITY OF TEXAS OF THE PERMIAN BASIN",1,0,2002,216,126,90,31,9,22,0.175,0.144,0.1,1920,24.825531,88,123,0.569444444444444
"12183",229018,"THE UNIVERSITY OF TEXAS OF THE PERMIAN BASIN",1,0,2003,292,160,132,52,19,33,0.206,0.178,0.144,2064,29.048991,96,145,0.496575342465753
"12184",229018,"THE UNIVERSITY OF TEXAS OF THE PERMIAN BASIN",1,0,2004,258,136,122,39,16,23,0.169,0.151,0.131,2400,32.98583,106,147,0.569767441860465
"12185",229018,"The University of Texas of the Permian Basin",1,0,2005,300,173,127,53,18,35,0.202,0.177,0.142,2616,33.275192,110,134,0.446666666666667
"12186",229018,"The University of Texas of the Permian Basin",1,0,2006,315,178,137,55,18,37,0.208,0.175,0.131,2832,38.794712,117,144,0.457142857142857
"12187",229018,"The University of Texas of the Permian Basin",1,0,2007,372,198,174,48,15,33,0.167,0.129,0.086,3096,37.274665,117,170,0.456989247311828
"12188",229018,"The University of Texas of the Permian Basin",1,0,2008,332,176,156,65,19,46,0.261,0.196,0.122,3264,44.16263,116,158,0.475903614457831
"12189",229018,"The University of Texas of the Permian Basin",1,0,2009,326,176,150,72,29,43,0.244,0.221,0.193,3504,46.64588,119,135,0.414110429447853
"12190",229018,"The University of Texas of the Permian Basin",1,0,2010,341,180,161,71,29,42,0.233,0.208,0.18,3600,56.685378,137,156,0.457478005865103
"12191",229027,"UNIVERSITY OF TEXAS AT SAN ANTONIO",1,0,1991,1479,799,680,69,27,42,0.053,0.047,0.04,1482,74.233375,302,817,0.552400270453009
"12192",229027,"UNIVERSITY OF TEXAS AT SAN ANTONIO",1,0,1992,1558,834,724,120,38,82,0.098,0.077,0.052,2086,78.45373,303,872,0.559691912708601
"12193",229027,"THE UNIVERSITY OF TEXAS AT SAN ANTONIO",1,0,1993,1591,855,736,84,43,41,0.048,0.053,0.058,2298,88.407535,286,823,0.517284726587052
"12194",229027,"THE UNIVERSITY OF TEXAS AT SAN ANTONIO",1,0,1995,1528,821,707,79,20,59,0.072,0.052,0.028,2542,102.40724,323,750,0.490837696335079
"12195",229027,"THE UNIVERSITY OF TEXAS AT SAN ANTONIO",1,0,1996,1679,852,827,93,39,54,0.063,0.055,0.047,2393,108.384033,365,740,0.440738534842168
"12196",229027,"THE UNIVERSITY OF TEXAS AT SAN ANTONIO",1,0,1997,1749,938,811,109,30,79,0.084,0.062,0.037,2110,115.094036,370,740,0.423098913664951
"12197",229027,"THE UNIVERSITY OF TEXAS AT SAN ANTONIO",1,0,1998,2067,1099,968,152,38,114,0.104,0.074,0.039,2336,132.399803,379,881,0.426221577164973
"12198",229027,"THE UNIVERSITY OF TEXAS AT SAN ANTONIO",1,0,1999,1665,882,783,105,32,73,0.083,0.063,0.041,1728,143.284703,478,615,0.369369369369369
"12199",229027,"THE UNIVERSITY OF TEXAS AT SAN ANTONIO",1,0,2000,1727,894,833,121,47,74,0.083,0.07,0.056,1920,175.789176,496,710,0.411117544875507
"12200",229027,"THE UNIVERSITY OF TEXAS AT SAN ANTONIO",1,0,2001,1910,977,933,137,60,77,0.079,0.072,0.064,2016,177.361616,514,751,0.393193717277487
"12201",229027,"THE UNIVERSITY OF TEXAS AT SAN ANTONIO",1,0,2002,3001,1619,1382,234,76,158,0.098,0.078,0.055,2112,213.011335,433,1153,0.384205264911696
"12202",229027,"THE UNIVERSITY OF TEXAS AT SAN ANTONIO",1,0,2003,4091,2070,2021,310,107,203,0.098,0.076,0.053,2208,220.969657,512,1697,0.414813004155463
"12203",229027,"THE UNIVERSITY OF TEXAS AT SAN ANTONIO",1,0,2004,4193,2129,2064,315,103,212,0.1,0.075,0.05,2976,240.725295,740,1723,0.410922966849511
"12204",229027,"The University of Texas at San Antonio",1,0,2005,4360,2240,2120,348,127,221,0.099,0.08,0.06,3174,285.612424,548,1735,0.397935779816514
"12205",229027,"The University of Texas at San Antonio",1,0,2006,4687,2389,2298,424,155,269,0.113,0.09,0.067,3414,311.409896,563,2054,0.4382334115639
"12206",229027,"The University of Texas at San Antonio",1,0,2007,4833,2309,2524,465,179,286,0.124,0.096,0.071,3624,336.806994,582,2043,0.422718808193669
"12207",229027,"The University of Texas at San Antonio",1,0,2008,4758,2432,2326,512,198,314,0.129,0.108,0.085,3840,378.651369,586,1885,0.396174863387978
"12208",229027,"The University of Texas at San Antonio",1,0,2009,4559,2281,2278,507,180,327,0.143,0.111,0.079,4100,422.876983,665,1684,0.36937924983549
"12209",229027,"The University of Texas at San Antonio",1,0,2010,4811,2243,2568,610,248,362,0.161,0.127,0.097,4362,461.956539,848,1562,0.324672625233839
"12210",229115,"TEXAS TECH UNIVERSITY",1,0,1991,2838,1439,1399,468,167,301,0.209,0.165,0.119,1498,247.860861,799,2356,0.830162085976039
"12211",229115,"TEXAS TECH UNIVERSITY",1,0,1992,2823,1418,1405,528,195,333,0.235,0.187,0.139,1489,217.802778,747,2326,0.823946156571024
"12212",229115,"TEXAS TECH UNIVERSITY",1,0,1993,3073,1525,1548,520,196,324,0.212,0.169,0.127,1550,232.356246,731,2567,0.835340058574683
"12213",229115,"TEXAS TECH UNIVERSITY",1,0,1995,3461,1764,1697,747,260,487,0.276,0.216,0.153,2200,261.920412,773,2876,0.830973707021092
"12214",229115,"TEXAS TECH UNIVERSITY",1,0,1996,3632,1860,1772,746,252,494,0.266,0.205,0.142,2496,283.191756,787,3037,0.836178414096916
"12215",229115,"TEXAS TECH UNIVERSITY",1,0,1997,3221,1625,1596,764,302,462,0.284,0.237,0.189,2747,296.28339,817,2749,0.853461657870227
"12216",229115,"TEXAS TECH UNIVERSITY",1,0,1998,3149,1581,1568,804,283,521,0.33,0.255,0.18,2971,322.356511,827,2674,0.849158463004128
"12217",229115,"TEXAS TECH UNIVERSITY",1,0,1999,3403,1725,1678,785,248,537,0.311,0.231,0.148,1140,355.114271,831,2892,0.849838377901851
"12218",229115,"TEXAS TECH UNIVERSITY",1,0,2000,3998,1982,2016,1005,359,646,0.326,0.251,0.178,2400,392.938191,854,3346,0.836918459229615
"12219",229115,"TEXAS TECH UNIVERSITY",1,0,2001,4075,1967,2108,1133,438,695,0.353,0.278,0.208,2520,413.913518,877,3450,0.846625766871166
"12220",229115,"TEXAS TECH UNIVERSITY",1,0,2002,4283,2066,2217,1302,551,751,0.364,0.304,0.249,2640,449.581832,950,3560,0.831193088956339
"12221",229115,"TEXAS TECH UNIVERSITY",1,0,2003,4312,2039,2273,1372,547,825,0.405,0.318,0.241,2208,445.647733,979,3597,0.834183673469388
"12222",229115,"TEXAS TECH UNIVERSITY",1,0,2004,3833,1894,1939,1419,554,865,0.457,0.37,0.286,2976,450.873158,1005,3137,0.818418992955909
"12223",229115,"Texas Tech University",1,0,2005,3743,1829,1914,1323,530,793,0.434,0.353,0.277,3096,474.989315,1046,3021,0.807106598984772
"12224",229115,"Texas Tech University",1,0,2006,3862,1844,2018,1427,601,826,0.448,0.369,0.298,3240,520.995844,1078,3076,0.796478508544795
"12225",229115,"Texas Tech University",1,0,2007,4439,2065,2374,1455,600,855,0.414,0.328,0.253,3448,536.049017,1078,3430,0.772696553277765
"12226",229115,"Texas Tech University",1,0,2008,4338,2056,2282,1413,560,853,0.415,0.326,0.245,3448,574.924323,1099,3251,0.749423697556478
"12227",229115,"Texas Tech University",1,0,2009,4514,2185,2329,1582,641,941,0.431,0.35,0.275,3900,619.281343,1148,3234,0.716437749224634
"12228",229115,"Texas Tech University",1,0,2010,4759,2290,2469,1623,645,978,0.427,0.341,0.261,4296,641.95763,1176,3198,0.671989913847447
"12229",229780,"WAYLAND BAPTIST UNIVERSITY",1,0,1991,133,79,54,28,9,19,0.241,0.211,0.167,5464,12.68912,59,95,0.714285714285714
"12230",229780,"WAYLAND BAPTIST UNIVERSITY",1,0,1992,133,84,49,20,7,13,0.155,0.15,0.143,5626,14.807776,60,100,0.75187969924812
"12231",229780,"WAYLAND BAPTIST UNIVERSITY",1,0,1993,166,106,60,26,10,16,0.151,0.157,0.167,5626,14.976652,66,105,0.632530120481928
"12232",229780,"WAYLAND BAPTIST UNIVERSITY",1,0,1995,167,102,65,26,7,19,0.186,0.156,0.108,6110,18.816759,70,100,0.598802395209581
"12233",229780,"WAYLAND BAPTIST UNIVERSITY",1,0,1996,228,134,94,41,10,31,0.231,0.18,0.106,6395,20.109964,76,159,0.697368421052632
"12234",229780,"WAYLAND BAPTIST UNIVERSITY",1,0,1997,241,132,109,58,21,37,0.28,0.241,0.193,6674,17.307782,82,185,0.767634854771784
"12235",229780,"WAYLAND BAPTIST UNIVERSITY",1,0,1998,244,120,124,37,9,28,0.233,0.152,0.073,7108,18.473288,87,169,0.692622950819672
"12236",229780,"WAYLAND BAPTIST UNIVERSITY",1,0,1999,210,108,102,39,15,24,0.222,0.186,0.147,7050,19.446794,86,105,0.5
"12237",229780,"WAYLAND BAPTIST UNIVERSITY",1,0,2000,216,120,96,30,6,24,0.2,0.139,0.062,7500,22.977034,89,156,0.722222222222222
"12238",229780,"WAYLAND BAPTIST UNIVERSITY",1,0,2001,204,111,93,50,17,33,0.297,0.245,0.183,7800,25.359499,92,62,0.303921568627451
"12239",229780,"WAYLAND BAPTIST UNIVERSITY",1,0,2002,182,104,78,41,13,28,0.269,0.225,0.167,8100,29.325357,93,79,0.434065934065934
"12240",229780,"WAYLAND BAPTIST UNIVERSITY",1,0,2003,205,112,93,41,13,28,0.25,0.2,0.14,8100,31.956521,104,105,0.51219512195122
"12241",229780,"WAYLAND BAPTIST UNIVERSITY",1,0,2004,212,109,103,59,26,33,0.303,0.278,0.252,8850,35.898204,107,131,0.617924528301887
"12242",229780,"Wayland Baptist University",1,0,2005,222,124,98,44,11,33,0.266,0.198,0.112,9450,36.008672,110,148,0.666666666666667
"12243",229780,"Wayland Baptist University",1,0,2006,211,103,108,46,21,25,0.243,0.218,0.194,10200,38.973027,109,149,0.706161137440758
"12244",229780,"Wayland Baptist University",1,0,2007,247,129,118,53,20,33,0.256,0.215,0.169,10650,40.705766,118,137,0.554655870445344
"12245",229780,"Wayland Baptist University",1,0,2008,197,88,109,23,9,14,0.159,0.117,0.083,11400,44.568593,130,115,0.583756345177665
"12246",229780,"Wayland Baptist University",1,0,2009,214,103,111,38,11,27,0.262,0.178,0.099,9480,47.469614,141,110,0.514018691588785
"12247",229780,"Wayland Baptist University",1,0,2010,242,112,130,25,10,15,0.134,0.103,0.077,9960,50.575203,142,106,0.43801652892562
"12248",229814,"WEST TEXAS STATE UNIVERSITY",1,0,1991,767,434,333,76,16,60,0.138,0.099,0.048,1154,35.677073,182,625,0.814863102998696
"12249",229814,"WEST TEXAS STATE UNIVERSITY",1,0,1992,848,421,427,98,27,71,0.169,0.116,0.063,1353,38.54356,182,714,0.841981132075472
"12250",229814,"WEST TEXAS STATE UNIVERSITY",1,0,1993,986,472,514,93,25,68,0.144,0.094,0.049,1444,43.048193,185,776,0.787018255578093
"12251",229814,"WEST TEXAS A & M UNIVERSITY",1,0,1995,901,506,395,108,35,73,0.144,0.12,0.089,1645,46.508579,202,749,0.831298557158713
"12252",229814,"WEST TEXAS A & M UNIVERSITY",1,0,1996,849,411,438,167,69,98,0.238,0.197,0.158,1853,49.707997,201,702,0.826855123674912
"12253",229814,"WEST TEXAS A & M UNIVERSITY",1,0,1997,854,414,440,105,33,72,0.174,0.123,0.075,2068,51.277048,199,709,0.830210772833724
"12254",229814,"WEST TEXAS A & M UNIVERSITY",1,0,1998,884,465,419,140,42,98,0.211,0.158,0.1,2205,59.287551,202,742,0.839366515837104
"12255",229814,"WEST TEXAS A & M UNIVERSITY",1,0,1999,986,506,480,126,34,92,0.182,0.128,0.071,1755,61.426041,203,797,0.808316430020284
"12256",229814,"WEST TEXAS A & M UNIVERSITY",1,0,2000,867,471,396,121,40,81,0.172,0.14,0.101,1875,68.407206,206,661,0.76239907727797
"12257",229814,"WEST TEXAS A & M UNIVERSITY",1,0,2001,759,419,340,109,24,85,0.203,0.144,0.071,1668,73.709789,209,594,0.782608695652174
"12258",229814,"WEST TEXAS A & M UNIVERSITY",1,0,2002,798,425,373,138,38,100,0.235,0.173,0.102,1740,77.981575,222,606,0.759398496240602
"12259",229814,"WEST TEXAS A & M UNIVERSITY",1,0,2003,774,404,370,125,31,94,0.233,0.161,0.084,1956,80.21007,218,595,0.768733850129199
"12260",229814,"WEST TEXAS A & M UNIVERSITY",1,0,2004,790,424,366,151,42,109,0.257,0.191,0.115,2064,82.358343,229,589,0.745569620253165
"12261",229814,"West Texas A & M University",1,0,2005,768,409,359,171,66,105,0.257,0.223,0.184,2208,84.942177,234,530,0.690104166666667
"12262",229814,"West Texas A & M University",1,0,2006,920,489,431,223,73,150,0.307,0.242,0.169,2568,92.968353,237,624,0.678260869565217
"12263",229814,"West Texas A & M University",1,0,2007,923,480,443,227,79,148,0.308,0.246,0.178,3216,96.578064,236,617,0.668472372697725
"12264",229814,"West Texas A & M University",1,0,2008,1149,599,550,259,83,176,0.294,0.225,0.151,3636,114.357646,250,792,0.689295039164491
"12265",229814,"West Texas A & M University",1,0,2009,1193,603,590,260,78,182,0.302,0.218,0.132,4028,120.028275,251,772,0.647108130762783
"12266",229814,"West Texas A & M University",1,0,2010,1227,637,590,336,102,234,0.367,0.274,0.173,4070,120.878252,262,764,0.622656886715566
"12267",230603,"SOUTHERN UTAH UNIVERSITY",0,1,1991,550,370,180,59,11,48,0.13,0.107,0.061,1419,29.388481,128,523,0.950909090909091
"12268",230603,"SOUTHERN UTAH UNIVERSITY",0,1,1992,649,421,228,84,18,66,0.157,0.129,0.079,1497,32.289,135,617,0.950693374422188
"12269",230603,"SOUTHERN UTAH UNIVERSITY",0,1,1993,588,416,172,83,11,72,0.173,0.141,0.064,1599,36.524688,147,569,0.967687074829932
"12270",230603,"SOUTHERN UTAH UNIVERSITY",0,1,1995,643,471,172,90,16,74,0.157,0.14,0.093,1779,43.447502,183,620,0.964230171073095
"12271",230603,"SOUTHERN UTAH UNIVERSITY",0,1,1996,626,443,183,69,19,50,0.113,0.11,0.104,1800,46.004786,172,595,0.950479233226837
"12272",230603,"SOUTHERN UTAH UNIVERSITY",0,1,1997,717,530,187,113,18,95,0.179,0.158,0.096,1854,49.542369,187,681,0.949790794979079
"12273",230603,"SOUTHERN UTAH UNIVERSITY",1,0,1998,667,487,180,113,7,106,0.218,0.169,0.039,1909,52.909257,200,631,0.946026986506747
"12274",230603,"SOUTHERN UTAH UNIVERSITY",1,0,1999,629,456,173,103,9,94,0.206,0.164,0.052,1524,59.409995,205,598,0.950715421303657
"12275",230603,"SOUTHERN UTAH UNIVERSITY",1,0,2000,513,414,99,98,12,86,0.208,0.191,0.121,1612,62.446688,209,468,0.912280701754386
"12276",230603,"SOUTHERN UTAH UNIVERSITY",1,0,2001,562,443,119,113,18,95,0.214,0.201,0.151,1732,66.28232,213,509,0.905693950177936
"12277",230603,"SOUTHERN UTAH UNIVERSITY",1,0,2002,528,383,145,106,12,94,0.245,0.201,0.083,1888,69.667418,205,478,0.90530303030303
"12278",230603,"SOUTHERN UTAH UNIVERSITY",1,0,2003,478,338,140,103,17,86,0.254,0.215,0.121,2332,70.483988,205,429,0.897489539748954
"12279",230603,"SOUTHERN UTAH UNIVERSITY",1,0,2004,656,445,211,130,18,112,0.252,0.198,0.085,2588,72.041991,213,581,0.885670731707317
"12280",230603,"Southern Utah University",1,0,2005,784,527,257,137,30,107,0.203,0.175,0.117,2834,75.289204,211,666,0.849489795918367
"12281",230603,"Southern Utah University",1,0,2006,832,594,238,164,23,141,0.237,0.197,0.097,3060,77.970422,218,713,0.856971153846154
"12282",230603,"Southern Utah University",1,0,2007,865,579,286,185,39,146,0.252,0.214,0.136,3274,86.196151,222,724,0.836994219653179
"12283",230603,"Southern Utah University",1,0,2008,836,574,262,169,29,140,0.244,0.202,0.111,3502,93.382572,229,733,0.876794258373206
"12284",230603,"Southern Utah University",1,0,2009,1101,742,359,193,42,151,0.204,0.175,0.117,3730,97.540706,216,921,0.836512261580381
"12285",230603,"Southern Utah University",1,0,2010,1103,768,335,232,43,189,0.246,0.21,0.128,4196,99.33355,231,928,0.841341795104261
"12286",230728,"UTAH STATE UNIVERSITY",0,1,1991,1359,857,502,1,1,0,0,0.001,0.002,1680,212.740584,509,1210,0.890360559234731
"12287",230728,"UTAH STATE UNIVERSITY",0,1,1992,1237,847,390,186,31,155,0.183,0.15,0.079,1821,231.618822,569,1088,0.879547291835085
"12288",230728,"UTAH STATE UNIVERSITY",0,1,1993,1321,850,471,212,42,170,0.2,0.16,0.089,1896,231.298155,583,1162,0.879636638909917
"12289",230728,"UTAH STATE UNIVERSITY",0,1,1995,1175,803,372,251,43,208,0.259,0.214,0.116,1992,262.385553,738,1091,0.928510638297872
"12290",230728,"UTAH STATE UNIVERSITY",0,1,1996,967,685,282,267,41,226,0.33,0.276,0.145,1971,271.719758,716,882,0.912099276111686
"12291",230728,"UTAH STATE UNIVERSITY",0,1,1997,1465,1029,436,304,60,244,0.237,0.208,0.138,2174,281.818181,654,1364,0.931058020477816
"12292",230728,"UTAH STATE UNIVERSITY",1,0,1998,1764,1229,535,328,43,285,0.232,0.186,0.08,2245,302.823239,648,1589,0.900793650793651
"12293",230728,"UTAH STATE UNIVERSITY",1,0,1999,1521,1047,474,320,67,253,0.242,0.21,0.141,1871,316.988997,640,1381,0.907955292570677
"12294",230728,"UTAH STATE UNIVERSITY",1,0,2000,1632,1116,516,357,76,281,0.252,0.219,0.147,1947,340.487147,642.5,1418,0.868872549019608
"12295",230728,"UTAH STATE UNIVERSITY",1,0,2001,1892,1270,622,384,72,312,0.246,0.203,0.116,2123,364.45864,645,1639,0.866279069767442
"12296",230728,"UTAH STATE UNIVERSITY",1,0,2002,1497,1010,487,423,81,342,0.339,0.283,0.166,2388,376.943508,719,1359,0.907815631262525
"12297",230728,"UTAH STATE UNIVERSITY",1,0,2003,1829,1229,600,491,86,405,0.33,0.268,0.143,2615,392.875166,705,1647,0.900492072170585
"12298",230728,"UTAH STATE UNIVERSITY",1,0,2004,1591,1048,543,433,70,363,0.346,0.272,0.129,2850,418.591981,727,1448,0.910119421747329
"12299",230728,"Utah State University",1,0,2005,1618,1065,553,415,75,340,0.319,0.256,0.136,3128,388.718531,727,1365,0.843634116192831
"12300",230728,"Utah State University",1,0,2006,2429,1574,855,498,102,396,0.252,0.205,0.119,3378,407.525388,692,2064,0.849732400164677
"12301",230728,"Utah State University",1,0,2007,2654,1697,957,544,113,431,0.254,0.205,0.118,3615,423.317075,714,2176,0.819894498869631
"12302",230728,"Utah State University",1,0,2008,2580,1646,934,484,83,401,0.244,0.188,0.089,3832,435.451351,744,2110,0.817829457364341
"12303",230728,"Utah State University",1,0,2009,2664,1663,1001,508,100,408,0.245,0.191,0.1,4043,462.652473,708,2176,0.816816816816817
"12304",230728,"Utah State University",1,0,2010,2941,1882,1059,548,113,435,0.231,0.186,0.107,4047,475.41985,702,2439,0.829309758585515
"12305",230764,"UNIVERSITY OF UTAH",0,1,1991,1924,914,1010,268,107,161,0.176,0.139,0.106,1981,595.104207,818,1664,0.864864864864865
"12306",230764,"UNIVERSITY OF UTAH",0,1,1992,2026,996,1030,304,119,185,0.186,0.15,0.116,2104,683.066109,833,1728,0.852912142152024
"12307",230764,"UNIVERSITY OF UTAH",0,1,1993,1794,1004,790,202,59,143,0.142,0.113,0.075,2298,722.061,860,1447,0.806577480490524
"12308",230764,"UNIVERSITY OF UTAH",0,1,1995,1356,837,519,284,73,211,0.252,0.209,0.141,2508,813.801,920,1156,0.852507374631268
"12309",230764,"UNIVERSITY OF UTAH",0,1,1996,1800,1019,781,436,155,281,0.276,0.242,0.198,2514,864.062,913,1486,0.825555555555556
"12310",230764,"UNIVERSITY OF UTAH",0,1,1997,1962,1039,923,407,133,274,0.264,0.207,0.144,2601,944.835,967,1633,0.832313965341488
"12311",230764,"UNIVERSITY OF UTAH",1,0,1998,1702,991,711,363,116,247,0.249,0.213,0.163,2711,1018.258,927,1370,0.804935370152762
"12312",230764,"UNIVERSITY OF UTAH",1,0,1999,1921,921,1000,295,109,186,0.202,0.154,0.109,2278,1167.717,886,1526,0.794377928162415
"12313",230764,"UNIVERSITY OF UTAH",1,0,2000,2067,1029,1038,441,155,286,0.278,0.213,0.149,2371,1220.579,903,1686,0.815674891146589
"12314",230764,"UNIVERSITY OF UTAH",1,0,2001,1877,1038,839,390,135,255,0.246,0.208,0.161,2517,1292.469,920,1480,0.788492274906766
"12315",230764,"UNIVERSITY OF UTAH",1,0,2002,1962,1109,853,391,127,264,0.238,0.199,0.149,2742,1627.257,927,1610,0.82059123343527
"12316",230764,"UNIVERSITY OF UTAH",1,0,2003,1870,1073,797,405,129,276,0.257,0.217,0.162,3057,1657.328,928,1453,0.777005347593583
"12317",230764,"UNIVERSITY OF UTAH",1,0,2004,1997,1133,864,453,152,301,0.266,0.227,0.176,3364,1707.576,1162,1559,0.780671006509765
"12318",230764,"University of Utah",1,0,2005,1997,1106,891,415,138,277,0.25,0.208,0.155,3628,1826.662,1175,1572,0.787180771156735
"12319",230764,"University of Utah",1,0,2006,2037,1167,870,457,149,308,0.264,0.224,0.171,3972,1966.266,1214,1575,0.77319587628866
"12320",230764,"University of Utah",1,0,2007,1953,1082,871,469,170,299,0.276,0.24,0.195,4270,2123.266,1248,1488,0.761904761904762
"12321",230764,"University of Utah",1,0,2008,1908,1054,854,465,171,294,0.279,0.244,0.2,4525,2310.805,1275,1427,0.7479035639413
"12322",230764,"University of Utah",1,0,2009,2102,1177,925,597,205,392,0.333,0.284,0.222,4956,2485.491,1259,1583,0.753092293054234
"12323",230764,"University of Utah",1,0,2010,2269,1217,1052,663,237,426,0.35,0.292,0.225,5426,2604.2,1287,1629,0.717937417364478
"12324",230782,"WEBER STATE UNIVERSITY",0,1,1991,1403,810,593,100,32,68,0.084,0.071,0.054,1458,79.083787,428,1264,0.900926585887384
"12325",230782,"WEBER STATE UNIVERSITY",0,1,1992,1211,729,482,52,15,37,0.051,0.043,0.031,1542,85.996748,438,1050,0.867052023121387
"12326",230782,"WEBER STATE UNIVERSITY",0,1,1993,1219,829,390,81,23,58,0.07,0.066,0.059,1638,91.155776,459,1070,0.877768662838392
"12327",230782,"WEBER STATE UNIVERSITY",0,1,1995,1338,889,449,109,23,86,0.097,0.081,0.051,1854,92.350687,441,1142,0.853512705530643
"12328",230782,"WEBER STATE UNIVERSITY",0,1,1996,1237,833,404,136,25,111,0.133,0.11,0.062,1863,98.861364,427,1078,0.871463217461601
"12329",230782,"WEBER STATE UNIVERSITY",0,1,1997,1503,978,525,152,37,115,0.118,0.101,0.07,1935,99.933799,417,1298,0.863606121091151
"12330",230782,"WEBER STATE UNIVERSITY",1,0,1998,1453,935,518,147,36,111,0.119,0.101,0.069,1986,106.244692,391,854,0.587749483826566
"12331",230782,"WEBER STATE UNIVERSITY",1,0,1999,1619,1001,618,158,47,111,0.111,0.098,0.076,1606,107.119589,430,1220,0.753551575046325
"12332",230782,"WEBER STATE UNIVERSITY",1,0,2000,1663,1000,663,135,39,96,0.096,0.081,0.059,1670,113.851543,442.5,1214,0.730006013229104
"12333",230782,"WEBER STATE UNIVERSITY",1,0,2001,1509,897,612,47,18,29,0.032,0.031,0.029,1786,121.083293,455,1136,0.752816434724983
"12334",230782,"WEBER STATE UNIVERSITY",1,0,2002,1675,1019,656,79,16,63,0.062,0.047,0.024,1946,130.258652,450,1321,0.78865671641791
"12335",230782,"WEBER STATE UNIVERSITY",1,0,2003,1688,944,744,90,31,59,0.062,0.053,0.042,2130,131.035207,450,1225,0.725710900473934
"12336",230782,"WEBER STATE UNIVERSITY",1,0,2004,1559,882,677,94,28,66,0.075,0.06,0.041,2344,141.631409,452,749,0.480436177036562
"12337",230782,"Weber State University",1,0,2005,1626,879,747,68,23,45,0.051,0.042,0.031,2573,143.193992,472,962,0.591635916359164
"12338",230782,"Weber State University",1,0,2006,1289,755,534,114,28,86,0.114,0.088,0.052,2793,148.513604,485,792,0.614429790535299
"12339",230782,"Weber State University",1,0,2007,1364,783,581,110,27,83,0.106,0.081,0.046,2988,158.307634,496,881,0.645894428152493
"12340",230782,"Weber State University",1,0,2008,1549,853,696,136,41,95,0.111,0.088,0.059,3153,167.799507,499,1044,0.673983214977405
"12341",230782,"Weber State University",1,0,2009,1845,1011,834,140,43,97,0.096,0.076,0.052,3365,176.958077,481,1243,0.673712737127371
"12342",230782,"Weber State University",1,0,2010,2041,1193,848,196,64,132,0.111,0.096,0.075,3559,180.087239,463,1431,0.701126898579128
"12343",231059,"SAINT MICHAEL'S COLLEGE",1,0,1991,485,253,232,329,145,184,0.727,0.678,0.625,11165,34.760755,116,467,0.962886597938144
"12344",231059,"SAINT MICHAEL'S COLLEGE",1,0,1992,414,211,203,277,121,156,0.739,0.669,0.596,11900,35.281472,120,390,0.942028985507246
"12345",231059,"SAINT MICHAELS COLLEGE",1,0,1993,454,238,216,291,128,163,0.685,0.641,0.593,12430,36.477992,122,442,0.973568281938326
"12346",231059,"SAINT MICHAELS COLLEGE",1,0,1995,529,301,228,383,160,223,0.741,0.724,0.702,13810,42.668896,125,507,0.958412098298677
"12347",231059,"SAINT MICHAELS COLLEGE",1,0,1996,486,284,202,335,138,197,0.694,0.689,0.683,14640,45.229095,138,461,0.948559670781893
"12348",231059,"SAINT MICHAELS COLLEGE",1,0,1997,528,279,249,358,158,200,0.717,0.678,0.635,15744,40.664531,133,509,0.964015151515151
"12349",231059,"SAINT MICHAELS COLLEGE",1,0,1998,518,278,240,378,166,212,0.763,0.73,0.692,16310,43.320595,132,503,0.971042471042471
"12350",231059,"SAINT MICHAELS COLLEGE",1,0,1999,501,269,232,342,145,197,0.732,0.683,0.625,17500,44.047343,140,481,0.960079840319361
"12351",231059,"SAINT MICHAELS COLLEGE",1,0,2000,521,283,238,366,149,217,0.767,0.702,0.626,18615,46.632764,140.5,500,0.959692898272553
"12352",231059,"SAINT MICHAELS COLLEGE",1,0,2001,518,286,232,380,150,230,0.804,0.734,0.647,19500,50.146799,141,486,0.938223938223938
"12353",231059,"SAINT MICHAELS COLLEGE",1,0,2002,527,301,226,406,172,234,0.777,0.77,0.761,21010,49.945575,144,498,0.944971537001898
"12354",231059,"SAINT MICHAELS COLLEGE",1,0,2003,512,263,249,362,158,204,0.776,0.707,0.635,22220,55.874843,147,481,0.939453125
"12355",231059,"SAINT MICHAELS COLLEGE",1,0,2004,518,280,238,378,165,213,0.761,0.73,0.693,25325,56.181768,136,497,0.959459459459459
"12356",231059,"Saint Michaels College",1,0,2005,592,331,261,454,188,266,0.804,0.767,0.72,26550,59.842,141,562,0.949324324324324
"12357",231059,"Saint Michaels College",1,0,2006,576,333,243,446,192,254,0.763,0.774,0.79,28280,63.755,147,546,0.947916666666667
"12358",231059,"Saint Michaels College",1,0,2007,524,280,244,364,154,210,0.75,0.695,0.631,29695,67.191,143,493,0.940839694656489
"12359",231059,"Saint Michaels College",1,0,2008,543,277,266,396,180,216,0.78,0.729,0.677,31675,69.627188,141,516,0.950276243093923
"12360",231059,"Saint Michael's College",1,0,2009,470,230,240,322,146,176,0.765,0.685,0.608,32940,76.296918,141,431,0.917021276595745
"12361",231059,"Saint Michael's College",1,0,2010,546,294,252,401,168,233,0.792,0.734,0.667,34555,75.567648,138,490,0.897435897435897
"12362",231174,"UNIVERSITY OF VERMONT",1,0,1991,1821,929,892,884,385,499,0.537,0.485,0.432,5312,222.658,560,1715,0.941790225151016
"12363",231174,"UNIVERSITY OF VERMONT AND ST AGRICULTURAL COLLEGE",1,0,1992,1796,978,818,944,378,566,0.579,0.526,0.462,6166,236.01,561,1721,0.958240534521158
"12364",231174,"UNIVERSITY OF VERMONT AND STATE AGRICULTURAL COLL",1,0,1993,1706,955,751,828,319,509,0.533,0.485,0.425,6400,237.752,555,1612,0.944900351699883
"12365",231174,"UNIVERSITY OF VERMONT AND STATE AGRICULTURAL COLL",1,0,1995,1853,1037,816,853,338,515,0.497,0.46,0.414,6909,256.071,539,1749,0.943874797625472
"12366",231174,"UNIVERSITY OF VERMONT AND STATE AGRICULTURAL COLL",1,0,1996,1779,971,808,915,374,541,0.557,0.514,0.463,7726,260.204,545,1690,0.949971894322653
"12367",231174,"UNIVERSITY OF VERMONT AND STATE AGRICULTURAL COLL",1,0,1997,1823,1005,818,959,381,578,0.575,0.526,0.466,7550,274.113,531,1733,0.950630828304992
"12368",231174,"UNIVERSITY OF VERMONT AND STATE AGRICULTURAL COLL",1,0,1998,1758,994,764,872,336,536,0.539,0.496,0.44,7888,283.951,535,1656,0.9419795221843
"12369",231174,"UNIVERSITY OF VERMONT AND STATE AGRICULTURAL COLL",1,0,1999,1808,984,824,875,351,524,0.532,0.484,0.426,7464,302.591,554,1713,0.947455752212389
"12370",231174,"UNIVERSITY OF VERMONT AND STATE AGRICULTURAL COLL",1,0,2000,1765,988,777,917,344,573,0.58,0.52,0.443,7692,328.46,541,1654,0.937110481586402
"12371",231174,"UNIVERSITY OF VERMONT AND STATE AGRICULTURAL COLL",1,0,2001,1835,1052,783,1017,381,636,0.605,0.554,0.487,8040,323.328,528,1694,0.923160762942779
"12372",231174,"UNIVERSITY OF VERMONT AND STATE AGRICULTURAL COLL",1,0,2002,1828,1005,823,1000,415,585,0.582,0.547,0.504,8320,345.61,549,1709,0.934901531728665
"12373",231174,"UNIVERSITY OF VERMONT AND STATE AGRICULTURAL COLL",1,0,2003,1916,1089,827,1087,439,648,0.595,0.567,0.531,8696,379.503,538,1773,0.925365344467641
"12374",231174,"UNIVERSITY OF VERMONT AND STATE AGRICULTURAL COLL",1,0,2004,1953,1079,874,1188,476,712,0.66,0.608,0.545,9088,406.661,551,1792,0.917562724014337
"12375",231174,"University of Vermont",1,0,2005,2378,1287,1091,1367,568,799,0.621,0.575,0.521,9452,423.317,560,2193,0.922203532380151
"12376",231174,"University of Vermont",1,0,2006,2175,1251,924,1417,551,866,0.692,0.651,0.596,9832,453.127,566,2024,0.930574712643678
"12377",231174,"University of Vermont",1,0,2007,2432,1346,1086,1577,650,927,0.689,0.648,0.599,10422,505.403,583,2259,0.928865131578947
"12378",231174,"University of Vermont",1,0,2008,2453,1457,996,1611,617,994,0.682,0.657,0.619,11048,559.961,606,2233,0.910313901345291
"12379",231174,"University of Vermont",1,0,2009,2607,1482,1125,1733,691,1042,0.703,0.665,0.614,11712,577.357,599,2281,0.874952052167242
"12380",231174,"University of Vermont",1,0,2010,2452,1425,1027,1523,576,947,0.665,0.621,0.561,12180,581.9,611,2145,0.874796084828711
"12381",231420,"AVERETT COLLEGE",1,0,1991,106,67,39,7,2,5,0.075,0.066,0.051,8750,11.293608,47,91,0.858490566037736
"12382",231420,"AVERETT COLLEGE",1,0,1992,104,62,42,25,6,19,0.306,0.24,0.143,9090,12.070149,47,76,0.730769230769231
"12383",231420,"AVERETT COLLEGE",1,0,1993,168,101,67,56,17,39,0.386,0.333,0.254,9710,12.758703,48,135,0.803571428571429
"12384",231420,"AVERETT COLLEGE",1,0,1995,147,79,68,35,13,22,0.278,0.238,0.191,10800,15.619264,52,118,0.802721088435374
"12385",231420,"AVERETT COLLEGE",1,0,1996,149,81,68,42,20,22,0.272,0.282,0.294,11450,18.252635,56,107,0.718120805369127
"12386",231420,"AVERETT COLLEGE",1,0,1997,160,91,69,43,16,27,0.297,0.269,0.232,12100,15.67054,60,115,0.71875
"12387",231420,"AVERETT COLLEGE",1,0,1998,145,78,67,31,18,13,0.167,0.214,0.269,12985,15.022909,61,119,0.820689655172414
"12388",231420,"AVERETT COLLEGE",1,0,1999,204,123,81,72,22,50,0.406,0.353,0.272,13145,16.101881,59,161,0.78921568627451
"12389",231420,"AVERETT COLLEGE",1,0,2000,192,64,128,44,17,27,0.422,0.229,0.133,13740,16.958671,59.5,139,0.723958333333333
"12390",231420,"AVERETT UNIVERSITY",1,0,2001,175,81,94,48,12,36,0.444,0.274,0.128,14490,19.342373,60,129,0.737142857142857
"12391",231420,"AVERETT UNIVERSITY",1,0,2002,187,90,97,59,20,39,0.433,0.316,0.206,15800,19.603095,61,133,0.711229946524064
"12392",231420,"AVERETT UNIVERSITY",1,0,2003,219,83,136,78,34,44,0.53,0.356,0.25,16600,21.448666,65,144,0.657534246575342
"12393",231420,"AVERETT UNIVERSITY",1,0,2004,191,68,123,53,25,28,0.412,0.277,0.203,17430,21.879093,68,127,0.664921465968586
"12394",231420,"Averett University",1,0,2005,229,84,145,59,33,26,0.31,0.258,0.228,18040,21.813701,65,158,0.689956331877729
"12395",231420,"Averett University",1,0,2006,160,60,100,45,19,26,0.433,0.281,0.19,18762,21.109276,63,117,0.73125
"12396",231420,"Averett University",1,0,2007,238,70,168,43,23,20,0.286,0.181,0.137,19512,16.009818,54,131,0.550420168067227
"12397",231420,"Averett University",1,0,2008,234,88,146,53,17,36,0.409,0.226,0.116,20300,16.634193,52,111,0.474358974358974
"12398",231420,"Averett University",1,0,2009,222,78,144,52,27,25,0.32,0.234,0.188,21112,18.413757,52,115,0.518018018018018
"12399",231420,"Averett University",1,0,2010,264,98,166,89,36,53,0.541,0.337,0.217,21956,19.929498,54,137,0.518939393939394
"12400",231554,"BLUEFIELD COLLEGE",1,0,1991,126,61,65,35,15,20,0.328,0.278,0.231,5400,3.998413,26,117,0.928571428571429
"12401",231554,"BLUEFIELD COLLEGE",1,0,1992,150,72,78,49,29,20,0.278,0.327,0.372,5940,5.126819,33,131,0.873333333333333
"12402",231554,"BLUEFIELD COLLEGE",1,0,1993,210,119,91,88,36,52,0.437,0.419,0.396,6500,6.129203,34,196,0.933333333333333
"12403",231554,"BLUEFIELD COLLEGE",1,0,1995,139,68,71,47,22,25,0.368,0.338,0.31,7770,7.449761,40,135,0.971223021582734
"12404",231554,"BLUEFIELD COLLEGE",1,0,1996,109,56,53,39,20,19,0.339,0.358,0.377,8200,9.153859,36,103,0.944954128440367
"12405",231554,"BLUEFIELD COLLEGE",1,0,1997,130,64,66,44,19,25,0.391,0.338,0.288,9100,6.796062,32,119,0.915384615384615
"12406",231554,"BLUEFIELD COLLEGE",1,0,1998,129,69,60,4,1,3,0.044,0.031,0.017,7030,7.075987,32,119,0.922480620155039
"12407",231554,"BLUEFIELD COLLEGE",1,0,1999,144,79,65,43,18,25,0.316,0.299,0.277,6900,9.128446,30,129,0.895833333333333
"12408",231554,"BLUEFIELD COLLEGE",1,0,2000,107,54,53,26,13,13,0.241,0.243,0.245,7900,8.126222,32,94,0.878504672897196
"12409",231554,"BLUEFIELD COLLEGE",1,0,2001,162,91,71,53,21,32,0.352,0.327,0.296,8690,7.917262,34,137,0.845679012345679
"12410",231554,"BLUEFIELD COLLEGE",1,0,2002,131,62,69,36,17,19,0.306,0.275,0.246,9345,8.176958,32,113,0.862595419847328
"12411",231554,"BLUEFIELD COLLEGE",1,0,2003,83,50,33,27,10,17,0.34,0.325,0.303,9715,8.588797,31,73,0.879518072289157
"12412",231554,"BLUEFIELD COLLEGE",1,0,2004,135,82,53,38,14,24,0.293,0.281,0.264,10105,8.657194,33,123,0.911111111111111
"12413",231554,"Bluefield College",1,0,2005,103,57,46,32,15,17,0.298,0.311,0.326,10860,9.176157,33,90,0.87378640776699
"12414",231554,"Bluefield College",1,0,2006,106,59,47,19,5,14,0.237,0.179,0.106,11675,9.72441,33,90,0.849056603773585
"12415",231554,"Bluefield College",1,0,2007,89,49,40,34,10,24,0.49,0.382,0.25,12550,10.338494,34,82,0.921348314606742
"12416",231554,"Bluefield College",1,0,2008,80,47,33,29,8,21,0.447,0.362,0.242,15000,11.41239,37,52,0.65
"12417",231554,"Bluefield College",1,0,2009,115,64,51,36,11,25,0.391,0.313,0.216,17250,12.0313,36,75,0.652173913043478
"12418",231554,"Bluefield College",1,0,2010,112,58,54,28,8,20,0.345,0.25,0.148,17990,11.584398,37,77,0.6875
"12419",231624,"COLLEGE OF WILLIAM AND MARY",1,0,1991,1222,609,613,920,413,507,0.833,0.753,0.674,3730,109.714726,448,1024,0.8379705400982
"12420",231624,"COLLEGE OF WILLIAM AND MARY",1,0,1992,1202,680,522,954,386,568,0.835,0.794,0.739,4046,112.189873,447,978,0.813643926788686
"12421",231624,"COLLEGE OF WILLIAM AND MARY",1,0,1993,1201,690,511,913,360,553,0.801,0.76,0.705,4414,116.818609,470,994,0.827643630308077
"12422",231624,"COLLEGE OF WILLIAM AND MARY",1,0,1995,1369,850,519,1086,378,708,0.833,0.793,0.728,4738,131.320969,492,1126,0.822498173849525
"12423",231624,"COLLEGE OF WILLIAM AND MARY",1,0,1996,1328,789,539,1053,381,672,0.852,0.793,0.707,4906,134.172472,502,1135,0.854668674698795
"12424",231624,"COLLEGE OF WILLIAM AND MARY",1,0,1997,1327,802,525,1063,381,682,0.85,0.801,0.726,5032,145.44591,506,1110,0.836473247927656
"12425",231624,"COLLEGE OF WILLIAM AND MARY",1,0,1998,1290,701,589,1007,412,595,0.849,0.781,0.699,5178,152.532564,516,1085,0.84108527131783
"12426",231624,"COLLEGE OF WILLIAM AND MARY",1,0,1999,1298,736,562,1052,418,634,0.861,0.81,0.744,2302,163.614654,514,1099,0.846687211093991
"12427",231624,"COLLEGE OF WILLIAM AND MARY",1,0,2000,1347,782,565,1118,425,693,0.886,0.83,0.752,2302,180.201518,529,1121,0.832219747587231
"12428",231624,"COLLEGE OF WILLIAM AND MARY",1,0,2001,1358,793,565,1140,441,699,0.882,0.839,0.781,2302,187.277077,544,1119,0.8240058910162
"12429",231624,"COLLEGE OF WILLIAM AND MARY",1,0,2002,1314,721,593,1082,456,626,0.868,0.823,0.769,2510,205.025491,532,1069,0.813546423135464
"12430",231624,"COLLEGE OF WILLIAM AND MARY",1,0,2003,1319,736,583,1098,439,659,0.895,0.832,0.753,3760,188.475075,535,860,0.652009097801365
"12431",231624,"COLLEGE OF WILLIAM AND MARY",1,0,2004,1335,683,652,1097,494,603,0.883,0.822,0.758,4330,203.234358,541,870,0.651685393258427
"12432",231624,"College of William and Mary",1,0,2005,1339,714,625,1134,489,645,0.903,0.847,0.782,4730,216.063909,587,954,0.712471994025392
"12433",231624,"College of William and Mary",1,0,2006,1341,693,648,1107,497,610,0.88,0.826,0.767,5180,230.570973,588,856,0.638329604772558
"12434",231624,"College of William and Mary",1,0,2007,1341,729,612,1114,474,640,0.878,0.831,0.775,5549,230.891237,602,760,0.566741237882177
"12435",231624,"College of William and Mary",1,0,2008,1381,780,601,1146,462,684,0.877,0.83,0.769,6090,296.580173,601,715,0.517740767559739
"12436",231624,"College of William and Mary",1,0,2009,1384,728,656,1133,503,630,0.865,0.819,0.767,6388,294.539121,613,712,0.514450867052023
"12437",231624,"College of William and Mary",1,0,2010,1396,791,605,1180,483,697,0.881,0.845,0.798,7523,272.716801,616,868,0.621776504297994
"12438",231712,"CHRISTOPHER NEWPORT COLLEGE",1,0,1991,443,287,156,44,14,30,0.104,0.099,0.09,2285,21.882284,137,355,0.801354401805869
"12439",231712,"CHRISTOPHER NEWPORT UNIVERSITY",1,0,1992,478,300,178,44,10,34,0.113,0.092,0.056,2860,22.403875,160,387,0.809623430962343
"12440",231712,"CHRISTOPHER NEWPORT UNIVERSITY",1,0,1993,428,266,162,29,7,22,0.083,0.068,0.043,3196,24.519808,166,345,0.80607476635514
"12441",231712,"CHRISTOPHER NEWPORT UNIVERSITY",1,0,1995,534,320,214,59,18,41,0.128,0.11,0.084,3350,30.061232,164,426,0.797752808988764
"12442",231712,"CHRISTOPHER NEWPORT UNIVERSITY",1,0,1996,517,304,213,65,16,49,0.161,0.126,0.075,3326,31.156057,166,393,0.760154738878143
"12443",231712,"CHRISTOPHER NEWPORT UNIVERSITY",1,0,1997,665,398,267,88,29,59,0.148,0.132,0.109,3466,35.815847,166,504,0.757894736842105
"12444",231712,"CHRISTOPHER NEWPORT UNIVERSITY",1,0,1998,693,414,279,121,35,86,0.208,0.175,0.125,3474,39.192661,172,569,0.821067821067821
"12445",231712,"CHRISTOPHER NEWPORT UNIVERSITY",1,0,1999,808,485,323,148,44,104,0.214,0.183,0.136,1888,44.217372,185,648,0.801980198019802
"12446",231712,"CHRISTOPHER NEWPORT UNIVERSITY",1,0,2000,999,587,412,262,73,189,0.322,0.262,0.177,1888,47.283851,184.5,827,0.827827827827828
"12447",231712,"CHRISTOPHER NEWPORT UNIVERSITY",1,0,2001,1042,595,447,318,100,218,0.366,0.305,0.224,1888,52.856034,184,883,0.847408829174664
"12448",231712,"CHRISTOPHER NEWPORT UNIVERSITY",1,0,2002,1176,660,516,363,128,235,0.356,0.309,0.248,2058,57.327161,184,1041,0.885204081632653
"12449",231712,"CHRISTOPHER NEWPORT UNIVERSITY",1,0,2003,1205,619,586,475,176,299,0.483,0.394,0.3,2814,64.268223,167,1042,0.864730290456432
"12450",231712,"CHRISTOPHER NEWPORT UNIVERSITY",1,0,2004,1174,638,536,498,151,347,0.544,0.424,0.282,3152,68.052861,195,1003,0.854344122657581
"12451",231712,"Christopher Newport University",1,0,2005,1245,667,578,578,203,375,0.562,0.464,0.351,3442,73.950875,218,257,0.206425702811245
"12452",231712,"Christopher Newport University",1,0,2006,1172,644,528,594,203,391,0.607,0.507,0.384,3784,91.179664,226,976,0.832764505119454
"12453",231712,"Christopher Newport University",1,0,2007,1241,706,535,618,200,418,0.592,0.498,0.374,4012,99.476544,226,1017,0.819500402900886
"12454",231712,"Christopher Newport University",1,0,2008,1134,640,494,624,207,417,0.652,0.55,0.419,4172,110.53423,239,897,0.791005291005291
"12455",231712,"Christopher Newport University",1,0,2009,1212,719,493,689,235,454,0.631,0.568,0.477,4380,108.099276,236,962,0.793729372937294
"12456",231712,"Christopher Newport University",1,0,2010,1150,673,477,723,250,473,0.703,0.629,0.524,5280,105.490702,243,890,0.773913043478261
"12457",232025,"EMORY AND HENRY COLLEGE",1,0,1991,143,78,65,82,36,46,0.59,0.573,0.554,7270,11.808655,54,138,0.965034965034965
"12458",232025,"EMORY AND HENRY COLLEGE",1,0,1992,188,79,109,61,25,36,0.456,0.324,0.229,7820,12.448687,53,175,0.930851063829787
"12459",232025,"EMORY AND HENRY COLLEGE",1,0,1993,230,120,110,91,30,61,0.508,0.396,0.273,8546,12.378639,54,211,0.917391304347826
"12460",232025,"EMORY AND HENRY COLLEGE",1,0,1995,221,107,114,103,47,56,0.523,0.466,0.412,9990,16.146367,57,200,0.904977375565611
"12461",232025,"EMORY AND HENRY COLLEGE",1,0,1996,256,121,135,123,52,71,0.587,0.48,0.385,10938,18.214876,58,235,0.91796875
"12462",232025,"EMORY AND HENRY COLLEGE",1,0,1997,197,98,99,92,35,57,0.582,0.467,0.354,11572,13.771484,62,190,0.964467005076142
"12463",232025,"EMORY AND HENRY COLLEGE",1,0,1998,290,144,146,120,43,77,0.535,0.414,0.295,11978,16.337681,64,263,0.906896551724138
"12464",232025,"EMORY AND HENRY COLLEGE",1,0,1999,271,129,142,117,50,67,0.519,0.432,0.352,12596,15.491785,66,243,0.896678966789668
"12465",232025,"EMORY AND HENRY COLLEGE",1,0,2000,251,127,124,126,53,73,0.575,0.502,0.427,12950,16.117596,64,231,0.920318725099602
"12466",232025,"EMORY AND HENRY COLLEGE",1,0,2001,267,130,137,113,48,65,0.5,0.423,0.35,13900,17.434527,62,240,0.898876404494382
"12467",232025,"EMORY AND HENRY COLLEGE",1,0,2002,235,130,105,118,48,70,0.538,0.502,0.457,14600,18.499594,64,220,0.936170212765957
"12468",232025,"EMORY AND HENRY COLLEGE",1,0,2003,223,106,117,96,43,53,0.5,0.43,0.368,15700,19.039569,68,205,0.919282511210762
"12469",232025,"EMORY AND HENRY COLLEGE",1,0,2004,260,142,118,125,48,77,0.542,0.481,0.407,16490,18.96492,67,234,0.9
"12470",232025,"Emory and Henry College",1,0,2005,338,155,183,177,80,97,0.626,0.524,0.437,19530,19.297593,68,304,0.899408284023669
"12471",232025,"Emory and Henry College",1,0,2006,267,115,152,84,36,48,0.417,0.315,0.237,20860,21.637637,74,227,0.850187265917603
"12472",232025,"Emory and Henry College",1,0,2007,240,103,137,80,37,43,0.418,0.333,0.27,22320,22.688471,74,201,0.8375
"12473",232025,"Emory and Henry College",1,0,2008,241,123,118,87,31,56,0.455,0.361,0.263,23860,24.450639,76,193,0.800829875518672
"12474",232025,"Emory and Henry College",1,0,2009,283,115,168,108,52,56,0.487,0.382,0.31,24880,25.224035,73,217,0.76678445229682
"12475",232025,"Emory and Henry College",1,0,2010,248,124,124,84,34,50,0.403,0.339,0.274,26000,25.199536,74,193,0.778225806451613
"12476",232043,"EASTERN MENNONITE COLLEGE AND SEMINARY",1,0,1991,201,129,72,95,29,66,0.512,0.473,0.403,7900,13.307824,48,182,0.90547263681592
"12477",232043,"EASTERN MENNONITE COLLEGE AND SEMINARY",1,0,1992,205,117,88,87,31,56,0.479,0.424,0.352,8600,15.291992,62,181,0.882926829268293
"12478",232043,"EASTERN MENNONITE COLLEGE AND SEMINARY",1,0,1993,229,130,99,108,42,66,0.508,0.472,0.424,9100,15.599221,69,205,0.895196506550218
"12479",232043,"EASTERN MENNONITE UNIVERSITY",1,0,1995,206,144,62,96,27,69,0.479,0.466,0.435,10400,18.451161,67,179,0.868932038834951
"12480",232043,"EASTERN MENNONITE UNIVERSITY",1,0,1996,228,143,85,90,26,64,0.448,0.395,0.306,11130,18.974252,67,203,0.890350877192982
"12481",232043,"EASTERN MENNONITE UNIVERSITY",1,0,1997,242,138,104,109,44,65,0.471,0.45,0.423,12000,18.126648,68,208,0.859504132231405
"12482",232043,"EASTERN MENNONITE UNIVERSITY",1,0,1998,229,130,99,107,43,64,0.492,0.467,0.434,12600,17.178329,67,206,0.899563318777293
"12483",232043,"EASTERN MENNONITE UNIVERSITY",1,0,1999,218,131,87,111,36,75,0.573,0.509,0.414,13434,19.937022,80,179,0.821100917431193
"12484",232043,"EASTERN MENNONITE UNIVERSITY",1,0,2000,220,137,83,106,35,71,0.518,0.482,0.422,14110,21.074539,88.5,185,0.840909090909091
"12485",232043,"EASTERN MENNONITE UNIVERSITY",1,0,2001,208,124,84,115,44,71,0.573,0.553,0.524,15254,22.971314,97,171,0.822115384615385
"12486",232043,"EASTERN MENNONITE UNIVERSITY",1,0,2002,208,120,88,113,46,67,0.558,0.543,0.523,16324,24.36638,108,181,0.870192307692308
"12487",232043,"EASTERN MENNONITE UNIVERSITY",1,0,2003,195,121,74,94,32,62,0.512,0.482,0.432,17304,25.292394,107,159,0.815384615384615
"12488",232043,"EASTERN MENNONITE UNIVERSITY",1,0,2004,207,134,73,91,33,58,0.433,0.44,0.452,18174,26.540138,112,151,0.729468599033816
"12489",232043,"Eastern Mennonite University",1,0,2005,202,123,79,116,40,76,0.618,0.574,0.506,19500,26.695777,101,159,0.787128712871287
"12490",232043,"Eastern Mennonite University",1,0,2006,205,119,86,93,31,62,0.521,0.454,0.36,20612,27.626466,95,156,0.760975609756098
"12491",232043,"Eastern Mennonite University",1,0,2007,203,121,82,100,34,66,0.545,0.493,0.415,21860,27.820236,100,162,0.798029556650246
"12492",232043,"Eastern Mennonite University",1,0,2008,183,103,80,90,35,55,0.534,0.492,0.438,23180,28.708548,100,146,0.797814207650273
"12493",232043,"Eastern Mennonite University",1,0,2009,218,135,83,110,40,70,0.519,0.505,0.482,24120,29.465319,97,168,0.770642201834862
"12494",232043,"Eastern Mennonite University",1,0,2010,206,122,84,96,32,64,0.525,0.466,0.381,25060,30.714491,100,148,0.718446601941748
"12495",232089,"FERRUM COLLEGE",1,0,1991,339,122,217,58,29,29,0.238,0.171,0.134,7400,15.748884,74,292,0.861356932153392
"12496",232089,"FERRUM COLLEGE",1,0,1992,337,130,207,78,46,32,0.246,0.231,0.222,8120,17.11752,72,283,0.839762611275964
"12497",232089,"FERRUM COLLEGE",1,0,1993,332,131,201,68,29,39,0.298,0.205,0.144,8800,18.878012,69,282,0.849397590361446
"12498",232089,"FERRUM COLLEGE",1,0,1995,297,109,188,66,28,38,0.349,0.222,0.149,9950,18.953042,72,243,0.818181818181818
"12499",232089,"FERRUM COLLEGE",1,0,1996,309,111,198,59,24,35,0.315,0.191,0.121,10200,18.965847,71,250,0.809061488673139
"12500",232089,"FERRUM COLLEGE",1,0,1997,240,102,138,72,35,37,0.363,0.3,0.254,10750,14.657786,71,181,0.754166666666667
"12501",232089,"FERRUM COLLEGE",1,0,1998,305,128,177,60,29,31,0.242,0.197,0.164,10750,14.628053,67,233,0.763934426229508
"12502",232089,"FERRUM COLLEGE",1,0,1999,309,104,205,56,26,30,0.289,0.181,0.127,10990,16.02602,64,225,0.728155339805825
"12503",232089,"FERRUM COLLEGE",1,0,2000,281,102,179,47,23,24,0.235,0.167,0.128,11900,16.273787,64.5,181,0.644128113879004
"12504",232089,"FERRUM COLLEGE",1,0,2001,269,104,165,51,20,31,0.298,0.19,0.121,12950,17.511408,65,189,0.702602230483271
"12505",232089,"FERRUM COLLEGE",1,0,2002,288,97,191,69,32,37,0.381,0.24,0.168,14390,17.993142,63,187,0.649305555555556
"12506",232089,"FERRUM COLLEGE",1,0,2003,301,106,195,71,37,34,0.321,0.236,0.19,15640,17.296936,63,187,0.621262458471761
"12507",232089,"FERRUM COLLEGE",1,0,2004,287,114,173,53,21,32,0.281,0.185,0.121,16840,17.378373,59,167,0.581881533101045
"12508",232089,"Ferrum College",1,0,2005,330,110,220,53,18,35,0.318,0.161,0.082,17990,17.98771,62,202,0.612121212121212
"12509",232089,"Ferrum College",1,0,2006,417,156,261,126,65,61,0.391,0.302,0.249,19490,19.942274,64,235,0.563549160671463
"12510",232089,"Ferrum College",1,0,2007,525,228,297,103,42,61,0.268,0.196,0.141,20885,22.807258,70,295,0.561904761904762
"12511",232089,"Ferrum College",1,0,2008,581,253,328,80,26,54,0.213,0.138,0.079,22500,25.415545,69,306,0.526678141135972
"12512",232089,"Ferrum College",1,0,2009,531,262,269,106,45,61,0.233,0.2,0.167,23520,26.875107,69,245,0.461393596986817
"12513",232089,"Ferrum College",1,0,2010,565,243,322,106,49,57,0.235,0.188,0.152,24900,29.212408,71,275,0.486725663716814
"12514",232186,"GEORGE MASON UNIVERSITY",1,0,1991,1678,927,751,348,106,242,0.261,0.207,0.141,2988,155.425011,643,1096,0.65315852205006
"12515",232186,"GEORGE MASON UNIVERSITY",1,0,1992,1732,981,751,467,146,321,0.327,0.27,0.194,3336,161.135143,630,1148,0.662817551963048
"12516",232186,"GEORGE MASON UNIVERSITY",1,0,1993,1670,934,736,442,140,302,0.323,0.265,0.19,3888,169.915219,660,1115,0.667664670658683
"12517",232186,"GEORGE MASON UNIVERSITY",1,0,1995,1852,1065,787,486,145,341,0.32,0.262,0.184,4212,205.015959,689,1136,0.613390928725702
"12518",232186,"GEORGE MASON UNIVERSITY",1,0,1996,1875,1040,835,480,150,330,0.317,0.256,0.18,4248,214.360455,711,1187,0.633066666666667
"12519",232186,"GEORGE MASON UNIVERSITY",1,0,1997,1930,1072,858,437,140,297,0.277,0.226,0.163,4296,234.163409,748,1194,0.618652849740933
"12520",232186,"GEORGE MASON UNIVERSITY",1,0,1998,2022,1112,910,540,164,376,0.338,0.267,0.18,4344,244.590236,759,1258,0.62215628090999
"12521",232186,"GEORGE MASON UNIVERSITY",1,0,1999,2030,1129,901,534,161,373,0.33,0.263,0.179,2376,264.999971,765,1248,0.614778325123153
"12522",232186,"GEORGE MASON UNIVERSITY",1,0,2000,2097,1132,965,650,194,456,0.403,0.31,0.201,2376,293.63651,806.5,1363,0.649976156413925
"12523",232186,"GEORGE MASON UNIVERSITY",1,0,2001,2068,1136,932,631,191,440,0.387,0.305,0.205,2376,321.520201,848,1293,0.625241779497099
"12524",232186,"GEORGE MASON UNIVERSITY",1,0,2002,2161,1180,981,770,254,516,0.437,0.356,0.259,2976,318.056423,915,1429,0.661267931513188
"12525",232186,"GEORGE MASON UNIVERSITY",1,0,2003,2191,1166,1025,847,284,563,0.483,0.387,0.277,3630,337.297531,962,1452,0.662711090826107
"12526",232186,"GEORGE MASON UNIVERSITY",1,0,2004,2210,1203,1007,869,311,558,0.464,0.393,0.309,3942,360.376293,974,1125,0.509049773755656
"12527",232186,"George Mason University",1,0,2005,2454,1339,1115,999,348,651,0.486,0.407,0.312,4260,392.890955,997,1284,0.523227383863081
"12528",232186,"George Mason University",1,0,2006,2390,1335,1055,992,355,637,0.477,0.415,0.336,4752,434.969166,1055,1276,0.533891213389121
"12529",232186,"George Mason University",1,0,2007,2174,1222,952,942,316,626,0.512,0.433,0.332,5035,487.516299,1104,1010,0.46458141674333
"12530",232186,"George Mason University",1,0,2008,2476,1328,1148,1099,406,693,0.522,0.444,0.354,5526,541.427355,1134,1252,0.505654281098546
"12531",232186,"George Mason University",1,0,2009,2627,1367,1260,1198,446,752,0.55,0.456,0.354,5840,562.545015,1138,1334,0.507803578226113
"12532",232186,"George Mason University",1,0,2010,2577,1324,1253,1198,462,736,0.556,0.465,0.369,6320,588.521375,1144,1439,0.558401241753978
"12533",232265,"HAMPTON UNIVERSITY",1,0,1991,1188,718,470,445,112,333,0.464,0.375,0.238,6550,63.896323,306,5,0.00420875420875421
"12534",232265,"HAMPTON UNIVERSITY",1,0,1992,1139,675,464,364,80,284,0.421,0.32,0.172,7006,67.720197,302,8,0.00702370500438982
"12535",232265,"HAMPTON UNIVERSITY",1,0,1993,1427,879,548,410,85,325,0.37,0.287,0.155,7356,68.0264,302,6,0.00420462508759636
"12536",232265,"HAMPTON UNIVERSITY",1,0,1995,1272,780,492,418,98,320,0.41,0.329,0.199,8362,86.873594,295,3,0.00235849056603774
"12537",232265,"HAMPTON UNIVERSITY",1,0,1996,917,591,326,358,70,288,0.487,0.39,0.215,8948,90.927287,288,4,0.00436205016357688
"12538",232265,"HAMPTON UNIVERSITY",1,0,1997,1218,765,453,459,119,340,0.444,0.377,0.263,9596,77.056478,297,8,0.00656814449917898
"12539",232265,"HAMPTON UNIVERSITY",1,0,1998,1153,715,438,461,105,356,0.498,0.4,0.24,10076,82.616086,293,10,0.00867302688638335
"12540",232265,"HAMPTON UNIVERSITY",1,0,1999,1190,728,462,422,102,320,0.44,0.355,0.221,9490,92.345872,303,30,0.0252100840336134
"12541",232265,"HAMPTON UNIVERSITY",1,0,2000,828,527,301,327,79,248,0.471,0.395,0.262,9968,98.057024,303.5,18,0.0217391304347826
"12542",232265,"HAMPTON UNIVERSITY",1,0,2001,1189,748,441,450,106,344,0.46,0.378,0.24,10464,99.698158,304,15,0.0126156433978133
"12543",232265,"HAMPTON UNIVERSITY",1,0,2002,1017,644,373,384,90,294,0.456,0.378,0.241,10990,108.493731,282,11,0.0108161258603736
"12544",232265,"HAMPTON UNIVERSITY",1,0,2003,1379,873,506,506,131,375,0.43,0.367,0.259,11540,110.36731,311,17,0.0123277737490935
"12545",232265,"HAMPTON UNIVERSITY",1,0,2004,1345,863,482,514,131,383,0.444,0.382,0.272,12116,148.401743,322,13,0.00966542750929368
"12546",232265,"Hampton University",1,0,2005,1099,701,398,445,114,331,0.472,0.405,0.286,12722,153.591115,305,6,0.00545950864422202
"12547",232265,"Hampton University",1,0,2006,1098,700,398,447,119,328,0.469,0.407,0.299,13358,148.329994,399,7,0.0063752276867031
"12548",232265,"Hampton University",1,0,2007,1179,757,422,585,163,422,0.557,0.496,0.386,14026,140.994241,353,10,0.00848176420695505
"12549",232265,"Hampton University",1,0,2008,1190,792,398,489,120,369,0.466,0.411,0.302,14728,137.423079,371,10,0.00840336134453781
"12550",232265,"Hampton University",1,0,2009,1017,632,385,135,135,0,0,0.133,0.351,15464,148.5458,347,9,0.00884955752212389
"12551",232265,"Hampton University",1,0,2010,978,605,373,351,87,264,0.436,0.359,0.233,16238,141.874364,371,16,0.016359918200409
"12552",232423,"JAMES MADISON UNIVERSITY",1,0,1991,2121,1223,898,1105,381,724,0.592,0.521,0.424,3298,106.543765,482,1805,0.851013672795851
"12553",232423,"JAMES MADISON UNIVERSITY",1,0,1992,2038,1171,867,1075,361,714,0.61,0.527,0.416,3576,113.465741,496,1731,0.849362119725221
"12554",232423,"JAMES MADISON UNIVERSITY",1,0,1993,2079,1170,909,1239,453,786,0.672,0.596,0.498,3798,115.769438,508,1788,0.86002886002886
"12555",232423,"JAMES MADISON UNIVERSITY",1,0,1995,2537,1484,1053,1548,523,1025,0.691,0.61,0.497,4014,134.780104,528,2181,0.85967678360268
"12556",232423,"JAMES MADISON UNIVERSITY",1,0,1996,3258,1878,1380,1958,704,1254,0.668,0.601,0.51,4104,141.892202,559,2890,0.887047268262738
"12557",232423,"JAMES MADISON UNIVERSITY",1,0,1997,3059,1791,1268,1855,643,1212,0.677,0.606,0.507,4148,165.470296,581,2634,0.86106570774763
"12558",232423,"JAMES MADISON UNIVERSITY",1,0,1998,2971,1788,1183,1830,546,1284,0.718,0.616,0.462,4256,173.244989,617,2623,0.882867721305958
"12559",232423,"JAMES MADISON UNIVERSITY",1,0,1999,3040,1855,1185,1887,610,1277,0.688,0.621,0.515,1550,199.754645,640,2692,0.885526315789474
"12560",232423,"JAMES MADISON UNIVERSITY",1,0,2000,3223,1981,1242,2089,684,1405,0.709,0.648,0.551,1550,202.572231,639,2766,0.858206639776606
"12561",232423,"JAMES MADISON UNIVERSITY",1,0,2001,3244,2004,1240,2103,696,1407,0.702,0.648,0.561,1550,223.976729,638,2734,0.842786683107275
"12562",232423,"JAMES MADISON UNIVERSITY",1,0,2002,3283,2116,1167,2220,690,1530,0.723,0.676,0.591,1690,216.003632,704,2804,0.854096862625647
"12563",232423,"JAMES MADISON UNIVERSITY",1,0,2003,3386,2167,1219,2220,697,1523,0.703,0.656,0.572,2382,224.545295,721,2931,0.865623154164206
"12564",232423,"JAMES MADISON UNIVERSITY",1,0,2004,3281,2112,1169,2216,690,1526,0.723,0.675,0.59,2752,237.203939,749,2785,0.84882657726303
"12565",232423,"James Madison University",1,0,2005,3796,2421,1375,2465,803,1662,0.687,0.649,0.584,2998,258.159766,795,2883,0.759483667017914
"12566",232423,"James Madison University",1,0,2006,3745,2431,1314,2357,713,1644,0.676,0.629,0.543,3228,283.317022,831,2998,0.800534045393859
"12567",232423,"James Madison University",1,0,2007,3864,2401,1463,2520,829,1691,0.704,0.652,0.567,3420,311.321512,854,3193,0.826345755693582
"12568",232423,"James Madison University",1,0,2008,3956,2425,1531,2577,876,1701,0.701,0.651,0.572,3556,339.705602,897,3162,0.799292214357937
"12569",232423,"James Madison University",1,0,2009,3948,2488,1460,2625,823,1802,0.724,0.665,0.564,3734,357.014959,906,3216,0.814589665653495
"12570",232423,"James Madison University",1,0,2010,3995,2482,1513,2599,838,1761,0.71,0.651,0.554,4182,370.856509,906,3185,0.797246558197747
"12571",232557,"LIBERTY UNIVERSITY",1,0,1991,849,451,398,146,53,93,0.206,0.172,0.133,5850,80.682559,223,737,0.868080094228504
"12572",232557,"LIBERTY UNIVERSITY",1,0,1992,766,369,397,156,81,75,0.203,0.204,0.204,6150,67.225271,196,660,0.861618798955614
"12573",232557,"LIBERTY UNIVERSITY",1,0,1993,1407,691,716,204,81,123,0.178,0.145,0.113,6600,65.29979,168,1168,0.830135039090263
"12574",232557,"LIBERTY UNIVERSITY",1,0,1995,1165,600,565,224,70,154,0.257,0.192,0.124,7350,98.461774,159,992,0.851502145922747
"12575",232557,"LIBERTY UNIVERSITY",1,0,1996,1253,635,618,253,91,162,0.255,0.202,0.147,7680,73.11617,163,1032,0.823623304070231
"12576",232557,"LIBERTY UNIVERSITY",1,0,1997,995,531,464,279,101,178,0.335,0.28,0.218,8050,50.300362,173,799,0.803015075376884
"12577",232557,"LIBERTY UNIVERSITY",1,0,1998,1020,479,541,327,126,201,0.42,0.321,0.233,8500,59.408453,175,910,0.892156862745098
"12578",232557,"LIBERTY UNIVERSITY",1,0,1999,1074,557,517,268,103,165,0.296,0.25,0.199,8550,48.776968,176,841,0.783054003724395
"12579",232557,"LIBERTY UNIVERSITY",1,0,2000,1216,657,559,431,167,264,0.402,0.354,0.299,8550,48.362846,174,997,0.819901315789474
"12580",232557,"LIBERTY UNIVERSITY",1,0,2001,1129,602,527,381,146,235,0.39,0.337,0.277,9000,51.999176,172,963,0.852967227635075
"12581",232557,"LIBERTY UNIVERSITY",1,0,2002,1530,812,718,393,154,239,0.294,0.257,0.214,9840,56.310953,181,1177,0.769281045751634
"12582",232557,"LIBERTY UNIVERSITY",1,0,2003,1811,1024,787,506,190,316,0.309,0.279,0.241,11520,67.481519,218,1358,0.749861954721149
"12583",232557,"LIBERTY UNIVERSITY",1,0,2004,2173,1178,995,647,251,396,0.336,0.298,0.252,12600,83.458607,272,1644,0.756557754256788
"12584",232557,"Liberty University",1,0,2005,1915,982,933,488,204,284,0.289,0.255,0.219,13700,108.820428,305,1373,0.716971279373368
"12585",232557,"Liberty University",1,0,2006,2028,1022,1006,489,209,280,0.274,0.241,0.208,14400,141.780712,354,1365,0.673076923076923
"12586",232557,"Liberty University",1,0,2007,2715,1474,1241,715,278,437,0.296,0.263,0.224,14850,183.197073,340,1820,0.670349907918969
"12587",232557,"Liberty University",1,0,2008,3063,1663,1400,857,314,543,0.326,0.28,0.224,15444,197.603317,350,1873,0.611492001305909
"12588",232557,"Liberty University",1,0,2009,3871,2113,1758,1154,439,715,0.338,0.298,0.25,15992,226.884979,379,2201,0.568586928442263
"12589",232557,"Liberty University",1,0,2010,3438,1874,1564,1005,410,595,0.318,0.292,0.262,16792,272.421699,390,2026,0.589296102385108
"12590",232566,"LONGWOOD COLLEGE",1,0,1991,634,465,169,223,43,180,0.387,0.352,0.254,3190,32.316255,148,568,0.89589905362776
"12591",232566,"LONGWOOD COLLEGE",1,0,1992,687,473,214,268,50,218,0.461,0.39,0.234,3664,33.787985,148,608,0.885007278020378
"12592",232566,"LONGWOOD COLLEGE",1,0,1993,724,509,215,275,40,235,0.462,0.38,0.186,4106,36.57555,150,647,0.893646408839779
"12593",232566,"LONGWOOD COLLEGE",1,0,1995,671,445,226,283,57,226,0.508,0.422,0.252,4370,41.787355,157,599,0.892697466467958
"12594",232566,"LONGWOOD COLLEGE",1,0,1996,657,447,210,242,53,189,0.423,0.368,0.252,4370,41.356407,158,559,0.850837138508371
"12595",232566,"LONGWOOD COLLEGE",1,0,1997,728,513,215,303,67,236,0.46,0.416,0.312,4416,43.748619,158,637,0.875
"12596",232566,"LONGWOOD COLLEGE",1,0,1998,812,539,273,362,91,271,0.503,0.446,0.333,4528,45.530553,158,709,0.873152709359606
"12597",232566,"LONGWOOD COLLEGE",1,0,1999,815,534,281,391,101,290,0.543,0.48,0.359,2020,48.522948,162,708,0.868711656441718
"12598",232566,"LONGWOOD COLLEGE",1,0,2000,895,611,284,412,105,307,0.503,0.46,0.37,1995,53.404707,166.5,771,0.86145251396648
"12599",232566,"LONGWOOD COLLEGE",1,0,2001,891,611,280,410,103,307,0.503,0.46,0.368,1970,56.606181,171,776,0.870931537598204
"12600",232566,"LONGWOOD UNIVERSITY",1,0,2002,860,593,267,410,101,309,0.521,0.477,0.378,2148,59.871689,171,770,0.895348837209302
"12601",232566,"LONGWOOD UNIVERSITY",1,0,2003,872,576,296,340,91,249,0.432,0.39,0.307,3046,55.986989,182,763,0.875
"12602",232566,"LONGWOOD UNIVERSITY",1,0,2004,972,631,341,386,111,275,0.436,0.397,0.326,3320,58.678372,194,872,0.897119341563786
"12603",232566,"Longwood University",1,0,2005,938,632,306,379,88,291,0.46,0.404,0.288,3586,65.684803,201,809,0.862473347547974
"12604",232566,"Longwood University",1,0,2006,985,627,358,411,111,300,0.479,0.417,0.31,3960,74.045598,203,872,0.885279187817259
"12605",232566,"Longwood University",1,0,2007,984,650,334,412,107,305,0.469,0.419,0.32,4249,87.057905,208,848,0.861788617886179
"12606",232566,"Longwood University",1,0,2008,1043,700,343,467,104,363,0.519,0.448,0.303,4509,98.334546,211,889,0.852348993288591
"12607",232566,"Longwood University",1,0,2009,934,631,303,414,96,318,0.504,0.443,0.317,4680,111.128881,207,754,0.80728051391863
"12608",232566,"Longwood University",1,0,2010,970,667,303,454,93,361,0.541,0.468,0.307,5370,98.518466,214,801,0.825773195876289
"12609",232609,"LYNCHBURG COLLEGE",1,0,1991,327,200,127,142,47,95,0.475,0.434,0.37,10300,29.183804,141,286,0.874617737003058
"12610",232609,"LYNCHBURG COLLEGE",1,0,1992,416,248,168,177,52,125,0.504,0.425,0.31,10900,29.649362,131,357,0.858173076923077
"12611",232609,"LYNCHBURG COLLEGE",1,0,1993,361,221,140,120,36,84,0.38,0.332,0.257,11600,30.228179,125,316,0.875346260387812
"12612",232609,"LYNCHBURG COLLEGE",1,0,1995,262,181,81,142,42,100,0.552,0.542,0.519,14080,29.821704,116,230,0.877862595419847
"12613",232609,"LYNCHBURG COLLEGE",1,0,1996,287,169,118,151,51,100,0.592,0.526,0.432,14720,28.721863,104,235,0.818815331010453
"12614",232609,"LYNCHBURG COLLEGE",1,0,1997,477,275,202,220,72,148,0.538,0.461,0.356,15490,24.775681,106,407,0.853249475890985
"12615",232609,"LYNCHBURG COLLEGE",1,0,1998,433,267,166,218,65,153,0.573,0.503,0.392,16290,26.238005,104,377,0.87066974595843
"12616",232609,"LYNCHBURG COLLEGE",1,0,1999,473,277,196,222,73,149,0.538,0.469,0.372,17120,28.371226,108,426,0.900634249471459
"12617",232609,"LYNCHBURG COLLEGE",1,0,2000,438,252,186,188,70,118,0.468,0.429,0.376,17980,30.157841,108.5,373,0.851598173515982
"12618",232609,"LYNCHBURG COLLEGE",1,0,2001,475,278,197,219,67,152,0.547,0.461,0.34,18880,32.316896,109,424,0.892631578947368
"12619",232609,"LYNCHBURG COLLEGE",1,0,2002,438,246,192,220,72,148,0.602,0.502,0.375,20040,33.21317,106,371,0.84703196347032
"12620",232609,"LYNCHBURG COLLEGE",1,0,2003,589,342,247,316,116,200,0.585,0.537,0.47,21270,33.459501,135,479,0.813242784380306
"12621",232609,"LYNCHBURG COLLEGE",1,0,2004,568,328,240,275,87,188,0.573,0.484,0.362,22640,36.50224,136,459,0.808098591549296
"12622",232609,"Lynchburg College",1,0,2005,553,321,232,246,84,162,0.505,0.445,0.362,23700,41.32651,149,378,0.683544303797468
"12623",232609,"Lynchburg College",1,0,2006,552,305,247,259,88,171,0.561,0.469,0.356,24860,45.045632,157,333,0.603260869565217
"12624",232609,"Lynchburg College",1,0,2007,598,324,274,274,95,179,0.552,0.458,0.347,26360,49.0382,158,407,0.680602006688963
"12625",232609,"Lynchburg College",1,0,2008,593,336,257,252,85,167,0.497,0.425,0.331,27160,51.421236,161,480,0.809443507588533
"12626",232609,"Lynchburg College",1,0,2009,592,348,244,278,91,187,0.537,0.47,0.373,27980,53.768083,163,481,0.8125
"12627",232609,"Lynchburg College",1,0,2010,571,328,243,275,89,186,0.567,0.482,0.366,28960,55.112286,171,455,0.796847635726795
"12628",232681,"MARY WASHINGTON COLLEGE",1,0,1991,712,496,216,458,123,335,0.675,0.643,0.569,2618,33.098263,162,620,0.870786516853933
"12629",232681,"MARY WASHINGTON COLLEGE",1,0,1992,698,474,224,448,132,316,0.667,0.642,0.589,2896,33.989816,160,623,0.892550143266476
"12630",232681,"MARY WASHINGTON COLLEGE",1,0,1993,750,477,273,486,161,325,0.681,0.648,0.59,3066,35.750935,157,662,0.882666666666667
"12631",232681,"MARY WASHINGTON COLLEGE",1,0,1995,758,497,261,443,138,305,0.614,0.584,0.529,3300,40.33876,174,654,0.862796833773087
"12632",232681,"MARY WASHINGTON COLLEGE",1,0,1996,729,504,225,450,112,338,0.671,0.617,0.498,3318,40.879048,170,655,0.898491083676269
"12633",232681,"MARY WASHINGTON COLLEGE",1,0,1997,808,547,261,479,129,350,0.64,0.593,0.494,3556,44.697399,177,731,0.90470297029703
"12634",232681,"MARY WASHINGTON COLLEGE",1,0,1998,812,557,255,530,156,374,0.672,0.653,0.612,3674,45.139114,179,741,0.91256157635468
"12635",232681,"MARY WASHINGTON COLLEGE",1,0,1999,834,619,215,583,142,441,0.712,0.699,0.66,1550,48.153915,184,753,0.902877697841727
"12636",232681,"MARY WASHINGTON COLLEGE",1,0,2000,873,609,264,622,175,447,0.734,0.712,0.663,1550,56.408925,193.5,779,0.892325315005727
"12637",232681,"MARY WASHINGTON COLLEGE",1,0,2001,840,574,266,570,158,412,0.718,0.679,0.594,1550,58.005036,203,742,0.883333333333333
"12638",232681,"MARY WASHINGTON COLLEGE",1,0,2002,862,618,244,607,164,443,0.717,0.704,0.672,1690,57.168679,206,760,0.881670533642691
"12639",232681,"MARY WASHINGTON COLLEGE",1,0,2003,879,572,307,590,181,409,0.715,0.671,0.59,2344,59.227512,209,791,0.899886234357224
"12640",232681,"UNIVERSITY OF MARY WASHINGTON",1,0,2004,869,569,300,590,183,407,0.715,0.679,0.61,2544,62.303726,214,779,0.896432681242808
"12641",232681,"University of Mary Washington",1,0,2005,877,581,296,552,159,393,0.676,0.629,0.537,2806,66.125462,231,644,0.734321550741163
"12642",232681,"University of Mary Washington",1,0,2006,909,614,295,625,180,445,0.725,0.688,0.61,3072,72.534604,242,619,0.680968096809681
"12643",232681,"University of Mary Washington",1,0,2007,951,649,302,626,175,451,0.695,0.658,0.579,3256,80.055295,246,600,0.630914826498423
"12644",232681,"University of Mary Washington",1,0,2008,848,553,295,539,160,379,0.685,0.636,0.542,3386,87.656539,246,586,0.691037735849057
"12645",232681,"University of Mary Washington",1,0,2009,925,600,325,543,156,387,0.645,0.587,0.48,3554,99.822988,242,521,0.563243243243243
"12646",232681,"University of Mary Washington",1,0,2010,950,612,338,586,179,407,0.665,0.617,0.53,3984,89.141917,239,503,0.529473684210526
"12647",232706,"MARYMOUNT UNIVERSITY",1,0,1991,211,159,52,81,21,60,0.377,0.384,0.404,9707,26.231489,92,151,0.71563981042654
"12648",232706,"MARYMOUNT UNIVERSITY",1,0,1992,212,165,47,77,19,58,0.352,0.363,0.404,10192,29.742449,114,155,0.731132075471698
"12649",232706,"MARYMOUNT UNIVERSITY",1,0,1993,175,130,45,66,10,56,0.431,0.377,0.222,10804,33.304737,112,128,0.731428571428571
"12650",232706,"MARYMOUNT UNIVERSITY",1,0,1995,167,122,45,82,22,60,0.492,0.491,0.489,11900,37.154106,111,114,0.682634730538922
"12651",232706,"MARYMOUNT UNIVERSITY",1,0,1996,212,145,67,102,27,75,0.517,0.481,0.403,12400,40.026974,108,136,0.641509433962264
"12652",232706,"MARYMOUNT UNIVERSITY",1,0,1997,261,190,71,111,28,83,0.437,0.425,0.394,12770,34.883562,108,186,0.71264367816092
"12653",232706,"MARYMOUNT UNIVERSITY",1,0,1998,262,177,85,100,24,76,0.429,0.382,0.282,13300,37.199479,115,164,0.625954198473282
"12654",232706,"MARYMOUNT UNIVERSITY",1,0,1999,302,220,82,116,26,90,0.409,0.384,0.317,13750,36.947968,118,185,0.612582781456954
"12655",232706,"MARYMOUNT UNIVERSITY",1,0,2000,309,230,79,120,21,99,0.43,0.388,0.266,14300,38.696917,120,166,0.537216828478964
"12656",232706,"MARYMOUNT UNIVERSITY",1,0,2001,354,241,113,123,29,94,0.39,0.347,0.257,14850,40.084197,122,187,0.528248587570621
"12657",232706,"MARYMOUNT UNIVERSITY",1,0,2002,361,261,100,128,25,103,0.395,0.355,0.25,15600,41.661391,128,170,0.470914127423823
"12658",232706,"MARYMOUNT UNIVERSITY",1,0,2003,379,290,89,158,30,128,0.441,0.417,0.337,16300,43.61735,128,193,0.509234828496042
"12659",232706,"MARYMOUNT UNIVERSITY",1,0,2004,414,310,104,180,45,135,0.436,0.435,0.433,16952,45.73234,129,222,0.536231884057971
"12660",232706,"Marymount University",1,0,2005,422,310,112,152,34,118,0.381,0.36,0.304,17970,47.901106,134,208,0.492890995260663
"12661",232706,"Marymount University",1,0,2006,365,268,97,136,28,108,0.403,0.373,0.289,19048,51.45973,143,173,0.473972602739726
"12662",232706,"Marymount University",1,0,2007,396,288,108,176,35,141,0.49,0.444,0.324,20190,54.36914,138,198,0.5
"12663",232706,"Marymount University",1,0,2008,404,294,110,141,25,116,0.395,0.349,0.227,21300,56.212727,138,173,0.428217821782178
"12664",232706,"Marymount University",1,0,2009,383,274,109,131,31,100,0.365,0.342,0.284,22370,57.657777,141,161,0.420365535248042
"12665",232706,"Marymount University",1,0,2010,415,295,120,151,36,115,0.39,0.364,0.3,23160,59.800326,144,153,0.368674698795181
"12666",232937,"NORFOLK STATE UNIVERSITY",1,0,1991,1543,920,623,95,24,71,0.077,0.062,0.039,2330,62.69427,308,33,0.0213869086195723
"12667",232937,"NORFOLK STATE UNIVERSITY",1,0,1992,1492,893,599,76,24,52,0.058,0.051,0.04,2530,66.097675,275,47,0.0315013404825737
"12668",232937,"NORFOLK STATE UNIVERSITY",1,0,1993,1324,759,565,70,24,46,0.061,0.053,0.042,2710,70.439106,297,27,0.020392749244713
"12669",232937,"NORFOLK STATE UNIVERSITY",1,0,1995,1257,706,551,91,24,67,0.095,0.072,0.044,2865,75.281125,294,33,0.0262529832935561
"12670",232937,"NORFOLK STATE UNIVERSITY",1,0,1996,1329,809,520,124,34,90,0.111,0.093,0.065,2865,79.12129,317,34,0.0255831452219714
"12671",232937,"NORFOLK STATE UNIVERSITY",1,0,1997,1132,700,432,104,30,74,0.106,0.092,0.069,3000,83.591616,320,23,0.0203180212014134
"12672",232937,"NORFOLK STATE UNIVERSITY",1,0,1998,1092,680,412,95,26,69,0.102,0.087,0.063,3335,80.807929,337,22,0.0201465201465201
"12673",232937,"NORFOLK STATE UNIVERSITY",1,0,1999,1111,687,424,118,27,91,0.132,0.106,0.064,1350,85.745423,326,28,0.0252025202520252
"12674",232937,"NORFOLK STATE UNIVERSITY",1,0,2000,1262,808,454,141,52,89,0.11,0.112,0.115,1326,95.50131,314,17,0.0134706814580032
"12675",232937,"NORFOLK STATE UNIVERSITY",1,0,2001,1067,655,412,113,25,88,0.134,0.106,0.061,1530,101.793832,302,22,0.0206185567010309
"12676",232937,"NORFOLK STATE UNIVERSITY",1,0,2002,1091,634,457,133,35,98,0.155,0.122,0.077,1658,104.110297,314,21,0.0192483959670028
"12677",232937,"NORFOLK STATE UNIVERSITY",1,0,2003,1080,593,487,123,41,82,0.138,0.114,0.084,1920,104.338485,299,29,0.0268518518518519
"12678",232937,"NORFOLK STATE UNIVERSITY",1,0,2004,970,580,390,103,20,83,0.143,0.106,0.051,2220,110.490188,285,32,0.0329896907216495
"12679",232937,"Norfolk State University",1,0,2005,957,551,406,138,39,99,0.18,0.144,0.096,2370,120.338017,280,21,0.0219435736677116
"12680",232937,"Norfolk State University",1,0,2006,1023,638,385,130,34,96,0.151,0.127,0.088,2580,122.637158,277,23,0.0224828934506354
"12681",232937,"Norfolk State University",1,0,2007,938,571,367,179,46,133,0.233,0.191,0.125,2700,127.825593,272,18,0.0191897654584222
"12682",232937,"Norfolk State University",1,0,2008,1143,657,486,182,53,129,0.196,0.159,0.109,2781,132.664508,272,24,0.020997375328084
"12683",232937,"Norfolk State University",1,0,2009,1160,654,506,183,63,120,0.184,0.158,0.125,2952,133.7407,270,32,0.0275862068965517
"12684",232937,"Norfolk State University",1,0,2010,902,528,374,185,67,118,0.224,0.205,0.179,3159,136.880638,269,30,0.0332594235033259
"12685",232982,"OLD DOMINION UNIVERSITY",1,0,1991,1363,685,678,161,48,113,0.165,0.118,0.071,2848,118.718394,621,1017,0.746148202494497
"12686",232982,"OLD DOMINION UNIVERSITY",1,0,1992,1491,764,727,158,50,108,0.141,0.106,0.069,2828,125.861484,601,1080,0.724346076458752
"12687",232982,"OLD DOMINION UNIVERSITY",1,0,1993,1173,580,593,137,39,98,0.169,0.117,0.066,3098,137.303959,640,825,0.703324808184143
"12688",232982,"OLD DOMINION UNIVERSITY",1,0,1995,1514,827,687,149,30,119,0.144,0.098,0.044,3288,141.827102,625,978,0.645970937912814
"12689",232982,"OLD DOMINION UNIVERSITY",1,0,1996,1478,803,675,210,60,150,0.187,0.142,0.089,3312,152.503698,623,926,0.626522327469553
"12690",232982,"OLD DOMINION UNIVERSITY",1,0,1997,1464,791,673,207,54,153,0.193,0.141,0.08,3428,161.367165,592,896,0.612021857923497
"12691",232982,"OLD DOMINION UNIVERSITY",1,0,1998,1561,904,657,324,82,242,0.268,0.208,0.125,3476,176.766491,582,930,0.595771941063421
"12692",232982,"OLD DOMINION UNIVERSITY",1,0,1999,1500,833,667,327,103,224,0.269,0.218,0.154,2184,182.815319,599,875,0.583333333333333
"12693",232982,"OLD DOMINION UNIVERSITY",1,0,2000,1407,798,609,321,93,228,0.286,0.228,0.153,1747,202.608745,597.5,798,0.567164179104478
"12694",232982,"OLD DOMINION UNIVERSITY",1,0,2001,1502,821,681,340,116,224,0.273,0.226,0.17,1747,208.776644,596,856,0.569906790945406
"12695",232982,"OLD DOMINION UNIVERSITY",1,0,2002,1701,902,799,373,139,234,0.259,0.219,0.174,1891,205.682118,575,958,0.563198118753674
"12696",232982,"OLD DOMINION UNIVERSITY",1,0,2003,2001,1139,862,457,136,321,0.282,0.228,0.158,2364,195.538708,566,1159,0.579210394802599
"12697",232982,"OLD DOMINION UNIVERSITY",1,0,2004,1917,1053,864,474,136,338,0.321,0.247,0.157,2569,204.27703,605,1093,0.570161711006781
"12698",232982,"Old Dominion University",1,0,2005,2054,1160,894,474,145,329,0.284,0.231,0.162,2785,219.412081,620,459,0.223466407010711
"12699",232982,"Old Dominion University",1,0,2006,2059,1108,951,507,159,348,0.314,0.246,0.167,3051,250.407437,663,555,0.269548324429335
"12700",232982,"Old Dominion University",1,0,2007,2513,1327,1186,581,200,381,0.287,0.231,0.169,3219,284.736474,686,1420,0.565061679267807
"12701",232982,"Old Dominion University",1,0,2008,2757,1381,1376,652,233,419,0.303,0.236,0.169,3348,309.270741,697,1567,0.568371418208197
"12702",232982,"Old Dominion University",1,0,2009,2691,1346,1345,698,263,435,0.323,0.259,0.196,3516,325.205402,696,1533,0.569676700111483
"12703",232982,"Old Dominion University",1,0,2010,2579,1280,1299,666,252,414,0.323,0.258,0.194,3763,337.85241,723,1360,0.527336176812718
"12704",233277,"RADFORD UNIVERSITY",1,0,1991,1857,1122,735,365,88,277,0.247,0.197,0.12,2430,75.02447,396,1706,0.91868605277329
"12705",233277,"RADFORD UNIVERSITY",1,0,1992,1807,1128,679,445,99,346,0.307,0.246,0.146,2746,76.185385,396,1651,0.913669064748201
"12706",233277,"RADFORD UNIVERSITY",1,0,1993,1736,1088,648,460,128,332,0.305,0.265,0.198,2924,79.111709,394,1580,0.910138248847926
"12707",233277,"RADFORD UNIVERSITY",1,0,1995,1381,833,548,425,121,304,0.365,0.308,0.221,3114,84.156589,395,1252,0.90658942795076
"12708",233277,"RADFORD UNIVERSITY",1,0,1996,1419,867,552,476,141,335,0.386,0.335,0.255,3146,80.592628,361,1274,0.897815362931642
"12709",233277,"RADFORD UNIVERSITY",1,0,1997,1619,1048,571,551,145,406,0.387,0.34,0.254,3180,81.368393,352,1443,0.891290920321186
"12710",233277,"RADFORD UNIVERSITY",1,0,1998,1518,1011,507,569,154,415,0.41,0.375,0.304,3238,88.551307,352,1356,0.893280632411067
"12711",233277,"RADFORD UNIVERSITY",1,0,1999,1655,1075,580,610,164,446,0.415,0.369,0.283,1629,93.387789,356,1462,0.883383685800604
"12712",233277,"RADFORD UNIVERSITY",1,0,2000,1753,1081,672,610,191,419,0.388,0.348,0.284,1629,98.900124,357,1563,0.891614375356532
"12713",233277,"RADFORD UNIVERSITY",1,0,2001,1875,1155,720,674,200,474,0.41,0.359,0.278,1629,107.209557,358,1679,0.895466666666667
"12714",233277,"RADFORD UNIVERSITY",1,0,2002,1813,1109,704,754,244,510,0.46,0.416,0.347,1774,97.984813,355,1590,0.87699944842802
"12715",233277,"RADFORD UNIVERSITY",1,0,2003,1800,1097,703,719,214,505,0.46,0.399,0.304,2476,101.531609,340,1614,0.896666666666667
"12716",233277,"RADFORD UNIVERSITY",1,0,2004,1828,1135,693,708,209,499,0.44,0.387,0.302,2974,103.722246,356,1604,0.87746170678337
"12717",233277,"Radford University",1,0,2005,1890,1101,789,725,254,471,0.428,0.384,0.322,3235,113.922176,377,1647,0.871428571428571
"12718",233277,"Radford University",1,0,2006,1730,1045,685,730,252,478,0.457,0.422,0.368,3720,126.391167,383,1507,0.871098265895954
"12719",233277,"Radford University",1,0,2007,1840,1055,785,758,273,485,0.46,0.412,0.348,4026,136.910495,397,1611,0.87554347826087
"12720",233277,"Radford University",1,0,2008,1871,1119,752,809,261,548,0.49,0.432,0.347,4187,147.755828,400,1573,0.840726884019241
"12721",233277,"Radford University",1,0,2009,1444,838,606,637,217,420,0.501,0.441,0.358,4396,149.673653,387,1249,0.864958448753463
"12722",233277,"Radford University",1,0,2010,1836,1068,768,783,259,524,0.491,0.426,0.337,5012,153.033022,393,1557,0.848039215686274
"12723",233374,"UNIVERSITY OF RICHMOND",1,0,1991,805,409,396,623,294,329,0.804,0.774,0.742,11695,67.525809,208,753,0.935403726708074
"12724",233374,"UNIVERSITY OF RICHMOND",1,0,1992,749,361,388,576,294,282,0.781,0.769,0.758,12620,76.208503,212,689,0.919893190921228
"12725",233374,"UNIVERSITY OF RICHMOND",1,0,1993,728,383,345,559,251,308,0.804,0.768,0.728,13540,78.751414,222,664,0.912087912087912
"12726",233374,"UNIVERSITY OF RICHMOND",1,0,1995,762,398,364,581,251,330,0.829,0.762,0.69,15500,87.064605,221,671,0.880577427821522
"12727",233374,"UNIVERSITY OF RICHMOND",1,0,1996,793,399,394,610,284,326,0.817,0.769,0.721,16570,83.798951,226,698,0.880201765447667
"12728",233374,"UNIVERSITY OF RICHMOND",1,0,1997,750,367,383,548,258,290,0.79,0.731,0.674,17570,92.694678,225,660,0.88
"12729",233374,"UNIVERSITY OF RICHMOND",1,0,1998,739,358,381,576,281,295,0.824,0.779,0.738,18595,87.024325,226,633,0.856562922868742
"12730",233374,"UNIVERSITY OF RICHMOND",1,0,1999,854,465,389,647,273,374,0.804,0.758,0.702,19340,107.328863,224,773,0.905152224824356
"12731",233374,"UNIVERSITY OF RICHMOND",1,0,2000,723,366,357,574,278,296,0.809,0.794,0.779,20140,116.038631,235.5,632,0.874135546334716
"12732",233374,"UNIVERSITY OF RICHMOND",1,0,2001,790,430,360,640,277,363,0.844,0.81,0.769,21700,121.966716,247,696,0.881012658227848
"12733",233374,"UNIVERSITY OF RICHMOND",1,0,2002,775,422,353,634,279,355,0.841,0.818,0.79,22995,128.57395,292,668,0.861935483870968
"12734",233374,"UNIVERSITY OF RICHMOND",1,0,2003,835,440,395,688,313,375,0.852,0.824,0.792,24170,133.012953,283,730,0.874251497005988
"12735",233374,"UNIVERSITY OF RICHMOND",1,0,2004,763,391,372,620,298,322,0.824,0.813,0.801,26520,139.593064,299,640,0.838794233289646
"12736",233374,"University of Richmond",1,0,2005,775,401,374,593,268,325,0.81,0.765,0.717,29250,150.229216,334,577,0.744516129032258
"12737",233374,"University of Richmond",1,0,2006,757,387,370,585,267,318,0.822,0.773,0.722,32870,159.391209,336,540,0.71334214002642
"12738",233374,"University of Richmond",1,0,2007,801,427,374,653,295,358,0.838,0.815,0.789,35718,169.274384,344,605,0.755305867665418
"12739",233374,"University of Richmond",1,0,2008,737,412,325,591,255,336,0.816,0.802,0.785,38850,186.128173,343,485,0.658073270013569
"12740",233374,"University of Richmond",1,0,2009,918,546,372,758,293,465,0.852,0.826,0.788,40010,201.682855,374,505,0.550108932461874
"12741",233374,"University of Richmond",1,0,2010,816,452,364,685,286,399,0.883,0.839,0.786,41610,212.794386,371,506,0.620098039215686
"12742",233426,"ROANOKE COLLEGE",1,0,1991,421,267,154,188,58,130,0.487,0.447,0.377,11250,24.985736,91,403,0.957244655581948
"12743",233426,"ROANOKE COLLEGE",1,0,1992,422,259,163,222,65,157,0.606,0.526,0.399,12000,27.338988,91,395,0.936018957345972
"12744",233426,"ROANOKE COLLEGE",1,0,1993,438,275,163,242,67,175,0.636,0.553,0.411,12625,28.614198,92,415,0.947488584474886
"12745",233426,"ROANOKE COLLEGE",1,0,1995,431,247,184,223,77,146,0.591,0.517,0.418,14100,31.519358,94,405,0.939675174013921
"12746",233426,"ROANOKE COLLEGE",1,0,1996,437,278,159,263,84,179,0.644,0.602,0.528,14750,33.558533,94,408,0.933638443935927
"12747",233426,"ROANOKE COLLEGE",1,0,1997,438,248,190,225,70,155,0.625,0.514,0.368,15380,26.237627,92,407,0.929223744292237
"12748",233426,"ROANOKE COLLEGE",1,0,1998,426,272,154,222,68,154,0.566,0.521,0.442,16035,27.956382,93,400,0.938967136150235
"12749",233426,"ROANOKE COLLEGE",1,0,1999,450,274,176,257,88,169,0.617,0.571,0.5,16655,29.124509,98,428,0.951111111111111
"12750",233426,"ROANOKE COLLEGE",1,0,2000,444,274,170,259,80,179,0.653,0.583,0.471,17320,30.643669,97,403,0.907657657657658
"12751",233426,"ROANOKE COLLEGE",1,0,2001,498,311,187,283,96,187,0.601,0.568,0.513,18186,32.348794,96,452,0.907630522088353
"12752",233426,"ROANOKE COLLEGE",1,0,2002,460,274,186,256,95,161,0.588,0.557,0.511,19186,35.382092,105,417,0.906521739130435
"12753",233426,"ROANOKE COLLEGE",1,0,2003,519,282,237,301,130,171,0.606,0.58,0.549,20355,36.657888,132,477,0.919075144508671
"12754",233426,"ROANOKE COLLEGE",1,0,2004,483,288,195,314,114,200,0.694,0.65,0.585,21504,39.576864,139,434,0.898550724637681
"12755",233426,"Roanoke College",1,0,2005,534,310,224,316,120,196,0.632,0.592,0.536,22848,41.274318,133,464,0.868913857677903
"12756",233426,"Roanoke College",1,0,2006,503,296,207,285,104,181,0.612,0.567,0.502,24048,43.991554,146,433,0.860834990059642
"12757",233426,"Roanoke College",1,0,2007,565,335,230,327,115,212,0.633,0.579,0.5,25550,46.841227,157,471,0.833628318584071
"12758",233426,"Roanoke College",1,0,2008,529,284,245,302,115,187,0.658,0.571,0.469,27210,52.431322,151,458,0.86578449905482
"12759",233426,"Roanoke College",1,0,2009,560,325,235,327,123,204,0.628,0.584,0.523,28734,52.498118,164,480,0.857142857142857
"12760",233426,"Roanoke College",1,0,2010,564,323,241,321,115,206,0.638,0.569,0.477,30314,57.714611,164,503,0.891843971631206
"12761",233541,"SHENANDOAH UNIVERSITY",1,0,1991,180,104,76,35,10,25,0.24,0.194,0.132,8100,12.391932,75,153,0.85
"12762",233541,"SHENANDOAH UNIVERSITY",1,0,1992,221,141,80,46,16,30,0.213,0.208,0.2,8750,14.654488,81,186,0.841628959276018
"12763",233541,"SHENANDOAH UNIVERSITY",1,0,1993,185,88,97,47,17,30,0.341,0.254,0.175,9800,17.932373,89,164,0.886486486486487
"12764",233541,"SHENANDOAH UNIVERSITY",1,0,1995,212,118,94,53,16,37,0.314,0.25,0.17,11470,24.606237,113,179,0.844339622641509
"12765",233541,"SHENANDOAH UNIVERSITY",1,0,1996,251,149,102,59,14,45,0.302,0.235,0.137,13700,27.070271,114,214,0.852589641434263
"12766",233541,"SHENANDOAH UNIVERSITY",1,0,1997,257,159,98,61,17,44,0.277,0.237,0.173,14400,25.889249,128,223,0.867704280155642
"12767",233541,"SHENANDOAH UNIVERSITY",1,0,1998,288,178,110,80,19,61,0.343,0.278,0.173,15080,25.558173,142,251,0.871527777777778
"12768",233541,"SHENANDOAH UNIVERSITY",1,0,1999,292,163,129,87,36,51,0.313,0.298,0.279,15700,32.719696,147,249,0.852739726027397
"12769",233541,"SHENANDOAH UNIVERSITY",1,0,2000,377,187,190,105,35,70,0.374,0.279,0.184,16300,36.184344,153,303,0.803713527851459
"12770",233541,"SHENANDOAH UNIVERSITY",1,0,2001,308,158,150,106,40,66,0.418,0.344,0.267,17000,38.835436,159,268,0.87012987012987
"12771",233541,"SHENANDOAH UNIVERSITY",1,0,2002,323,163,160,115,42,73,0.448,0.356,0.262,17510,42.429146,167,267,0.826625386996904
"12772",233541,"SHENANDOAH UNIVERSITY",1,0,2003,328,185,143,106,34,72,0.389,0.323,0.238,18310,45.685504,175,317,0.966463414634146
"12773",233541,"SHENANDOAH UNIVERSITY",1,0,2004,325,160,165,98,39,59,0.369,0.302,0.236,19090,46.5469,175,301,0.926153846153846
"12774",233541,"Shenandoah University",1,0,2005,369,211,158,123,44,79,0.374,0.333,0.278,19900,50.111087,181,158,0.428184281842818
"12775",233541,"Shenandoah University",1,0,2006,304,157,147,75,29,46,0.293,0.247,0.197,21090,53.244675,191,50,0.164473684210526
"12776",233541,"Shenandoah University",1,0,2007,397,205,192,135,49,86,0.42,0.34,0.255,22040,56.697075,196,287,0.722921914357683
"12777",233541,"Shenandoah University",1,0,2008,399,200,199,145,52,93,0.465,0.363,0.261,22740,61.658035,211,292,0.731829573934837
"12778",233541,"Shenandoah University",1,0,2009,443,235,208,155,46,109,0.464,0.35,0.221,23850,66.949433,215,320,0.72234762979684
"12779",233541,"Shenandoah University",1,0,2010,414,228,186,164,57,107,0.469,0.396,0.306,24780,68.39136,222,297,0.717391304347826
"12780",233897,"UNIVERSITY OF VIRGINIA CLINCH VALLEY COLLEGE",1,0,1991,326,155,171,52,16,36,0.232,0.16,0.094,2300,11.525596,52,303,0.929447852760736
"12781",233897,"UNIVERSITY OF VIRGINIA CLINCH VALLEY COLLEGE",1,0,1992,232,110,122,41,14,27,0.246,0.177,0.115,2650,13.247172,57,219,0.943965517241379
"12782",233897,"UNIVERSITY OF VIRGINIA-CLINCH VALLEY COLLEGE",1,0,1993,253,110,143,53,22,31,0.282,0.209,0.154,2988,14.189734,58,229,0.905138339920949
"12783",233897,"UNIVERSITY OF VIRGINIA-CLINCH VALLEY COLLEGE",1,0,1995,269,141,128,67,27,40,0.284,0.249,0.211,3200,14.323701,57,255,0.947955390334573
"12784",233897,"UNIVERSITY OF VIRGINIA-CLINCH VALLEY COLLEGE",1,0,1996,247,132,115,69,31,38,0.288,0.279,0.27,3258,14.481934,56,234,0.947368421052632
"12785",233897,"UNIVERSITY OF VIRGINIA-CLINCH VALLEY COLLEGE",1,0,1997,303,155,148,80,28,52,0.335,0.264,0.189,3348,15.645383,59,279,0.920792079207921
"12786",233897,"UNIVERSITY OF VIRGINIA-CLINCH VALLEY COLLEGE",1,0,1998,297,146,151,57,18,39,0.267,0.192,0.119,3520,11.853363,63,268,0.902356902356902
"12787",233897,"UNIVERSITY OF VIRGINIA'S COLLEGE AT WISE",1,0,1999,299,151,148,76,36,40,0.265,0.254,0.243,1930,19.023288,69,274,0.916387959866221
"12788",233897,"UNIVERSITY OF VIRGINIA'S COLLEGE AT WISE",1,0,2000,277,137,140,74,22,52,0.38,0.267,0.157,1930,20.973365,69,252,0.909747292418773
"12789",233897,"UNIVERSITY OF VIRGINIA'S COLLEGE AT WISE",1,0,2001,325,154,171,80,36,44,0.286,0.246,0.211,1885,22.278339,69,280,0.861538461538462
"12790",233897,"UNIVERSITY OF VIRGINIA'S COLLEGE AT WISE",1,0,2002,345,181,164,100,34,66,0.365,0.29,0.207,2055,24.525495,67,315,0.91304347826087
"12791",233897,"THE UNIVERSITY OF VIRGINIA'S COLLEGE AT WISE",1,0,2003,349,177,172,109,39,70,0.395,0.312,0.227,2630,24.80859,76,296,0.848137535816619
"12792",233897,"THE UNIVERSITY OF VIRGINIA'S COLLEGE AT WISE",1,0,2004,373,180,193,130,61,69,0.383,0.349,0.316,2788,26.989531,74,336,0.900804289544236
"12793",233897,"The University of Virginia's College at Wise",1,0,2005,366,186,180,94,27,67,0.36,0.257,0.15,2984,28.233527,89,314,0.85792349726776
"12794",233897,"The University of Virginia's College at Wise",1,0,2006,401,187,214,98,45,53,0.283,0.244,0.21,3252,30.62599,91,349,0.870324189526185
"12795",233897,"The University of Virginia's College at Wise",1,0,2007,401,184,217,97,41,56,0.304,0.242,0.189,3422,34.944334,95,332,0.827930174563591
"12796",233897,"The University of Virginia's College at Wise",1,0,2008,427,194,233,98,42,56,0.289,0.23,0.18,3482,43.365422,94,350,0.819672131147541
"12797",233897,"The University of Virginia's College at Wise",1,0,2009,397,172,225,87,40,47,0.273,0.219,0.178,3586,37.843073,93,314,0.790931989924433
"12798",233897,"The University of Virginia's College at Wise",1,0,2010,399,197,202,92,33,59,0.3,0.231,0.163,3910,40.639058,91,323,0.80952380952381
"12799",233921,"VIRGINIA POLYTECHNIC INSTITUTE AND STATE UNIV",1,0,1991,4407,1878,2529,1566,697,869,0.463,0.355,0.276,3304,449.499681,1468,3760,0.853188109825278
"12800",233921,"VIRGINIA POLYTECHNIC INSTITUTE AND STATE UNIV",1,0,1992,3851,1639,2212,1386,603,783,0.478,0.36,0.273,3538,465.13678,1452,3259,0.846273695144118
"12801",233921,"VIRGINIA POLYTECHNIC INSTITUTE AND STATE UNIV",1,0,1993,4270,1776,2494,1459,620,839,0.472,0.342,0.249,3812,471.171223,1485,3631,0.850351288056206
"12802",233921,"VIRGINIA POLYTECHNIC INSTITUTE AND STATE UNIV",1,0,1995,4687,2050,2637,1819,745,1074,0.524,0.388,0.283,4087,516.546758,1424,4074,0.869212716023043
"12803",233921,"VIRGINIA POLYTECHNIC INSTITUTE AND STATE UNIV",1,0,1996,5057,2061,2996,2120,970,1150,0.558,0.419,0.324,4131,503.789277,1410,4377,0.865532924658889
"12804",233921,"VIRGINIA POLYTECHNIC INSTITUTE AND STATE UNIV",1,0,1997,4522,1818,2704,1903,869,1034,0.569,0.421,0.321,4147,558.25447,1414,3910,0.864661654135338
"12805",233921,"VIRGINIA POLYTECHNIC INSTITUTE AND STATE UNIV",1,0,1998,4638,1941,2697,1999,855,1144,0.589,0.431,0.317,4305,585.915359,1209,3978,0.857697283311772
"12806",233921,"VIRGINIA POLYTECHNIC INSTITUTE AND STATE UNIV",1,0,1999,4653,1957,2696,2177,996,1181,0.604,0.468,0.369,2792,628.937812,1253,4020,0.863958736299162
"12807",233921,"VIRGINIA POLYTECHNIC INSTITUTE AND STATE UNIV",1,0,2000,4586,2024,2562,2339,1047,1292,0.638,0.51,0.409,2792,670.841623,1274,3878,0.845617095508068
"12808",233921,"VIRGINIA POLYTECHNIC INSTITUTE AND STATE UNIV",1,0,2001,5020,2063,2957,2511,1228,1283,0.622,0.5,0.415,2792,710.281876,1295,3868,0.770517928286853
"12809",233921,"VIRGINIA POLYTECHNIC INSTITUTE AND STATE UNIV",1,0,2002,4714,2002,2712,2437,1151,1286,0.642,0.517,0.424,3044,706.133191,1301,3579,0.759227831989818
"12810",233921,"VIRGINIA POLYTECHNIC INSTITUTE AND STATE UNIV",1,0,2003,4923,2092,2831,2588,1213,1375,0.657,0.526,0.428,4190,703.601849,1251,3635,0.738370912045501
"12811",233921,"VIRGINIA POLYTECHNIC INSTITUTE AND STATE UNIV",1,0,2004,4923,2042,2881,2599,1252,1347,0.66,0.528,0.435,4513,707.281787,1265,3613,0.733902092220191
"12812",233921,"Virginia Polytechnic Institute and State University",1,0,2005,5026,2190,2836,2797,1296,1501,0.685,0.557,0.457,4959,750.663387,1304,3697,0.735575009948269
"12813",233921,"Virginia Polytechnic Institute and State University",1,0,2006,5078,2273,2805,2953,1367,1586,0.698,0.582,0.487,5450,826.337186,1340,3423,0.674084285151635
"12814",233921,"Virginia Polytechnic Institute and State University",1,0,2007,5112,2264,2848,3063,1430,1633,0.721,0.599,0.502,5772,896.176815,1371,3852,0.753521126760563
"12815",233921,"Virginia Polytechnic Institute and State University",1,0,2008,5449,2449,3000,3306,1509,1797,0.734,0.607,0.503,6332,957.835365,1369,4219,0.774270508350156
"12816",233921,"Virginia Polytechnic Institute and State University",1,0,2009,5036,2266,2770,3075,1446,1629,0.719,0.611,0.522,6639,983.238767,1364,3885,0.771445591739476
"12817",233921,"Virginia Polytechnic Institute and State University",1,0,2010,5193,2158,3035,3130,1587,1543,0.715,0.603,0.523,7309,982.778306,1306,4007,0.771615636433661
"12818",234030,"VIRGINIA COMMONWEALTH UNIVERSITY",1,0,1991,1318,799,519,216,65,151,0.189,0.164,0.125,3069,607.414864,780,896,0.679817905918058
"12819",234030,"VIRGINIA COMMONWEALTH UNIVERSITY",1,0,1992,1460,877,583,270,92,178,0.203,0.185,0.158,3529,650.185045,768,994,0.680821917808219
"12820",234030,"VIRGINIA COMMONWEALTH UNIVERSITY",1,0,1993,1466,874,592,281,80,201,0.23,0.192,0.135,3747,670.147718,784,1001,0.68281036834925
"12821",234030,"VIRGINIA COMMONWEALTH UNIVERSITY",1,0,1995,1655,963,692,320,104,216,0.224,0.193,0.15,4030,726.923414,778,1001,0.604833836858006
"12822",234030,"VIRGINIA COMMONWEALTH UNIVERSITY",1,0,1996,1875,1146,729,352,103,249,0.217,0.188,0.141,4071,745.763884,734,1102,0.587733333333333
"12823",234030,"VIRGINIA COMMONWEALTH UNIVERSITY",1,0,1997,2175,1301,874,337,106,231,0.178,0.155,0.121,4111,812.014757,770,1313,0.60367816091954
"12824",234030,"VIRGINIA COMMONWEALTH UNIVERSITY",1,0,1998,2141,1257,884,364,117,247,0.196,0.17,0.132,4182,444.620963,800,1359,0.634750116767866
"12825",234030,"VIRGINIA COMMONWEALTH UNIVERSITY",1,0,1999,2408,1427,981,499,164,335,0.235,0.207,0.167,2492,473.136106,813,1476,0.612956810631229
"12826",234030,"VIRGINIA COMMONWEALTH UNIVERSITY",1,0,2000,2670,1608,1062,522,161,361,0.224,0.196,0.152,2492,491.315488,819.5,1684,0.630711610486891
"12827",234030,"VIRGINIA COMMONWEALTH UNIVERSITY",1,0,2001,2675,1563,1112,547,170,377,0.241,0.204,0.153,2492,509.566123,826,1682,0.628785046728972
"12828",234030,"VIRGINIA COMMONWEALTH UNIVERSITY",1,0,2002,3014,1810,1204,711,237,474,0.262,0.236,0.197,2716,510.071771,807,1893,0.62806901128069
"12829",234030,"VIRGINIA COMMONWEALTH UNIVERSITY",1,0,2003,3230,1912,1318,779,218,561,0.293,0.241,0.165,3600,499.789964,809,2006,0.621052631578947
"12830",234030,"VIRGINIA COMMONWEALTH UNIVERSITY",1,0,2004,3271,1960,1311,749,220,529,0.27,0.229,0.168,3780,518.035721,834,2051,0.62702537450321
"12831",234030,"Virginia Commonwealth University",1,0,2005,3432,2052,1380,904,306,598,0.291,0.263,0.222,4012,579.397262,868,1937,0.564393939393939
"12832",234030,"Virginia Commonwealth University",1,0,2006,3445,1986,1459,1018,346,672,0.338,0.296,0.237,4270,656.133528,899,1811,0.525689404934688
"12833",234030,"Virginia Commonwealth University",1,0,2007,3802,2159,1643,1129,405,724,0.335,0.297,0.247,4525,706.062326,1085,1942,0.510783798001052
"12834",234030,"Virginia Commonwealth University",1,0,2008,3640,2128,1512,1227,429,798,0.375,0.337,0.284,4992,747.036697,1119,1858,0.51043956043956
"12835",234030,"Virginia Commonwealth University",1,0,2009,3588,2094,1494,1318,475,843,0.403,0.367,0.318,5253,794.472993,1096,1814,0.505574136008919
"12836",234030,"Virginia Commonwealth University",1,0,2010,3533,2086,1447,1256,445,811,0.389,0.356,0.308,6953,787.456786,1106,1809,0.512029436739315
"12837",234085,"VIRGINIA MILITARY INSTITUTE",1,0,1997,394,20,374,201,188,13,0.65,0.51,0.503,6380,34.36657,103,322,0.817258883248731
"12838",234085,"VIRGINIA MILITARY INSTITUTE",1,0,1998,375,23,352,180,174,6,0.261,0.48,0.494,6490,37.380572,95,322,0.858666666666667
"12839",234085,"VIRGINIA MILITARY INSTITUTE",1,0,1999,369,24,345,194,180,14,0.583,0.526,0.522,2924,40.116321,98,304,0.823848238482385
"12840",234085,"VIRGINIA MILITARY INSTITUTE",1,0,2000,349,22,327,204,189,15,0.682,0.585,0.578,2924,44.348465,101,310,0.888252148997135
"12841",234085,"VIRGINIA MILITARY INSTITUTE",1,0,2001,372,17,355,205,196,9,0.529,0.551,0.552,2924,47.880795,104,310,0.833333333333333
"12842",234085,"VIRGINIA MILITARY INSTITUTE",1,0,2002,356,24,332,209,197,12,0.5,0.587,0.593,3124,43.528655,102,310,0.870786516853933
"12843",234085,"VIRGINIA MILITARY INSTITUTE",1,0,2003,384,36,348,246,223,23,0.639,0.641,0.641,3856,46.703116,106,330,0.859375
"12844",234085,"VIRGINIA MILITARY INSTITUTE",1,0,2004,363,24,339,216,205,11,0.458,0.595,0.605,4050,49.6221,111,315,0.867768595041322
"12845",234085,"Virginia Military Institute",1,0,2005,363,40,323,209,187,22,0.55,0.576,0.579,4382,52.049908,111,307,0.845730027548209
"12846",234085,"Virginia Military Institute",1,0,2006,387,34,353,216,200,16,0.471,0.558,0.567,4776,56.843831,115,330,0.852713178294574
"12847",234085,"Virginia Military Institute",1,0,2007,410,36,374,240,221,19,0.528,0.585,0.591,5062,60.629342,116,334,0.814634146341463
"12848",234085,"Virginia Military Institute",1,0,2008,391,33,358,210,192,18,0.545,0.537,0.536,5262,100.999558,120,314,0.80306905370844
"12849",234085,"Virginia Military Institute",1,0,2009,429,42,387,261,237,24,0.571,0.608,0.612,5500,69.396826,121,360,0.839160839160839
"12850",234085,"Virginia Military Institute",1,0,2010,440,51,389,64,27,37,0.726,0.145,0.069,6024,69.483221,117,384,0.872727272727273
"12851",234155,"VIRGINIA STATE UNIVERSITY",1,0,1991,1161,692,469,107,12,95,0.137,0.092,0.026,2668,53.03494,194,11,0.00947459086993971
"12852",234155,"VIRGINIA STATE UNIVERSITY",1,0,1992,911,496,415,46,11,35,0.071,0.05,0.027,2913,47.421389,188,13,0.0142700329308452
"12853",234155,"VIRGINIA STATE UNIVERSITY",1,0,1993,695,409,286,88,33,55,0.134,0.127,0.115,3050,48.443341,191,12,0.0172661870503597
"12854",234155,"VIRGINIA STATE UNIVERSITY",1,0,1995,734,431,303,131,35,96,0.223,0.178,0.116,3256,55.458246,171,10,0.0136239782016349
"12855",234155,"VIRGINIA STATE UNIVERSITY",1,0,1996,782,465,317,186,47,139,0.299,0.238,0.148,3291,53.636044,165,6,0.00767263427109974
"12856",234155,"VIRGINIA STATE UNIVERSITY",1,0,1997,865,493,372,170,48,122,0.248,0.197,0.129,3307,58.133939,168,11,0.0127167630057803
"12857",234155,"VIRGINIA STATE UNIVERSITY",1,0,1998,871,526,345,192,48,144,0.274,0.22,0.139,3439,60.910875,170,11,0.0126291618828932
"12858",234155,"VIRGINIA STATE UNIVERSITY",1,0,1999,937,543,394,185,48,137,0.252,0.197,0.122,1588,62.928257,176,3,0.0032017075773746
"12859",234155,"VIRGINIA STATE UNIVERSITY",1,0,2000,885,498,387,187,45,142,0.285,0.211,0.116,1588,71.656584,178,7,0.00790960451977401
"12860",234155,"VIRGINIA STATE UNIVERSITY",1,0,2001,1085,618,467,252,61,191,0.309,0.232,0.131,1588,84.333341,180,9,0.00829493087557604
"12861",234155,"VIRGINIA STATE UNIVERSITY",1,0,2002,1129,650,479,237,60,177,0.272,0.21,0.125,1780,77.146445,207,9,0.00797165633303809
"12862",234155,"VIRGINIA STATE UNIVERSITY",1,0,2003,959,563,396,240,62,178,0.316,0.25,0.157,2412,80.944385,207,7,0.0072992700729927
"12863",234155,"VIRGINIA STATE UNIVERSITY",1,0,2004,1025,656,369,250,54,196,0.299,0.244,0.146,2150,80.70791,214,7,0.00682926829268293
"12864",234155,"Virginia State University",1,0,2005,1176,775,401,234,48,186,0.24,0.199,0.12,2317,89.014376,223,11,0.00935374149659864
"12865",234155,"Virginia State University",1,0,2006,869,540,329,209,54,155,0.287,0.241,0.164,3007,95.827352,238,5,0.00575373993095512
"12866",234155,"Virginia State University",1,0,2007,1185,796,389,259,58,201,0.252,0.219,0.149,3186,108.297882,263,9,0.00759493670886076
"12867",234155,"Virginia State University",1,0,2008,1323,832,491,302,64,238,0.286,0.228,0.13,3313,112.208049,254,22,0.0166288737717309
"12868",234155,"Virginia State University",1,0,2009,1225,806,419,353,93,260,0.323,0.288,0.222,3584,122.111792,247,14,0.0114285714285714
"12869",234155,"Virginia State University",1,0,2010,1282,802,480,307,64,243,0.303,0.239,0.133,3886,125.376039,247,16,0.0124804992199688
"12870",234164,"VIRGINIA UNION UNIVERSITY",1,0,1991,382,196,186,53,9,44,0.224,0.139,0.048,6153,14.920568,78,0,0
"12871",234164,"VIRGINIA UNION UNIVERSITY",1,0,1992,449,238,211,45,12,33,0.139,0.1,0.057,6557,16.034138,76,0,0
"12872",234164,"VIRGINIA UNION UNIVERSITY",1,0,1993,435,240,195,49,15,34,0.142,0.113,0.077,7061,17.534339,78,0,0
"12873",234164,"VIRGINIA UNION UNIVERSITY",1,0,1995,441,234,207,2,0,2,0.009,0.005,0,8219,20.176516,74,1,0.00226757369614512
"12874",234164,"VIRGINIA UNION UNIVERSITY",1,0,1996,380,211,169,75,16,59,0.28,0.197,0.095,8590,20.975303,83,5,0.0131578947368421
"12875",234164,"VIRGINIA UNION UNIVERSITY",1,0,1997,304,155,149,3,1,2,0.013,0.01,0.007,8980,17.230367,81,1,0.00328947368421053
"12876",234164,"VIRGINIA UNION UNIVERSITY",1,0,1998,313,191,122,61,15,46,0.241,0.195,0.123,9110,17.813727,92,0,0
"12877",234164,"VIRGINIA UNION UNIVERSITY",1,0,1999,268,167,101,50,8,42,0.252,0.187,0.079,8780,19.293334,90,0,0
"12878",234164,"VIRGINIA UNION UNIVERSITY",1,0,2000,456,265,191,69,16,53,0.2,0.151,0.084,8780,20.562091,83,3,0.00657894736842105
"12879",234164,"VIRGINIA UNION UNIVERSITY",1,0,2001,534,316,218,68,12,56,0.177,0.127,0.055,9640,21.492861,76,3,0.00561797752808989
"12880",234164,"VIRGINIA UNION UNIVERSITY",1,0,2002,437,259,178,74,14,60,0.232,0.169,0.079,16082,24.746765,84,3,0.0068649885583524
"12881",234164,"VIRGINIA UNION UNIVERSITY",1,0,2003,512,318,194,99,16,83,0.261,0.193,0.082,10460,24.355352,84,5,0.009765625
"12882",234164,"VIRGINIA UNION UNIVERSITY",1,0,2004,431,247,184,78,17,61,0.247,0.181,0.092,11090,25.947494,74,4,0.00928074245939675
"12883",234164,"Virginia Union University",1,0,2005,356,197,159,57,14,43,0.218,0.16,0.088,11600,24.573759,74,4,0.0112359550561798
"12884",234164,"Virginia Union University",1,0,2006,325,160,165,58,13,45,0.281,0.178,0.079,11948,23.39115,85,1,0.00307692307692308
"12885",234164,"Virginia Union University",1,0,2007,375,209,166,81,17,64,0.306,0.216,0.102,12188,23.851325,74,2,0.00533333333333333
"12886",234164,"Virginia Union University",1,0,2008,345,170,175,48,20,28,0.165,0.139,0.114,12432,25.298897,62,0,0
"12887",234164,"Virginia Union University",1,0,2009,554,303,251,99,34,65,0.214,0.179,0.135,12680,25.488849,87,0,0
"12888",234164,"Virginia Union University",1,0,2010,460,260,200,76,26,50,0.192,0.165,0.13,13314,29.410034,88,0,0
"12889",235097,"EASTERN WASHINGTON UNIVERSITY",0,1,1991,730,421,309,114,40,74,0.176,0.156,0.129,1698,78.989946,358,611,0.836986301369863
"12890",235097,"EASTERN WASHINGTON UNIVERSITY",0,1,1992,753,480,273,124,38,86,0.179,0.165,0.139,1785,82.181118,363,615,0.816733067729084
"12891",235097,"EASTERN WASHINGTON UNIVERSITY",0,1,1993,725,424,301,131,45,86,0.203,0.181,0.15,2091,88.375969,348,581,0.801379310344828
"12892",235097,"EASTERN WASHINGTON UNIVERSITY",0,1,1995,687,464,223,109,18,91,0.196,0.159,0.081,2463,90.675923,389,546,0.794759825327511
"12893",235097,"EASTERN WASHINGTON UNIVERSITY",0,1,1996,639,399,240,114,29,85,0.213,0.178,0.121,2445,93.498492,381,506,0.791862284820031
"12894",235097,"EASTERN WASHINGTON UNIVERSITY",0,1,1997,624,367,257,86,21,65,0.177,0.138,0.082,2520,93.62107,349,512,0.82051282051282
"12895",235097,"EASTERN WASHINGTON UNIVERSITY",0,1,1998,816,486,330,148,34,114,0.235,0.181,0.103,2622,95.315132,348,637,0.780637254901961
"12896",235097,"EASTERN WASHINGTON UNIVERSITY",0,1,1999,1072,652,420,164,45,119,0.182,0.153,0.107,2700,100.939479,346,851,0.79384328358209
"12897",235097,"EASTERN WASHINGTON UNIVERSITY",0,1,2000,1085,642,443,227,64,163,0.254,0.209,0.144,2790,110.328502,349,876,0.807373271889401
"12898",235097,"EASTERN WASHINGTON UNIVERSITY",0,1,2001,1179,694,485,256,98,158,0.228,0.217,0.202,2964,119.580469,352,939,0.796437659033079
"12899",235097,"EASTERN WASHINGTON UNIVERSITY",0,1,2002,1265,768,497,274,84,190,0.247,0.217,0.169,3357,121.810941,356,1003,0.792885375494071
"12900",235097,"EASTERN WASHINGTON UNIVERSITY",0,1,2003,1374,843,531,295,81,214,0.254,0.215,0.153,3582,136.301648,371,948,0.689956331877729
"12901",235097,"EASTERN WASHINGTON UNIVERSITY",0,1,2004,1403,813,590,297,102,195,0.24,0.212,0.173,3822,136.341306,396,999,0.712045616535994
"12902",235097,"Eastern Washington University",0,1,2005,1610,992,618,340,120,220,0.222,0.211,0.194,4044,144.073663,411,1124,0.698136645962733
"12903",235097,"Eastern Washington University",0,1,2006,1412,855,557,280,84,196,0.229,0.198,0.151,4278,154.09943,424,941,0.66643059490085
"12904",235097,"Eastern Washington University",0,1,2007,1313,770,543,243,81,162,0.21,0.185,0.149,4805,168.057832,427,897,0.683168316831683
"12905",235097,"Eastern Washington University",0,1,2008,1488,859,629,295,110,185,0.215,0.198,0.175,4701,185.060428,427,1019,0.684811827956989
"12906",235097,"Eastern Washington University",0,1,2009,1459,848,611,298,98,200,0.236,0.204,0.16,5340,188.126013,410,940,0.644276901987663
"12907",235097,"Eastern Washington University",0,1,2010,1524,887,637,324,109,215,0.242,0.213,0.171,6063,181.634153,410,1035,0.679133858267717
"12908",235167,"EVERGREEN STATE COLLEGE",0,1,1991,445,263,182,173,59,114,0.434,0.389,0.324,1758,38.920261,160,348,0.782022471910112
"12909",235167,"EVERGREEN STATE COLLEGE",0,1,1992,399,239,160,116,39,77,0.322,0.291,0.244,1785,38.664965,157,313,0.784461152882206
"12910",235167,"EVERGREEN STATE COLLEGE",0,1,1993,435,253,182,158,63,95,0.376,0.363,0.346,1971,42.528437,154,335,0.770114942528736
"12911",235167,"EVERGREEN STATE COLLEGE",0,1,1995,536,318,218,224,88,136,0.428,0.418,0.404,2442,44.675136,154,396,0.738805970149254
"12912",235167,"EVERGREEN STATE COLLEGE",0,1,1996,530,308,222,200,74,126,0.409,0.377,0.333,2544,44.029327,151,407,0.767924528301887
"12913",235167,"EVERGREEN STATE COLLEGE",0,1,1997,494,271,223,186,71,115,0.424,0.377,0.318,2573,47.930222,153,340,0.688259109311741
"12914",235167,"EVERGREEN STATE COLLEGE",0,1,1998,475,280,195,185,65,120,0.429,0.389,0.333,2637,49.182542,156,348,0.732631578947368
"12915",235167,"EVERGREEN STATE COLLEGE",0,1,1999,456,256,200,190,69,121,0.473,0.417,0.345,2757,52.383525,165,323,0.708333333333333
"12916",235167,"EVERGREEN STATE COLLEGE",0,1,2000,468,254,214,208,81,127,0.5,0.444,0.379,2856,57.789578,162,333,0.711538461538462
"12917",235167,"EVERGREEN STATE COLLEGE",0,1,2001,460,236,224,206,93,113,0.479,0.448,0.415,3024,63.527638,159,347,0.754347826086956
"12918",235167,"EVERGREEN STATE COLLEGE",0,1,2002,486,236,250,250,133,117,0.496,0.514,0.532,3441,80.374414,161,361,0.742798353909465
"12919",235167,"EVERGREEN STATE COLLEGE",0,1,2003,454,246,208,193,98,95,0.386,0.425,0.471,3651,74.67742,157,308,0.6784140969163
"12920",235167,"EVERGREEN STATE COLLEGE",0,1,2004,479,250,229,185,87,98,0.392,0.386,0.38,3900,100.320059,160,333,0.695198329853862
"12921",235167,"The Evergreen State College",0,1,2005,590,296,294,243,114,129,0.436,0.412,0.388,4128,81.343161,158,429,0.727118644067797
"12922",235167,"The Evergreen State College",0,1,2006,577,300,277,227,103,124,0.413,0.393,0.372,4371,86.175289,158,414,0.717504332755633
"12923",235167,"The Evergreen State College",0,1,2007,677,347,330,288,138,150,0.432,0.425,0.418,4590,87.767019,158,488,0.72082717872969
"12924",235167,"The Evergreen State College",0,1,2008,658,321,337,302,146,156,0.486,0.459,0.433,4797,90.310143,164,498,0.756838905775076
"12925",235167,"The Evergreen State College",0,1,2009,576,284,292,234,112,122,0.43,0.406,0.384,5412,93.827918,169,408,0.708333333333333
"12926",235167,"The Evergreen State College",0,1,2010,612,332,280,265,118,147,0.443,0.433,0.421,6108,94.563259,169,431,0.704248366013072
"12927",236230,"PACIFIC LUTHERAN UNIVERSITY",1,0,1991,489,291,198,215,63,152,0.522,0.44,0.318,11075,49.086886,225,432,0.883435582822086
"12928",236230,"PACIFIC LUTHERAN UNIVERSITY",1,0,1992,500,295,205,214,69,145,0.492,0.428,0.337,11968,50.347564,225,441,0.882
"12929",236230,"PACIFIC LUTHERAN UNIVERSITY",1,0,1993,499,269,230,228,90,138,0.513,0.457,0.391,12672,53.213086,229,437,0.875751503006012
"12930",236230,"PACIFIC LUTHERAN UNIVERSITY",1,0,1995,667,394,273,264,81,183,0.464,0.396,0.297,13856,59.333301,229,571,0.856071964017991
"12931",236230,"PACIFIC LUTHERAN UNIVERSITY",1,0,1996,610,359,251,284,97,187,0.521,0.466,0.386,14560,59.557568,232,523,0.857377049180328
"12932",236230,"PACIFIC LUTHERAN UNIVERSITY",1,0,1997,660,394,266,303,87,216,0.548,0.459,0.327,15316,50.449246,231,551,0.834848484848485
"12933",236230,"PACIFIC LUTHERAN UNIVERSITY",1,0,1998,652,414,238,272,77,195,0.471,0.417,0.324,15680,52.386087,229,541,0.829754601226994
"12934",236230,"PACIFIC LUTHERAN UNIVERSITY",1,0,1999,562,370,192,241,77,164,0.443,0.429,0.401,16224,57.235901,234,455,0.809608540925267
"12935",236230,"PACIFIC LUTHERAN UNIVERSITY",1,0,2000,580,355,225,293,94,199,0.561,0.505,0.418,16800,59.912805,230,495,0.853448275862069
"12936",236230,"PACIFIC LUTHERAN UNIVERSITY",1,0,2001,578,348,230,287,89,198,0.569,0.497,0.387,17728,63.637383,226,483,0.835640138408305
"12937",236230,"PACIFIC LUTHERAN UNIVERSITY",1,0,2002,625,400,225,325,98,227,0.568,0.52,0.436,18500,67.566586,214,508,0.8128
"12938",236230,"PACIFIC LUTHERAN UNIVERSITY",1,0,2003,693,426,267,361,118,243,0.57,0.521,0.442,19610,68.258823,228,556,0.802308802308802
"12939",236230,"PACIFIC LUTHERAN UNIVERSITY",1,0,2004,697,462,235,327,96,231,0.5,0.469,0.409,20790,71.500034,237,540,0.774748923959828
"12940",236230,"Pacific Lutheran University",1,0,2005,687,432,255,340,106,234,0.542,0.495,0.416,22040,76.365171,202,550,0.800582241630277
"12941",236230,"Pacific Lutheran University",1,0,2006,668,418,250,401,142,259,0.62,0.6,0.568,23450,83.130638,220,517,0.773952095808383
"12942",236230,"Pacific Lutheran University",1,0,2007,714,453,261,394,134,260,0.574,0.552,0.513,25088,85.945318,235,533,0.746498599439776
"12943",236230,"Pacific Lutheran University",1,0,2008,712,444,268,372,115,257,0.579,0.522,0.429,26800,91.654353,211,553,0.776685393258427
"12944",236230,"Pacific Lutheran University",1,0,2009,712,436,276,373,123,250,0.573,0.524,0.446,28100,94.11123,206,557,0.782303370786517
"12945",236230,"Pacific Lutheran University",1,0,2010,687,415,272,398,141,257,0.619,0.579,0.518,29200,94.935509,209,512,0.745269286754003
"12946",236328,"UNIVERSITY OF PUGET SOUND",1,0,1991,696,395,301,401,162,239,0.605,0.576,0.538,12690,61.499,173,531,0.762931034482759
"12947",236328,"UNIVERSITY OF PUGET SOUND",1,0,1992,725,446,279,433,166,267,0.599,0.597,0.595,13780,67.156,173,557,0.768275862068965
"12948",236328,"UNIVERSITY OF PUGET SOUND",1,0,1993,687,402,285,402,159,243,0.605,0.585,0.558,15220,71.585,175,518,0.754002911208151
"12949",236328,"UNIVERSITY OF PUGET SOUND",1,0,1995,656,374,282,404,162,242,0.647,0.616,0.574,17310,68.566,178,494,0.753048780487805
"12950",236328,"UNIVERSITY OF PUGET SOUND",1,0,1996,740,445,295,459,171,288,0.647,0.62,0.58,18030,75.603,177,525,0.709459459459459
"12951",236328,"UNIVERSITY OF PUGET SOUND",1,0,1997,642,390,252,430,155,275,0.705,0.67,0.615,18940,57.945,178,492,0.766355140186916
"12952",236328,"UNIVERSITY OF PUGET SOUND",1,0,1998,680,417,263,446,151,295,0.707,0.656,0.574,19795,58.716001,181,525,0.772058823529412
"12953",236328,"UNIVERSITY OF PUGET SOUND",1,0,1999,682,413,269,443,170,273,0.661,0.65,0.632,20450,60.73,211,528,0.774193548387097
"12954",236328,"UNIVERSITY OF PUGET SOUND",1,0,2000,647,408,239,442,155,287,0.703,0.683,0.649,21270,63.691,215.5,474,0.732612055641422
"12955",236328,"UNIVERSITY OF PUGET SOUND",1,0,2001,702,423,279,477,182,295,0.697,0.679,0.652,22350,66.973,220,562,0.800569800569801
"12956",236328,"UNIVERSITY OF PUGET SOUND",1,0,2002,666,399,267,459,173,286,0.717,0.689,0.648,23780,69.136,218,531,0.797297297297297
"12957",236328,"UNIVERSITY OF PUGET SOUND",1,0,2003,639,358,281,438,164,274,0.765,0.685,0.584,25190,65.912,235,483,0.755868544600939
"12958",236328,"UNIVERSITY OF PUGET SOUND",1,0,2004,671,390,281,471,190,281,0.721,0.702,0.676,26700,77.023,232,513,0.764530551415797
"12959",236328,"University of Puget Sound",1,0,2005,669,385,284,446,180,266,0.691,0.667,0.634,28270,79.025,237,497,0.742899850523169
"12960",236328,"University of Puget Sound",1,0,2006,677,406,271,464,173,291,0.717,0.685,0.638,29870,82.554,238,522,0.771048744460857
"12961",236328,"University of Puget Sound",1,0,2007,641,393,248,437,157,280,0.713,0.682,0.633,31700,87.405,238,473,0.737909516380655
"12962",236328,"University of Puget Sound",1,0,2008,676,377,299,459,187,272,0.722,0.679,0.625,33780,94.397,236,540,0.798816568047337
"12963",236328,"University of Puget Sound",1,0,2009,719,419,300,517,198,319,0.761,0.719,0.66,35440,99.995,230,547,0.760778859527121
"12964",236328,"University of Puget Sound",1,0,2010,625,355,270,436,168,268,0.755,0.698,0.622,37030,100.85,233,495,0.792
"12965",236577,"SEATTLE PACIFIC UNIVERSITY",0,1,1991,370,253,117,95,27,68,0.269,0.257,0.231,10581,41.906,141,311,0.840540540540541
"12966",236577,"SEATTLE PACIFIC UNIVERSITY",0,1,1992,380,253,127,103,24,79,0.312,0.271,0.189,11301,42.506,144,316,0.831578947368421
"12967",236577,"SEATTLE PACIFIC UNIVERSITY",0,1,1993,395,263,132,117,42,75,0.285,0.296,0.318,11979,45.187,144,346,0.875949367088608
"12968",236577,"SEATTLE PACIFIC UNIVERSITY",0,1,1995,397,254,143,138,58,80,0.315,0.348,0.406,13479,51.013,138,340,0.856423173803526
"12969",236577,"SEATTLE PACIFIC UNIVERSITY",0,1,1996,465,323,142,173,52,121,0.375,0.372,0.366,13680,53.288,140,421,0.905376344086022
"12970",236577,"SEATTLE PACIFIC UNIVERSITY",0,1,1997,584,392,192,233,63,170,0.434,0.399,0.328,14130,43.01,138,496,0.849315068493151
"12971",236577,"SEATTLE PACIFIC UNIVERSITY",0,1,1998,582,376,206,232,75,157,0.418,0.399,0.364,14541,43.862,145,506,0.869415807560137
"12972",236577,"SEATTLE PACIFIC UNIVERSITY",0,1,1999,567,392,175,272,79,193,0.492,0.48,0.451,14924,46.75,152,490,0.864197530864197
"12973",236577,"SEATTLE PACIFIC UNIVERSITY",0,1,2000,612,413,199,293,90,203,0.492,0.479,0.452,15381,50.686,162.5,532,0.869281045751634
"12974",236577,"SEATTLE PACIFIC UNIVERSITY",0,1,2001,645,433,212,327,95,232,0.536,0.507,0.448,16335,55.309,173,565,0.875968992248062
"12975",236577,"SEATTLE PACIFIC UNIVERSITY",0,1,2002,601,412,189,302,94,208,0.505,0.502,0.497,17592,59.892,168,519,0.863560732113145
"12976",236577,"SEATTLE PACIFIC UNIVERSITY",0,1,2003,683,485,198,410,105,305,0.629,0.6,0.53,18822,65.212,169,599,0.87701317715959
"12977",236577,"SEATTLE PACIFIC UNIVERSITY",0,1,2004,633,414,219,341,115,226,0.546,0.539,0.525,20139,69.028,177,497,0.785150078988942
"12978",236577,"Seattle Pacific University",0,1,2005,710,490,220,425,123,302,0.616,0.599,0.559,21447,71.916,178,596,0.83943661971831
"12979",236577,"Seattle Pacific University",0,1,2006,622,413,209,350,111,239,0.579,0.563,0.531,23055,74.09,183,514,0.826366559485531
"12980",236577,"Seattle Pacific University",0,1,2007,716,499,217,390,110,280,0.561,0.545,0.507,24783,77.467,187,548,0.76536312849162
"12981",236577,"Seattle Pacific University",0,1,2008,712,492,220,431,122,309,0.628,0.605,0.555,26457,87.772,190,563,0.790730337078652
"12982",236577,"Seattle Pacific University",0,1,2009,682,489,193,361,93,268,0.548,0.529,0.482,27450,85.067,195,484,0.709677419354839
"12983",236577,"Seattle Pacific University",0,1,2010,726,501,225,405,120,285,0.569,0.558,0.533,28602,87.605,201,549,0.756198347107438
"12984",236595,"SEATTLE UNIVERSITY",0,1,1991,390,229,161,133,51,82,0.358,0.341,0.317,10710,52.071957,186,218,0.558974358974359
"12985",236595,"SEATTLE UNIVERSITY",0,1,1992,439,236,203,161,74,87,0.369,0.367,0.365,11520,61.774622,211,231,0.52619589977221
"12986",236595,"SEATTLE UNIVERSITY",0,1,1993,489,276,213,165,61,104,0.377,0.337,0.286,12150,67.39984,237,309,0.631901840490798
"12987",236595,"SEATTLE UNIVERSITY",0,1,1995,426,245,181,165,56,109,0.445,0.387,0.309,13635,89.343376,293,235,0.551643192488263
"12988",236595,"SEATTLE UNIVERSITY",0,1,1996,576,358,218,245,78,167,0.466,0.425,0.358,14265,93.234744,288,319,0.553819444444444
"12989",236595,"SEATTLE UNIVERSITY",0,1,1997,499,288,211,220,78,142,0.493,0.441,0.37,14805,79.508045,288,278,0.557114228456914
"12990",236595,"SEATTLE UNIVERSITY",0,1,1998,626,369,257,287,114,173,0.469,0.458,0.444,15255,82.08868,303,335,0.535143769968051
"12991",236595,"SEATTLE UNIVERSITY",0,1,1999,578,351,227,256,92,164,0.467,0.443,0.405,16110,85.295099,311,300,0.519031141868512
"12992",236595,"SEATTLE UNIVERSITY",0,1,2000,664,428,236,338,104,234,0.547,0.509,0.441,17010,90.230947,321,353,0.531626506024096
"12993",236595,"SEATTLE UNIVERSITY",0,1,2001,643,412,231,321,101,220,0.534,0.499,0.437,17865,98.184132,331,358,0.556765163297045
"12994",236595,"SEATTLE UNIVERSITY",0,1,2002,633,387,246,324,110,214,0.553,0.512,0.447,18885,108.236841,312,341,0.53870458135861
"12995",236595,"SEATTLE UNIVERSITY",0,1,2003,619,418,201,323,75,248,0.593,0.522,0.373,20070,115.19906,312,330,0.533117932148627
"12996",236595,"SEATTLE UNIVERSITY",0,1,2004,719,447,272,407,138,269,0.602,0.566,0.507,21285,126.257767,354,404,0.561891515994437
"12997",236595,"Seattle University",0,1,2005,739,454,285,422,156,266,0.586,0.571,0.547,22905,134.303649,355,425,0.57510148849797
"12998",236595,"Seattle University",0,1,2006,731,463,268,455,165,290,0.626,0.622,0.616,24615,146.505081,360,394,0.538987688098495
"12999",236595,"Seattle University",0,1,2007,736,479,257,432,127,305,0.637,0.587,0.494,26325,157.632461,406,399,0.542119565217391
"13000",236595,"Seattle University",0,1,2008,881,557,324,530,170,360,0.646,0.602,0.525,28260,166.906979,413,522,0.592508513053349
"13001",236595,"Seattle University",0,1,2009,730,459,271,468,156,312,0.68,0.641,0.576,29340,173.232063,393,375,0.513698630136986
"13002",236595,"Seattle University",0,1,2010,1037,660,377,667,232,435,0.659,0.643,0.615,30825,175.03125,423,566,0.545805207328833
"13003",236896,"WALLA WALLA COLLEGE",0,1,1991,282,132,150,55,26,29,0.22,0.195,0.173,9089,22.196755,107,231,0.819148936170213
"13004",236896,"WALLA WALLA COLLEGE",0,1,1992,267,126,141,58,27,31,0.246,0.217,0.191,9666,24.127737,112,205,0.767790262172285
"13005",236896,"WALLA WALLA COLLEGE",0,1,1993,263,138,125,70,29,41,0.297,0.266,0.232,10200,25.715262,117,219,0.832699619771863
"13006",236896,"WALLA WALLA COLLEGE",0,1,1995,288,145,143,57,22,35,0.241,0.198,0.154,12140,26.053053,121,262,0.909722222222222
"13007",236896,"WALLA WALLA COLLEGE",0,1,1996,292,144,148,40,18,22,0.153,0.137,0.122,12033,30.695063,125,263,0.900684931506849
"13008",236896,"WALLA WALLA COLLEGE",0,1,1997,283,142,141,62,29,33,0.232,0.219,0.206,12588,31.489817,135,244,0.862190812720848
"13009",236896,"WALLA WALLA COLLEGE",0,1,1998,305,165,140,60,27,33,0.2,0.197,0.193,13854,27.175246,135,274,0.898360655737705
"13010",236896,"WALLA WALLA COLLEGE",0,1,1999,323,158,165,64,28,36,0.228,0.198,0.17,14601,27.636555,128,275,0.851393188854489
"13011",236896,"WALLA WALLA COLLEGE",0,1,2000,338,160,178,62,25,37,0.231,0.183,0.14,15303,30.017582,132.5,289,0.855029585798817
"13012",236896,"WALLA WALLA COLLEGE",0,1,2001,285,149,136,63,26,37,0.248,0.221,0.191,16107,32.483816,137,248,0.870175438596491
"13013",236896,"WALLA WALLA COLLEGE",0,1,2002,336,172,164,61,29,32,0.186,0.182,0.177,16134,33.885712,133,282,0.839285714285714
"13014",236896,"WALLA WALLA COLLEGE",0,1,2003,326,157,169,66,31,35,0.223,0.202,0.183,16860,35.387757,135,265,0.812883435582822
"13015",236896,"WALLA WALLA COLLEGE",0,1,2004,352,173,179,83,33,50,0.289,0.236,0.184,17655,39.864243,140,279,0.792613636363636
"13016",236896,"Walla Walla College",0,1,2005,292,132,160,62,34,28,0.212,0.212,0.212,18696,38.275163,138,229,0.784246575342466
"13017",236896,"Walla Walla College",0,1,2006,323,164,159,62,28,34,0.207,0.192,0.176,19725,40.942781,133,238,0.736842105263158
"13018",236896,"Walla Walla University",0,1,2007,344,162,182,58,25,33,0.204,0.169,0.137,20910,42.053249,126,263,0.76453488372093
"13019",236896,"Walla Walla University",0,1,2008,310,158,152,63,24,39,0.247,0.203,0.158,21726,43.424496,127,224,0.72258064516129
"13020",236896,"Walla Walla University",0,1,2009,316,157,159,59,20,39,0.248,0.187,0.126,22575,44.55942,118,241,0.762658227848101
"13021",236896,"Walla Walla University",0,1,2010,305,151,154,72,35,37,0.245,0.236,0.227,23229,43.139411,119,243,0.79672131147541
"13022",236939,"WASHINGTON STATE UNIVERSITY",1,0,1991,1852,982,870,470,171,299,0.304,0.254,0.197,2178,347.496606,973,1544,0.833693304535637
"13023",236939,"WASHINGTON STATE UNIVERSITY",1,0,1992,2027,1019,1008,527,212,315,0.309,0.26,0.21,2254,360.897245,962,1703,0.840157868771584
"13024",236939,"WASHINGTON STATE UNIVERSITY",1,0,1993,2431,1234,1197,644,235,409,0.331,0.265,0.196,2532,374.000966,965,2000,0.822706705059646
"13025",236939,"WASHINGTON STATE UNIVERSITY",1,0,1995,2512,1217,1295,734,315,419,0.344,0.292,0.243,3022,408.167981,983,2022,0.804936305732484
"13026",236939,"WASHINGTON STATE UNIVERSITY",1,0,1996,2272,1169,1103,694,263,431,0.369,0.305,0.238,3142,438.01062,1004,1828,0.804577464788732
"13027",236939,"WASHINGTON STATE UNIVERSITY",1,0,1997,2276,1191,1085,657,235,422,0.354,0.289,0.217,3266,454.107002,1000,1791,0.786906854130053
"13028",236939,"WASHINGTON STATE UNIVERSITY",1,0,1998,2934,1526,1408,888,335,553,0.362,0.303,0.238,3396,467.667717,1006,2353,0.801976823449216
"13029",236939,"WASHINGTON STATE UNIVERSITY",1,0,1999,2456,1276,1180,791,306,485,0.38,0.322,0.259,3233,472.95475,980,2042,0.8314332247557
"13030",236939,"WASHINGTON STATE UNIVERSITY",1,0,2000,2440,1257,1183,794,277,517,0.411,0.325,0.234,3351,497.814989,985.5,1982,0.812295081967213
"13031",236939,"WASHINGTON STATE UNIVERSITY",1,0,2001,2575,1369,1206,852,314,538,0.393,0.331,0.26,3574,542.695662,991,2044,0.79378640776699
"13032",236939,"WASHINGTON STATE UNIVERSITY",1,0,2002,2771,1469,1302,1018,372,646,0.44,0.367,0.286,4145,606.172643,1013,2139,0.77192349332371
"13033",236939,"WASHINGTON STATE UNIVERSITY",1,0,2003,2997,1613,1384,1204,417,787,0.488,0.402,0.301,4435,615.532567,1018,2355,0.785785785785786
"13034",236939,"WASHINGTON STATE UNIVERSITY",1,0,2004,3089,1622,1467,1251,495,756,0.466,0.405,0.337,4745,642.457502,1016,2398,0.776303010683069
"13035",236939,"Washington State University",1,0,2005,2855,1418,1437,1072,413,659,0.465,0.375,0.287,5077,679.157967,1028,2301,0.805954465849387
"13036",236939,"Washington State University",1,0,2006,2676,1349,1327,1040,417,623,0.462,0.389,0.314,5432,714.504144,1049,2108,0.787742899850523
"13037",236939,"Washington State University",1,0,2007,3184,1588,1596,1275,508,767,0.483,0.4,0.318,5812,744.406851,1118,2468,0.775125628140704
"13038",236939,"Washington State University",1,0,2008,3391,1744,1647,1408,536,872,0.5,0.415,0.325,6218,831.103756,1215,2610,0.769684458861693
"13039",236939,"Washington State University",1,0,2009,3627,1888,1739,1366,549,817,0.433,0.377,0.316,7088,841.37936,1166,2665,0.734767025089606
"13040",236939,"Washington State University",1,0,2010,3241,1634,1607,1327,525,802,0.491,0.409,0.327,8080,845.005761,1182,2276,0.702252391237272
"13041",236948,"UNIVERSITY OF WASHINGTON",0,1,1991,3484,1788,1696,1287,482,805,0.45,0.369,0.284,2178,1065.914,1890,2295,0.658725602755454
"13042",236948,"UNIVERSITY OF WASHINGTON",0,1,1992,3509,1769,1740,1315,517,798,0.451,0.375,0.297,2253,1135.659,1883,2282,0.650327728697635
"13043",236948,"UNIVERSITY OF WASHINGTON",0,1,1993,3206,1576,1630,1217,515,702,0.445,0.38,0.316,2532,1259.487,1906,2084,0.650031191515908
"13044",236948,"UNIVERSITY OF WASHINGTON",0,1,1995,3500,1783,1717,1405,562,843,0.473,0.401,0.327,3019,1408.205,1855,2182,0.623428571428571
"13045",236948,"UNIVERSITY OF WASHINGTON",0,1,1996,3789,1964,1825,1613,648,965,0.491,0.426,0.355,3250,1458.911,1858,2227,0.587754024808657
"13046",236948,"UNIVERSITY OF WASHINGTON",0,1,1997,4346,2270,2076,1734,667,1067,0.47,0.399,0.321,3366,1528.754,1861,2438,0.560975609756098
"13047",236948,"UNIVERSITY OF WASHINGTON",0,1,1998,4038,2076,1962,1716,718,998,0.481,0.425,0.366,3495,1626.574,1900,2172,0.537890044576523
"13048",236948,"UNIVERSITY OF WASHINGTON-SEATTLE CAMPUS",0,1,1999,4319,2279,2040,1977,790,1187,0.521,0.458,0.387,3251,1825.467,1930,2303,0.53322528363047
"13049",236948,"UNIVERSITY OF WASHINGTON-SEATTLE CAMPUS",0,1,2000,4765,2495,2270,2271,926,1345,0.539,0.477,0.408,3638,1956.961,2684,2632,0.552360965372508
"13050",236948,"UNIVERSITY OF WASHINGTON-SEATTLE CAMPUS",0,1,2001,5288,2737,2551,2555,1099,1456,0.532,0.483,0.431,3593,2151.293,3438,2693,0.509266263237519
"13051",236948,"UNIVERSITY OF WASHINGTON-SEATTLE CAMPUS",0,1,2002,4776,2561,2215,2450,1039,1411,0.551,0.513,0.469,4167,2276.752668,2009,2615,0.547529313232831
"13052",236948,"UNIVERSITY OF WASHINGTON-SEATTLE CAMPUS",0,1,2003,4948,2654,2294,2665,1106,1559,0.587,0.539,0.482,4458,2420.594261,1768,2652,0.535974130962005
"13053",236948,"UNIVERSITY OF WASHINGTON-SEATTLE CAMPUS",0,1,2004,4867,2639,2228,2625,1075,1550,0.587,0.539,0.482,4770,2560.18579,1787,2614,0.537086500924594
"13054",236948,"University of Washington-Seattle Campus",0,1,2005,4892,2622,2270,2883,1209,1674,0.638,0.589,0.533,5103,2730.036873,1947,2641,0.539860997547016
"13055",236948,"University of Washington-Seattle Campus",0,1,2006,5284,2800,2484,2939,1245,1694,0.605,0.556,0.501,5460,2889.526814,1978,2845,0.538417865253596
"13056",236948,"University of Washington-Seattle Campus",0,1,2007,5163,2771,2392,2968,1213,1755,0.633,0.575,0.507,5842,3045.886326,1852,2697,0.522370714700755
"13057",236948,"University of Washington-Seattle Campus",0,1,2008,5377,2896,2481,3296,1351,1945,0.672,0.613,0.545,6250,3242.807934,1881,2762,0.513669332341454
"13058",236948,"University of Washington-Seattle Campus",0,1,2009,5119,2795,2324,3227,1338,1889,0.676,0.63,0.576,7125,3473.693012,1839,2400,0.468841570619262
"13059",236948,"University of Washington-Seattle Campus",0,1,2010,5460,2917,2543,3525,1504,2021,0.693,0.646,0.591,8122,3535.634308,1880,2506,0.458974358974359
"13060",237011,"WESTERN WASHINGTON UNIVERSITY",0,1,1991,1547,921,626,288,86,202,0.219,0.186,0.137,1698,94.586815,410,1332,0.861021331609567
"13061",237011,"WESTERN WASHINGTON UNIVERSITY",0,1,1992,1455,883,572,341,98,243,0.275,0.234,0.171,1785,103.772155,408,1208,0.830240549828179
"13062",237011,"WESTERN WASHINGTON UNIVERSITY",0,1,1993,1542,941,601,365,91,274,0.291,0.237,0.151,2120,110.6988,385,1231,0.798313878080415
"13063",237011,"WESTERN WASHINGTON UNIVERSITY",0,1,1995,1745,1105,640,457,120,337,0.305,0.262,0.188,2523,114.125219,397,1379,0.79025787965616
"13064",237011,"WESTERN WASHINGTON UNIVERSITY",0,1,1996,2026,1177,849,507,176,331,0.281,0.25,0.207,2613,119.198546,414,1596,0.787759131293189
"13065",237011,"WESTERN WASHINGTON UNIVERSITY",0,1,1997,2068,1266,802,601,176,425,0.336,0.291,0.219,2526,127.45432,433,1606,0.776595744680851
"13066",237011,"WESTERN WASHINGTON UNIVERSITY",0,1,1998,2104,1221,883,623,202,421,0.345,0.296,0.229,2622,136.013835,433,1629,0.774239543726236
"13067",237011,"WESTERN WASHINGTON UNIVERSITY",0,1,1999,2074,1264,810,623,172,451,0.357,0.3,0.212,2737,140.621417,443,1749,0.843297974927676
"13068",237011,"WESTERN WASHINGTON UNIVERSITY",0,1,2000,2351,1427,924,692,212,480,0.336,0.294,0.229,2832,149.58334,445.5,2013,0.85623139089749
"13069",237011,"WESTERN WASHINGTON UNIVERSITY",0,1,2001,2205,1284,921,641,207,434,0.338,0.291,0.225,3015,161.185271,448,1755,0.795918367346939
"13070",237011,"WESTERN WASHINGTON UNIVERSITY",0,1,2002,2213,1290,923,761,225,536,0.416,0.344,0.244,3408,165.92035,455,1768,0.798915499322187
"13071",237011,"WESTERN WASHINGTON UNIVERSITY",0,1,2003,2194,1266,928,778,233,545,0.43,0.355,0.251,3639,183.107443,453,1789,0.815405651777575
"13072",237011,"WESTERN WASHINGTON UNIVERSITY",0,1,2004,2425,1405,1020,876,287,589,0.419,0.361,0.281,3885,179.356499,457,1922,0.792577319587629
"13073",237011,"Western Washington University",0,1,2005,2365,1364,1001,943,302,641,0.47,0.399,0.302,4113,191.826674,489,1856,0.784778012684989
"13074",237011,"Western Washington University",0,1,2006,2425,1397,1028,850,293,557,0.399,0.351,0.285,4356,202.259478,485,1902,0.784329896907216
"13075",237011,"Western Washington University",0,1,2007,2572,1484,1088,970,324,646,0.435,0.377,0.298,4568,218.845743,520,1949,0.757776049766719
"13076",237011,"Western Washington University",0,1,2008,2667,1560,1107,1057,328,729,0.467,0.396,0.296,4788,230.071905,522,2018,0.756655418072741
"13077",237011,"Western Washington University",0,1,2009,2670,1521,1149,1062,369,693,0.456,0.398,0.321,5397,236.052915,513,2015,0.754681647940075
"13078",237011,"Western Washington University",0,1,2010,2722,1614,1108,1077,345,732,0.454,0.396,0.311,6081,241.845757,504,2061,0.757163850110213
"13079",237057,"WHITMAN COLLEGE",1,0,1991,319,167,152,201,82,119,0.713,0.63,0.539,13110,26.922522,104,269,0.843260188087774
"13080",237057,"WHITMAN COLLEGE",1,0,1992,336,167,169,218,104,114,0.683,0.649,0.615,14360,26.674126,99,285,0.848214285714286
"13081",237057,"WHITMAN COLLEGE",1,0,1993,341,196,145,249,102,147,0.75,0.73,0.703,15650,30.552234,93,289,0.847507331378299
"13082",237057,"WHITMAN COLLEGE",1,0,1995,369,189,180,247,119,128,0.677,0.669,0.661,17630,39.253001,100,306,0.829268292682927
"13083",237057,"WHITMAN COLLEGE",1,0,1996,355,207,148,274,111,163,0.787,0.772,0.75,18650,39.534507,98,295,0.830985915492958
"13084",237057,"WHITMAN COLLEGE",1,0,1997,370,223,147,277,97,180,0.807,0.749,0.66,19580,30.893568,102,321,0.867567567567568
"13085",237057,"WHITMAN COLLEGE",1,0,1998,386,204,182,286,132,154,0.755,0.741,0.725,20120,32.74,105,337,0.873056994818653
"13086",237057,"WHITMAN COLLEGE",1,0,1999,361,209,152,294,120,174,0.833,0.814,0.789,20720,34.582213,107,313,0.867036011080332
"13087",237057,"WHITMAN COLLEGE",1,0,2000,349,220,129,278,99,179,0.814,0.797,0.767,21550,36.885614,111,291,0.833810888252149
"13088",237057,"WHITMAN COLLEGE",1,0,2001,362,195,167,288,126,162,0.831,0.796,0.754,22600,37.749122,115,273,0.75414364640884
"13089",237057,"WHITMAN COLLEGE",1,0,2002,379,230,149,322,126,196,0.852,0.85,0.846,24070,40.777197,129,274,0.722955145118733
"13090",237057,"WHITMAN COLLEGE",1,0,2003,362,182,180,294,144,150,0.824,0.812,0.8,25400,44.48848,136,236,0.651933701657459
"13091",237057,"WHITMAN COLLEGE",1,0,2004,385,222,163,308,124,184,0.829,0.8,0.761,26870,47.660832,124,259,0.672727272727273
"13092",237057,"Whitman College",1,0,2005,360,180,180,288,140,148,0.822,0.8,0.778,28400,49.443935,140,231,0.641666666666667
"13093",237057,"Whitman College",1,0,2006,367,219,148,294,109,185,0.845,0.801,0.736,30530,51.859736,150,241,0.656675749318801
"13094",237057,"Whitman College",1,0,2007,400,239,161,319,124,195,0.816,0.797,0.77,32670,54.877949,144,269,0.6725
"13095",237057,"Whitman College",1,0,2008,401,230,171,328,130,198,0.861,0.818,0.76,34880,57.566463,152,276,0.688279301745636
"13096",237057,"Whitman College",1,0,2009,395,238,157,314,117,197,0.828,0.795,0.745,36620,63.760573,140,275,0.69620253164557
"13097",237057,"Whitman College",1,0,2010,415,237,178,345,141,204,0.861,0.831,0.792,38450,61.512574,149,283,0.681927710843373
"13098",237066,"WHITWORTH COLLEGE",1,0,1991,240,141,99,94,29,65,0.461,0.392,0.293,10300,19.374004,70,203,0.845833333333333
"13099",237066,"WHITWORTH COLLEGE",1,0,1992,266,151,115,113,44,69,0.457,0.425,0.383,11029,19.26323,80,218,0.819548872180451
"13100",237066,"WHITWORTH COLLEGE",1,0,1993,361,206,155,160,59,101,0.49,0.443,0.381,11965,19.469342,93,305,0.844875346260388
"13101",237066,"WHITWORTH COLLEGE",1,0,1995,395,229,166,198,73,125,0.546,0.501,0.44,13410,28.461748,87,331,0.837974683544304
"13102",237066,"WHITWORTH COLLEGE",1,0,1996,315,193,122,177,56,121,0.627,0.562,0.459,14100,31.334322,89,252,0.8
"13103",237066,"WHITWORTH COLLEGE",1,0,1997,398,212,186,226,103,123,0.58,0.568,0.554,14750,25.362895,84,345,0.866834170854271
"13104",237066,"WHITWORTH COLLEGE",1,0,1998,373,224,149,197,74,123,0.549,0.528,0.497,15370,26.699443,82,313,0.839142091152815
"13105",237066,"WHITWORTH COLLEGE",1,0,1999,406,266,140,233,74,159,0.598,0.574,0.529,15970,29.111326,83,358,0.881773399014778
"13106",237066,"WHITWORTH COLLEGE",1,0,2000,402,234,168,242,86,156,0.667,0.602,0.512,16700,30.29877,93.5,354,0.880597014925373
"13107",237066,"WHITWORTH COLLEGE",1,0,2001,427,265,162,251,88,163,0.615,0.588,0.543,17800,32.288119,104,396,0.927400468384075
"13108",237066,"WHITWORTH COLLEGE",1,0,2002,433,232,201,261,107,154,0.664,0.603,0.532,18550,35.107079,112,373,0.861431870669746
"13109",237066,"WHITWORTH COLLEGE",1,0,2003,438,259,179,267,105,162,0.625,0.61,0.587,19810,37.162717,119,364,0.831050228310502
"13110",237066,"WHITWORTH COLLEGE",1,0,2004,469,266,203,308,127,181,0.68,0.657,0.626,20980,40.406247,119,406,0.865671641791045
"13111",237066,"Whitworth College",1,0,2005,451,266,185,304,125,179,0.673,0.674,0.676,22400,42.455785,120,383,0.849223946784922
"13112",237066,"Whitworth College",1,0,2006,469,285,184,303,115,188,0.66,0.646,0.625,23850,45.473043,124,408,0.869936034115139
"13113",237066,"Whitworth University",1,0,2007,532,293,239,347,141,206,0.703,0.652,0.59,25382,49.373889,127,456,0.857142857142857
"13114",237066,"Whitworth University",1,0,2008,545,289,256,354,149,205,0.709,0.65,0.582,27100,53.622786,133,458,0.840366972477064
"13115",237066,"Whitworth University",1,0,2009,555,324,231,354,145,209,0.645,0.638,0.628,28320,58.433329,140,457,0.823423423423423
"13116",237066,"Whitworth University",1,0,2010,683,403,280,430,161,269,0.667,0.63,0.575,29890,60.328517,162,542,0.793557833089312
"13117",237215,"BLUEFIELD STATE COLLEGE",1,0,1991,305,163,142,9,2,7,0.043,0.03,0.014,1454,11.173834,92,280,0.918032786885246
"13118",237215,"BLUEFIELD STATE COLLEGE",1,0,1992,371,192,179,9,4,5,0.026,0.024,0.022,1729,12.481434,93,336,0.905660377358491
"13119",237215,"BLUEFIELD STATE COLLEGE",1,0,1993,358,215,143,10,5,5,0.023,0.028,0.035,1832,13.775622,91,312,0.871508379888268
"13120",237215,"BLUEFIELD STATE COLLEGE",1,0,1995,416,243,173,8,5,3,0.012,0.019,0.029,1916,12.901186,84,387,0.930288461538462
"13121",237215,"BLUEFIELD STATE COLLEGE",1,0,1996,384,207,177,4,1,3,0.014,0.01,0.006,2000,15.414374,77,368,0.958333333333333
"13122",237215,"BLUEFIELD STATE COLLEGE",1,0,1997,423,237,186,6,0,6,0.025,0.014,0,2044,17.365204,77,391,0.92434988179669
"13123",237215,"BLUEFIELD STATE COLLEGE",1,0,1998,426,215,211,7,4,3,0.014,0.016,0.019,2110,17.845742,79,382,0.896713615023474
"13124",237215,"BLUEFIELD STATE COLLEGE",1,0,1999,370,225,145,8,3,5,0.022,0.022,0.021,1140,19.432717,80,342,0.924324324324324
"13125",237215,"BLUEFIELD STATE COLLEGE",1,0,2000,443,254,189,30,14,16,0.063,0.068,0.074,2288,20.697971,80,401,0.905191873589165
"13126",237215,"BLUEFIELD STATE COLLEGE",1,0,2001,380,233,147,3,1,2,0.009,0.008,0.007,2288,22.497613,80,343,0.902631578947368
"13127",237215,"BLUEFIELD STATE COLLEGE",1,0,2002,499,265,234,2,2,0,0,0.004,0.009,2598,20.819754,85,454,0.909819639278557
"13128",237215,"BLUEFIELD STATE COLLEGE",1,0,2003,273,155,118,15,7,8,0.052,0.055,0.059,2806,22.515053,94,251,0.919413919413919
"13129",237215,"BLUEFIELD STATE COLLEGE",1,0,2004,244,138,106,14,8,6,0.044,0.057,0.075,3114,26.446376,99,211,0.864754098360656
"13130",237215,"Bluefield State College",1,0,2005,246,133,113,5,3,2,0.015,0.02,0.027,3410,20.584707,75,219,0.890243902439024
"13131",237215,"Bluefield State College",1,0,2006,253,134,119,28,19,9,0.067,0.111,0.16,3648,20.929861,75,211,0.83399209486166
"13132",237215,"Bluefield State College",1,0,2007,296,167,129,18,11,7,0.042,0.061,0.085,3984,20.511929,77,252,0.851351351351351
"13133",237215,"Bluefield State College",1,0,2008,270,156,114,33,15,18,0.115,0.122,0.132,4272,22.843787,74,235,0.87037037037037
"13134",237215,"Bluefield State College",1,0,2009,304,177,127,28,18,10,0.056,0.092,0.142,4596,23.905256,78,253,0.832236842105263
"13135",237215,"Bluefield State College",1,0,2010,289,181,108,22,13,9,0.05,0.076,0.12,4596,23.847588,76,254,0.878892733564014
"13136",237330,"CONCORD COLLEGE",1,0,1991,401,229,172,87,32,55,0.24,0.217,0.186,1602,16.165881,88,376,0.937655860349127
"13137",237330,"CONCORD COLLEGE",1,0,1992,393,233,160,50,9,41,0.176,0.127,0.056,1736,18.006734,91,364,0.926208651399491
"13138",237330,"CONCORD COLLEGE",1,0,1993,487,284,203,71,25,46,0.162,0.146,0.123,1936,19.520792,94,452,0.928131416837782
"13139",237330,"CONCORD COLLEGE",1,0,1995,542,282,260,148,62,86,0.305,0.273,0.238,2150,19.904995,94,494,0.911439114391144
"13140",237330,"CONCORD COLLEGE",1,0,1996,582,301,281,107,34,73,0.242,0.184,0.121,2218,19.921167,93,519,0.891752577319588
"13141",237330,"CONCORD COLLEGE",1,0,1997,726,390,336,121,49,72,0.185,0.167,0.146,2310,21.111225,100,662,0.911845730027548
"13142",237330,"CONCORD COLLEGE",1,0,1998,545,293,252,74,30,44,0.15,0.136,0.119,2388,25.406386,96,500,0.917431192660551
"13143",237330,"CONCORD COLLEGE",1,0,1999,612,317,295,92,37,55,0.174,0.15,0.125,250,26.751214,91,560,0.915032679738562
"13144",237330,"CONCORD COLLEGE",1,0,2000,694,381,313,87,26,61,0.16,0.125,0.083,250,29.011149,95.5,642,0.92507204610951
"13145",237330,"CONCORD COLLEGE",1,0,2001,646,343,303,199,74,125,0.364,0.308,0.244,250,31.647482,100,594,0.919504643962848
"13146",237330,"CONCORD COLLEGE",1,0,2002,587,273,314,74,34,40,0.147,0.126,0.108,250,29.893021,97,534,0.909710391822828
"13147",237330,"CONCORD COLLEGE",1,0,2003,508,286,222,98,29,69,0.241,0.193,0.131,250,30.229594,95,463,0.911417322834646
"13148",237330,"CONCORD UNIVERSITY",1,0,2004,488,262,226,75,30,45,0.172,0.154,0.133,250,29.942234,98,443,0.907786885245902
"13149",237330,"Concord University",1,0,2005,639,352,287,104,35,69,0.196,0.163,0.122,250,30.019441,94,582,0.910798122065728
"13150",237330,"Concord University",1,0,2006,593,306,287,102,37,65,0.212,0.172,0.129,250,31.956107,95,517,0.871838111298482
"13151",237330,"Concord University",1,0,2007,618,335,283,115,49,66,0.197,0.186,0.173,250,31.808869,101,554,0.896440129449838
"13152",237330,"Concord University",1,0,2008,706,380,326,128,38,90,0.237,0.181,0.117,250,33.854319,106,631,0.893767705382436
"13153",237330,"Concord University",1,0,2009,607,348,259,121,44,77,0.221,0.199,0.17,4974,37.362473,108,540,0.889621087314662
"13154",237330,"Concord University",1,0,2010,568,288,280,105,37,68,0.236,0.185,0.132,4974,40.281971,108,490,0.862676056338028
"13155",237358,"DAVIS AND ELKINS COLLEGE",1,0,1991,141,80,61,13,4,9,0.112,0.092,0.066,7600,11.975954,55,123,0.872340425531915
"13156",237358,"DAVIS AND ELKINS COLLEGE",1,0,1992,201,108,93,49,22,27,0.25,0.244,0.237,8050,12.208644,55,186,0.925373134328358
"13157",237358,"DAVIS AND ELKINS COLLEGE",1,0,1993,167,100,67,24,10,14,0.14,0.144,0.149,8980,13.341596,55,160,0.958083832335329
"13158",237358,"DAVIS AND ELKINS COLLEGE",1,0,1995,180,101,79,35,13,22,0.218,0.194,0.165,10330,13.700528,50,171,0.95
"13159",237358,"DAVIS AND ELKINS COLLEGE",1,0,1996,120,66,54,27,16,11,0.167,0.225,0.296,10580,13.908942,58,107,0.891666666666667
"13160",237358,"DAVIS AND ELKINS COLLEGE",1,0,1997,95,54,41,6,3,3,0.056,0.063,0.073,11000,17.569,56,88,0.926315789473684
"13161",237358,"DAVIS AND ELKINS COLLEGE",1,0,1998,152,87,65,66,29,37,0.425,0.434,0.446,11500,18.818744,54,139,0.914473684210526
"13162",237358,"DAVIS AND ELKINS COLLEGE",1,0,1999,129,72,57,34,15,19,0.264,0.264,0.263,12080,17.42111,47,115,0.891472868217054
"13163",237358,"DAVIS AND ELKINS COLLEGE",1,0,2000,133,76,57,39,18,21,0.276,0.293,0.316,12624,18.149526,46,116,0.87218045112782
"13164",237358,"DAVIS AND ELKINS COLLEGE",1,0,2001,123,71,52,31,13,18,0.254,0.252,0.25,13224,18.013408,45,105,0.853658536585366
"13165",237358,"DAVIS AND ELKINS COLLEGE",1,0,2002,122,68,54,29,18,11,0.162,0.238,0.333,13700,17.498293,46,103,0.844262295081967
"13166",237358,"DAVIS AND ELKINS COLLEGE",1,0,2003,104,60,44,27,8,19,0.317,0.26,0.182,14248,17.269559,45,84,0.807692307692308
"13167",237358,"DAVIS AND ELKINS COLLEGE",1,0,2004,142,77,65,57,26,31,0.403,0.401,0.4,15246,17.696599,45,118,0.830985915492958
"13168",237358,"Davis & Elkins College",1,0,2005,109,67,42,25,5,20,0.299,0.229,0.119,16312,14.708757,44,93,0.853211009174312
"13169",237358,"Davis & Elkins College",1,0,2006,119,65,54,30,14,16,0.246,0.252,0.259,17210,15.190132,45,89,0.747899159663866
"13170",237358,"Davis & Elkins College",1,0,2007,120,70,50,21,9,12,0.171,0.175,0.18,18226,15.296827,44,87,0.725
"13171",237358,"Davis & Elkins College",1,0,2008,129,68,61,35,19,16,0.235,0.271,0.311,19320,14.228288,37,90,0.697674418604651
"13172",237358,"Davis & Elkins College",1,0,2009,234,139,95,60,23,37,0.266,0.256,0.242,19170,14.316347,39,163,0.696581196581197
"13173",237358,"Davis & Elkins College",1,0,2010,253,149,104,64,29,35,0.235,0.253,0.279,20800,15.834471,45,161,0.636363636363636
"13174",237367,"FAIRMONT STATE COLLEGE",1,0,1991,1034,567,467,83,35,48,0.085,0.08,0.075,1424,27.151361,170,898,0.868471953578337
"13175",237367,"FAIRMONT STATE COLLEGE",1,0,1992,1107,578,529,66,18,48,0.083,0.06,0.034,1686,30.415988,175,926,0.836495031616983
"13176",237367,"FAIRMONT STATE COLLEGE",1,0,1993,1053,553,500,93,29,64,0.116,0.088,0.058,1800,33.467976,182,1000,0.949667616334283
"13177",237367,"FAIRMONT STATE COLLEGE",1,0,1995,1123,618,505,96,36,60,0.097,0.085,0.071,1858,36.30639,190,999,0.889581478183437
"13178",237367,"FAIRMONT STATE COLLEGE",1,0,1996,1049,570,479,119,43,76,0.133,0.113,0.09,1918,37.735084,191,994,0.947569113441373
"13179",237367,"FAIRMONT STATE COLLEGE",1,0,1997,540,300,240,115,45,70,0.233,0.213,0.188,2040,38.761916,194,514,0.951851851851852
"13180",237367,"FAIRMONT STATE COLLEGE",1,0,1998,555,311,244,93,27,66,0.212,0.168,0.111,2106,41.679079,194,522,0.940540540540541
"13181",237367,"FAIRMONT STATE COLLEGE",1,0,1999,534,286,248,77,28,49,0.171,0.144,0.113,2284,44.736395,196,472,0.883895131086142
"13182",237367,"FAIRMONT STATE COLLEGE",1,0,2000,589,333,256,87,25,62,0.186,0.148,0.098,2316,48.31937,198,534,0.906621392190153
"13183",237367,"FAIRMONT STATE COLLEGE",1,0,2001,568,320,248,62,18,44,0.138,0.109,0.073,2408,54.033018,200,514,0.904929577464789
"13184",237367,"FAIRMONT STATE COLLEGE",1,0,2002,682,377,305,80,30,50,0.133,0.117,0.098,1200,62.367052,204,625,0.916422287390029
"13185",237367,"FAIRMONT STATE COLLEGE",1,0,2003,631,317,314,85,31,54,0.17,0.135,0.099,3130,54.887834,157,563,0.892234548335975
"13186",237367,"FAIRMONT STATE UNIVERSITY",1,0,2004,602,321,281,90,27,63,0.196,0.15,0.096,3640,59.010117,159,557,0.925249169435216
"13187",237367,"Fairmont State University",1,0,2005,653,367,286,97,35,62,0.169,0.149,0.122,4218,45.022637,163,606,0.92802450229709
"13188",237367,"Fairmont State University",1,0,2006,642,345,297,84,35,49,0.142,0.131,0.118,4522,70.566692,232,602,0.937694704049844
"13189",237367,"Fairmont State University",1,0,2007,632,331,301,87,37,50,0.151,0.138,0.123,4814,74.337775,236,581,0.919303797468354
"13190",237367,"Fairmont State University",1,0,2008,755,370,385,116,52,64,0.173,0.154,0.135,5024,76.834815,233,657,0.870198675496689
"13191",237367,"Fairmont State University",1,0,2009,795,412,383,118,58,60,0.146,0.148,0.151,5172,79.632768,171,712,0.89559748427673
"13192",237367,"Fairmont State University",1,0,2010,766,393,373,103,49,54,0.137,0.134,0.131,5172,68.929386,162,675,0.881201044386423
"13193",237792,"SHEPHERD COLLEGE",1,0,1991,395,208,187,46,16,30,0.144,0.116,0.086,1894,18.15,111,373,0.944303797468354
"13194",237792,"SHEPHERD COLLEGE",1,0,1992,490,270,220,3,0,3,0.011,0.006,0,1954,19.471,114,464,0.946938775510204
"13195",237792,"SHEPHERD COLLEGE",1,0,1993,557,310,247,59,17,42,0.136,0.106,0.069,2040,20.615,117,521,0.935368043087971
"13196",237792,"SHEPHERD COLLEGE",1,0,1995,598,333,265,74,20,54,0.162,0.124,0.075,2064,24.470884,120,563,0.941471571906355
"13197",237792,"SHEPHERD COLLEGE",1,0,1996,617,363,254,97,24,73,0.201,0.157,0.094,2160,25.681235,119,571,0.925445705024311
"13198",237792,"SHEPHERD COLLEGE",1,0,1997,643,341,302,111,43,68,0.199,0.173,0.142,2228,27.152218,124,581,0.903576982892691
"13199",237792,"SHEPHERD COLLEGE",1,0,1998,610,356,254,93,23,70,0.197,0.152,0.091,2298,27.989322,115,559,0.916393442622951
"13200",237792,"SHEPHERD COLLEGE",1,0,1999,674,367,307,91,25,66,0.18,0.135,0.081,250,29.755413,112,626,0.928783382789317
"13201",237792,"SHEPHERD COLLEGE",1,0,2000,669,378,291,101,32,69,0.182,0.151,0.11,250,32.693867,115,612,0.914798206278027
"13202",237792,"SHEPHERD COLLEGE",1,0,2001,647,333,314,71,27,44,0.132,0.11,0.086,250,35.044782,118,584,0.902627511591963
"13203",237792,"SHEPHERD COLLEGE",1,0,2002,705,378,327,92,24,68,0.18,0.13,0.073,250,40.287569,120,632,0.89645390070922
"13204",237792,"SHEPHERD COLLEGE",1,0,2003,768,440,328,134,48,86,0.196,0.174,0.146,250,40.24741,124,695,0.904947916666667
"13205",237792,"SHEPHERD UNIVERSITY",1,0,2004,774,427,347,119,44,75,0.176,0.154,0.127,250,39.624025,126,709,0.916020671834625
"13206",237792,"Shepherd University",1,0,2005,657,352,305,134,52,82,0.233,0.204,0.17,350,37.056034,112,593,0.902587519025875
"13207",237792,"Shepherd University",1,0,2006,688,395,293,135,40,95,0.241,0.196,0.137,350,43.343784,116,618,0.898255813953488
"13208",237792,"Shepherd University",1,0,2007,691,366,325,124,48,76,0.208,0.179,0.148,350,44.719819,116,599,0.866859623733719
"13209",237792,"Shepherd University",1,0,2008,698,395,303,137,42,95,0.241,0.196,0.139,350,50.045143,119,562,0.805157593123209
"13210",237792,"Shepherd University",1,0,2009,786,437,349,169,63,106,0.243,0.215,0.181,350,53.368982,124,486,0.618320610687023
"13211",237792,"Shepherd University",1,0,2010,759,436,323,191,59,132,0.303,0.252,0.183,350,56.800573,125,649,0.855072463768116
"13212",237899,"WEST VIRGINIA STATE COLLEGE",1,0,1991,475,227,248,15,7,8,0.035,0.032,0.028,1578,21.235,138,375,0.789473684210526
"13213",237899,"WEST VIRGINIA STATE COLLEGE",1,0,1992,400,188,212,17,7,10,0.053,0.043,0.033,1712,22.143,140,299,0.7475
"13214",237899,"WEST VIRGINIA STATE COLLEGE",1,0,1993,634,308,326,21,8,13,0.042,0.033,0.025,1894,24.767,138,511,0.805993690851735
"13215",237899,"WEST VIRGINIA STATE COLLEGE",1,0,1995,572,292,280,28,13,15,0.051,0.049,0.046,2050,24.160418,140,474,0.828671328671329
"13216",237899,"WEST VIRGINIA STATE COLLEGE",1,0,1996,529,254,275,28,10,18,0.071,0.053,0.036,2116,27.568547,137,418,0.790170132325142
"13217",237899,"WEST VIRGINIA STATE COLLEGE",1,0,1997,581,288,293,33,13,20,0.069,0.057,0.044,2184,30.727902,131,442,0.760757314974182
"13218",237899,"WEST VIRGINIA STATE COLLEGE",1,0,1998,551,282,269,31,13,18,0.064,0.056,0.048,2254,31.070765,133,436,0.791288566243194
"13219",237899,"WEST VIRGINIA STATE COLLEGE",1,0,1999,555,260,295,31,13,18,0.069,0.056,0.044,2386,33.500148,140,437,0.787387387387387
"13220",237899,"WEST VIRGINIA STATE COLLEGE",1,0,2000,542,277,265,19,6,13,0.047,0.035,0.023,2464,37.597113,135.5,397,0.732472324723247
"13221",237899,"WEST VIRGINIA STATE COLLEGE",1,0,2001,379,193,186,16,5,11,0.057,0.042,0.027,2562,52.173122,131,276,0.728232189973615
"13222",237899,"WEST VIRGINIA STATE COLLEGE",1,0,2002,351,178,173,28,8,20,0.112,0.08,0.046,2610,54.063574,150,271,0.772079772079772
"13223",237899,"WEST VIRGINIA STATE COLLEGE",1,0,2003,333,187,146,20,6,14,0.075,0.06,0.041,2609,44.571814,161,252,0.756756756756757
"13224",237899,"WEST VIRGINIA STATE UNIVERSITY",1,0,2004,331,175,156,18,8,10,0.057,0.054,0.051,3222,48.634625,116,249,0.75226586102719
"13225",237899,"West Virginia State University",1,0,2005,306,152,154,21,11,10,0.066,0.069,0.071,3528,47.874931,120,227,0.741830065359477
"13226",237899,"West Virginia State University",1,0,2006,341,170,171,24,8,16,0.094,0.07,0.047,3776,54.947521,124,231,0.67741935483871
"13227",237899,"West Virginia State University",1,0,2007,364,170,194,14,5,9,0.053,0.038,0.026,4136,57.160739,129,214,0.587912087912088
"13228",237899,"West Virginia State University",1,0,2008,302,147,155,16,5,11,0.075,0.053,0.032,4346,60.259229,125,176,0.582781456953642
"13229",237899,"West Virginia State University",1,0,2009,246,120,126,28,9,19,0.158,0.114,0.071,4524,49.984795,121,163,0.66260162601626
"13230",237899,"West Virginia State University",1,0,2010,270,128,142,26,9,17,0.133,0.096,0.063,4544,54.411458,120,198,0.733333333333333
"13231",237932,"WEST LIBERTY STATE COLLEGE",1,0,1991,437,227,210,75,25,50,0.22,0.172,0.119,1500,16.985406,131,415,0.949656750572082
"13232",237932,"WEST LIBERTY STATE COLLEGE",1,0,1992,488,263,225,104,29,75,0.285,0.213,0.129,1590,18.055533,130,462,0.94672131147541
"13233",237932,"WEST LIBERTY STATE COLLEGE",1,0,1993,474,238,236,85,32,53,0.223,0.179,0.136,1800,19.106762,130,459,0.968354430379747
"13234",237932,"WEST LIBERTY STATE COLLEGE",1,0,1995,509,273,236,108,27,81,0.297,0.212,0.114,1960,20.165464,126,486,0.954813359528487
"13235",237932,"WEST LIBERTY STATE COLLEGE",1,0,1996,464,250,214,77,20,57,0.228,0.166,0.093,2020,21.05765,125,438,0.943965517241379
"13236",237932,"WEST LIBERTY STATE COLLEGE",1,0,1997,491,257,234,77,21,56,0.218,0.157,0.09,2120,27.717049,120,469,0.955193482688391
"13237",237932,"WEST LIBERTY STATE COLLEGE",1,0,1998,498,268,230,96,35,61,0.228,0.193,0.152,2190,21.870984,115,478,0.959839357429719
"13238",237932,"WEST LIBERTY STATE COLLEGE",1,0,1999,494,245,249,96,31,65,0.265,0.194,0.124,2320,25.217483,108,474,0.959514170040486
"13239",237932,"WEST LIBERTY STATE COLLEGE",1,0,2000,513,275,238,91,29,62,0.226,0.177,0.122,2420,26.820745,110,486,0.947368421052632
"13240",237932,"WEST LIBERTY STATE COLLEGE",1,0,2001,521,298,223,99,40,59,0.198,0.19,0.179,2516,27.461913,112,502,0.963531669865643
"13241",237932,"WEST LIBERTY STATE COLLEGE",1,0,2002,445,253,192,107,23,84,0.332,0.24,0.12,2748,31.760669,111,424,0.952808988764045
"13242",237932,"WEST LIBERTY STATE COLLEGE",1,0,2003,453,248,205,69,16,53,0.214,0.152,0.078,3138,27.50829,114,423,0.933774834437086
"13243",237932,"WEST LIBERTY STATE COLLEGE",1,0,2004,459,238,221,92,35,57,0.24,0.2,0.158,3380,25.805645,100,432,0.941176470588235
"13244",237932,"West Liberty State College",1,0,2005,416,234,182,94,25,69,0.295,0.226,0.137,3686,25.680553,100,390,0.9375
"13245",237932,"West Liberty State College",1,0,2006,476,269,207,84,28,56,0.208,0.176,0.135,3946,25.405677,97,432,0.907563025210084
"13246",237932,"West Liberty State College",1,0,2007,499,264,235,110,27,83,0.314,0.22,0.115,4172,27.66237,99,460,0.92184368737475
"13247",237932,"West Liberty State College",1,0,2008,550,299,251,96,30,66,0.221,0.175,0.12,4464,29.735045,101,509,0.925454545454545
"13248",237932,"West Liberty University",1,0,2009,569,340,229,130,33,97,0.285,0.228,0.144,4880,31.692813,111,531,0.933216168717047
"13249",237932,"West Liberty University",1,0,2010,526,285,241,103,31,72,0.253,0.196,0.129,4880,36.376701,117,473,0.899239543726236
"13250",237969,"WEST VIRGINIA WESLEYAN COLLEGE",1,0,1991,363,195,168,155,44,111,0.569,0.427,0.262,11830,22.301191,78,321,0.884297520661157
"13251",237969,"WEST VIRGINIA WESLEYAN COLLEGE",1,0,1992,467,223,244,173,72,101,0.453,0.37,0.295,12605,25.034396,73,416,0.890792291220557
"13252",237969,"WEST VIRGINIA WESLEYAN COLLEGE",1,0,1993,475,235,240,172,64,108,0.46,0.362,0.267,13400,27.303213,74,424,0.892631578947368
"13253",237969,"WEST VIRGINIA WESLEYAN COLLEGE",1,0,1995,453,240,213,200,77,123,0.512,0.442,0.362,14750,31.472625,76,406,0.896247240618102
"13254",237969,"WEST VIRGINIA WESLEYAN COLLEGE",1,0,1996,377,204,173,161,57,104,0.51,0.427,0.329,14975,34.723815,75,330,0.875331564986737
"13255",237969,"WEST VIRGINIA WESLEYAN COLLEGE",1,0,1997,480,260,220,201,72,129,0.496,0.419,0.327,15275,24.43588,72,395,0.822916666666667
"13256",237969,"WEST VIRGINIA WESLEYAN COLLEGE",1,0,1998,472,247,225,204,74,130,0.526,0.432,0.329,15750,24.709431,80,423,0.896186440677966
"13257",237969,"WEST VIRGINIA WESLEYAN COLLEGE",1,0,1999,472,261,211,211,89,122,0.467,0.447,0.422,16300,26.384013,81,424,0.898305084745763
"13258",237969,"WEST VIRGINIA WESLEYAN COLLEGE",1,0,2000,415,232,183,169,56,113,0.487,0.407,0.306,16800,27.45086,82.5,376,0.906024096385542
"13259",237969,"WEST VIRGINIA WESLEYAN COLLEGE",1,0,2001,400,202,198,175,65,110,0.545,0.438,0.328,17300,30.683955,84,358,0.895
"13260",237969,"WEST VIRGINIA WESLEYAN COLLEGE",1,0,2002,500,283,217,224,83,141,0.498,0.448,0.382,17900,26.327498,88,450,0.9
"13261",237969,"WEST VIRGINIA WESLEYAN COLLEGE",1,0,2003,457,257,200,197,64,133,0.517,0.431,0.32,18450,26.184337,88,355,0.776805251641138
"13262",237969,"WEST VIRGINIA WESLEYAN COLLEGE",1,0,2004,348,181,167,148,59,89,0.492,0.425,0.353,19450,26.213585,85,262,0.752873563218391
"13263",237969,"West Virginia Wesleyan College",1,0,2005,307,161,146,129,38,91,0.565,0.42,0.26,20250,25.884629,80,251,0.817589576547231
"13264",237969,"West Virginia Wesleyan College",1,0,2006,291,167,124,117,39,78,0.467,0.402,0.315,20250,24.87928,72,161,0.553264604810997
"13265",237969,"West Virginia Wesleyan College",1,0,2007,401,203,198,174,71,103,0.507,0.434,0.359,20980,24.268733,71,288,0.718204488778055
"13266",237969,"West Virginia Wesleyan College",1,0,2008,382,208,174,168,63,105,0.505,0.44,0.362,21030,24.622571,76,279,0.730366492146597
"13267",237969,"West Virginia Wesleyan College",1,0,2009,399,197,202,151,61,90,0.457,0.378,0.302,22030,25.734107,75,312,0.781954887218045
"13268",237969,"West Virginia Wesleyan College",1,0,2010,371,196,175,141,43,98,0.5,0.38,0.246,23130,25.561284,78,302,0.814016172506739
"13269",238032,"WEST VIRGINIA UNIVERSITY",1,0,1991,3307,1550,1757,796,325,471,0.304,0.241,0.185,1850,298.534072,903,3090,0.934381614756577
"13270",238032,"WEST VIRGINIA UNIVERSITY",1,0,1992,2978,1444,1534,766,296,470,0.325,0.257,0.193,1928,331.83943,908,2736,0.918737407656145
"13271",238032,"WEST VIRGINIA UNIVERSITY",1,0,1993,2806,1370,1436,658,252,406,0.296,0.234,0.175,2026,334.452473,895,2622,0.934426229508197
"13272",238032,"WEST VIRGINIA UNIVERSITY",1,0,1995,2938,1457,1481,783,324,459,0.315,0.267,0.219,2192,368.975243,863,2731,0.929543907420014
"13273",238032,"WEST VIRGINIA UNIVERSITY",1,0,1996,3065,1499,1566,817,335,482,0.322,0.267,0.214,2262,393.834122,846,2850,0.929853181076672
"13274",238032,"WEST VIRGINIA UNIVERSITY",1,0,1997,3079,1431,1648,794,344,450,0.314,0.258,0.209,2336,396.170761,806,2829,0.91880480675544
"13275",238032,"WEST VIRGINIA UNIVERSITY",1,0,1998,3335,1571,1764,818,348,470,0.299,0.245,0.197,2662,398.423812,804,3070,0.920539730134933
"13276",238032,"WEST VIRGINIA UNIVERSITY",1,0,1999,3523,1641,1882,885,363,522,0.318,0.251,0.193,1332,435.961603,797,3199,0.908032926483111
"13277",238032,"WEST VIRGINIA UNIVERSITY",1,0,2000,3480,1679,1801,889,346,543,0.323,0.255,0.192,1332,452.613913,803.5,3193,0.917528735632184
"13278",238032,"WEST VIRGINIA UNIVERSITY",1,0,2001,3593,1743,1850,928,381,547,0.314,0.258,0.206,1332,482.283742,810,3263,0.908154745338158
"13279",238032,"WEST VIRGINIA UNIVERSITY",1,0,2002,3917,1841,2076,1161,473,688,0.374,0.296,0.228,3240,503.478843,796,3573,0.912177687005361
"13280",238032,"WEST VIRGINIA UNIVERSITY",1,0,2003,4366,2104,2262,1387,583,804,0.382,0.318,0.258,3548,553.421803,778,4070,0.932203389830508
"13281",238032,"WEST VIRGINIA UNIVERSITY",1,0,2004,4308,2032,2276,1416,571,845,0.416,0.329,0.251,3938,549.711423,776,3961,0.919452181987001
"13282",238032,"West Virginia University",1,0,2005,4524,2126,2398,1457,639,818,0.385,0.322,0.266,4164,583.622175,785,4129,0.912687886825818
"13283",238032,"West Virginia University",1,0,2006,4777,2151,2626,1596,746,850,0.395,0.334,0.284,4476,652.897407,813,4354,0.911450701276952
"13284",238032,"West Virginia University",1,0,2007,4664,2156,2508,1561,696,865,0.401,0.335,0.278,4722,690.130519,802,4187,0.897727272727273
"13285",238032,"West Virginia University",1,0,2008,5083,2300,2783,1656,766,890,0.387,0.326,0.275,5100,776.835464,876,4548,0.894747196537478
"13286",238032,"West Virginia University",1,0,2009,4555,2098,2457,1501,661,840,0.4,0.33,0.269,5304,834.561921,968,4058,0.890889132821076
"13287",238032,"West Virginia University",1,0,2010,5006,2290,2716,1619,755,864,0.377,0.323,0.278,5406,899.855596,980,4312,0.861366360367559
"13288",238333,"BELOIT COLLEGE",1,0,1991,261,147,114,135,50,85,0.578,0.517,0.439,13050,23.097083,83,231,0.885057471264368
"13289",238333,"BELOIT COLLEGE",1,0,1992,306,159,147,171,68,103,0.648,0.559,0.463,14250,25.36893,83,259,0.84640522875817
"13290",238333,"BELOIT COLLEGE",1,0,1993,284,161,123,158,61,97,0.603,0.556,0.496,15430,27.018256,80,234,0.823943661971831
"13291",238333,"BELOIT COLLEGE",1,0,1995,291,163,128,187,74,113,0.693,0.643,0.578,17544,32.20218,83,242,0.831615120274914
"13292",238333,"BELOIT COLLEGE",1,0,1996,284,147,137,175,76,99,0.673,0.616,0.555,18230,33.125269,80,224,0.788732394366197
"13293",238333,"BELOIT COLLEGE",1,0,1997,339,194,145,204,73,131,0.675,0.602,0.503,19050,27.270983,88,275,0.811209439528024
"13294",238333,"BELOIT COLLEGE",1,0,1998,302,180,122,166,58,108,0.6,0.55,0.475,19770,27.956382,86,245,0.811258278145695
"13295",238333,"BELOIT COLLEGE",1,0,1999,303,173,130,196,75,121,0.699,0.647,0.577,20220,28.862057,97,244,0.805280528052805
"13296",238333,"BELOIT COLLEGE",1,0,2000,306,177,129,168,79,89,0.503,0.549,0.612,21330,30.699264,98,255,0.833333333333333
"13297",238333,"BELOIT COLLEGE",1,0,2001,311,189,122,234,86,148,0.783,0.752,0.705,22184,32.058377,99,262,0.842443729903537
"13298",238333,"BELOIT COLLEGE",1,0,2002,303,191,112,210,75,135,0.707,0.693,0.67,23016,33.22746,99,266,0.877887788778878
"13299",238333,"BELOIT COLLEGE",1,0,2003,346,217,129,251,88,163,0.751,0.725,0.682,24166,35.456095,103,307,0.88728323699422
"13300",238333,"BELOIT COLLEGE",1,0,2004,323,176,147,218,97,121,0.688,0.675,0.66,25516,34.952593,103,285,0.882352941176471
"13301",238333,"Beloit College",1,0,2005,326,198,128,216,71,145,0.732,0.663,0.555,26664,37.290074,103,277,0.849693251533742
"13302",238333,"Beloit College",1,0,2006,347,207,140,243,94,149,0.72,0.7,0.671,28130,39.696897,109,284,0.818443804034582
"13303",238333,"Beloit College",1,0,2007,325,183,142,229,99,130,0.71,0.705,0.697,29678,40.669205,127,248,0.763076923076923
"13304",238333,"Beloit College",1,0,2008,337,182,155,240,104,136,0.747,0.712,0.671,31310,45.267227,123,222,0.658753709198813
"13305",238333,"Beloit College",1,0,2009,332,199,133,233,90,143,0.719,0.702,0.677,33188,48.837771,123,242,0.728915662650602
"13306",238333,"Beloit College",1,0,2010,333,191,142,212,89,123,0.644,0.637,0.627,34808,46.238483,127,237,0.711711711711712
"13307",238430,"CARDINAL STRITCH COLLEGE",1,0,1991,125,89,36,24,7,17,0.191,0.192,0.194,6960,14.569108,51,98,0.784
"13308",238430,"CARDINAL STRITCH COLLEGE",1,0,1992,199,133,66,20,10,10,0.075,0.101,0.152,7360,15.188151,59,158,0.793969849246231
"13309",238430,"CARDINAL STRITCH COLLEGE",1,0,1993,481,327,154,39,12,27,0.083,0.081,0.078,7720,17.227336,69,375,0.77962577962578
"13310",238430,"CARDINAL STRITCH COLLEGE",1,0,1995,139,93,46,20,3,17,0.183,0.144,0.065,8320,19.09992,68,114,0.820143884892086
"13311",238430,"CARDINAL STRITCH COLLEGE",1,0,1996,253,174,79,40,16,24,0.138,0.158,0.203,8960,19.103957,80,197,0.778656126482213
"13312",238430,"CARDINAL STRITCH UNIVERSITY",1,0,1997,226,149,77,55,19,36,0.242,0.243,0.247,10080,21.187872,72,164,0.725663716814159
"13313",238430,"CARDINAL STRITCH UNIVERSITY",1,0,1998,224,140,84,71,28,43,0.307,0.317,0.333,10496,23.097883,62,159,0.709821428571429
"13314",238430,"CARDINAL STRITCH UNIVERSITY",1,0,1999,203,132,71,28,10,18,0.136,0.138,0.141,11000,21.963158,78,152,0.748768472906404
"13315",238430,"CARDINAL STRITCH UNIVERSITY",1,0,2000,207,122,85,129,53,76,0.623,0.623,0.624,11680,24.919124,88,155,0.748792270531401
"13316",238430,"CARDINAL STRITCH UNIVERSITY",1,0,2001,296,215,81,78,29,49,0.228,0.264,0.358,12480,29.280491,98,197,0.665540540540541
"13317",238430,"CARDINAL STRITCH UNIVERSITY",1,0,2002,197,155,42,55,12,43,0.277,0.279,0.286,13280,33.628961,88,137,0.695431472081218
"13318",238430,"CARDINAL STRITCH UNIVERSITY",1,0,2003,205,136,69,28,11,17,0.125,0.137,0.159,14240,37.943877,97,135,0.658536585365854
"13319",238430,"CARDINAL STRITCH UNIVERSITY",1,0,2004,157,120,37,63,8,55,0.458,0.401,0.216,15360,39.126221,97,103,0.656050955414013
"13320",238430,"Cardinal Stritch University",1,0,2005,182,139,43,19,4,15,0.108,0.104,0.093,16130,39.429372,93,120,0.659340659340659
"13321",238430,"Cardinal Stritch University",1,0,2006,245,168,77,19,6,13,0.077,0.078,0.078,17600,41.639605,98,125,0.510204081632653
"13322",238430,"Cardinal Stritch University",1,0,2007,173,115,58,25,6,19,0.165,0.145,0.103,18624,44.221465,98,87,0.502890173410405
"13323",238430,"Cardinal Stritch University",1,0,2008,258,177,81,39,14,25,0.141,0.151,0.173,20000,49.572392,95,162,0.627906976744186
"13324",238430,"Cardinal Stritch University",1,0,2009,209,119,90,19,4,15,0.126,0.091,0.044,21280,54.527935,103,101,0.483253588516746
"13325",238430,"Cardinal Stritch University",1,0,2010,213,128,85,37,14,23,0.18,0.174,0.165,22240,53.547256,105,124,0.582159624413146
"13326",238458,"CARROLL COLLEGE",1,0,1991,275,168,107,132,35,97,0.577,0.48,0.327,11068,25.107183,87,250,0.909090909090909
"13327",238458,"CARROLL COLLEGE",1,0,1992,298,193,105,93,27,66,0.342,0.312,0.257,11432,24.225084,86,258,0.865771812080537
"13328",238458,"CARROLL COLLEGE",1,0,1993,345,211,134,130,45,85,0.403,0.377,0.336,11790,24.031108,70,309,0.895652173913044
"13329",238458,"CARROLL COLLEGE",1,0,1995,429,296,133,202,41,161,0.544,0.471,0.308,12880,27.284324,74,378,0.881118881118881
"13330",238458,"CARROLL COLLEGE",1,0,1996,450,295,155,214,67,147,0.498,0.476,0.432,13190,29.110313,73,401,0.891111111111111
"13331",238458,"CARROLL COLLEGE",1,0,1997,459,287,172,232,65,167,0.582,0.505,0.378,13670,22.543141,74,404,0.880174291938998
"13332",238458,"CARROLL COLLEGE",1,0,1998,414,296,118,156,31,125,0.422,0.377,0.263,14200,24.388178,85,390,0.942028985507246
"13333",238458,"CARROLL COLLEGE",1,0,1999,482,327,155,219,63,156,0.477,0.454,0.406,14740,26.565057,98,446,0.925311203319502
"13334",238458,"CARROLL COLLEGE",1,0,2000,500,334,166,220,58,162,0.485,0.44,0.349,15250,30.434618,101,465,0.93
"13335",238458,"CARROLL COLLEGE",1,0,2001,471,319,152,197,48,149,0.467,0.418,0.316,15860,30.960098,104,424,0.900212314225053
"13336",238458,"CARROLL COLLEGE",1,0,2002,529,324,205,240,70,170,0.525,0.454,0.341,16400,31.158046,99,492,0.930056710775047
"13337",238458,"CARROLL COLLEGE",1,0,2003,501,329,172,220,62,158,0.48,0.439,0.36,17020,31.526529,96,468,0.934131736526946
"13338",238458,"CARROLL COLLEGE",1,0,2004,616,405,211,234,61,173,0.427,0.38,0.289,17800,32.523373,94,543,0.881493506493506
"13339",238458,"Carroll College",1,0,2005,598,383,215,231,63,168,0.439,0.386,0.293,18650,34.14364,99,530,0.88628762541806
"13340",238458,"Carroll College",1,0,2006,675,485,190,284,58,226,0.466,0.421,0.305,19500,36.871849,108,585,0.866666666666667
"13341",238458,"Carroll College",1,0,2007,652,440,212,277,88,189,0.43,0.425,0.415,20400,39.359474,117,561,0.860429447852761
"13342",238458,"Carroll University",1,0,2008,655,447,208,263,77,186,0.416,0.402,0.37,21410,42.418385,113,577,0.880916030534351
"13343",238458,"Carroll University",1,0,2009,738,482,256,311,102,209,0.434,0.421,0.398,22470,45.332645,115,644,0.872628726287263
"13344",238458,"Carroll University",1,0,2010,751,502,249,386,115,271,0.54,0.514,0.462,23582,50.504183,121,654,0.870838881491345
"13345",238476,"CARTHAGE COLLEGE",1,0,1991,401,227,174,183,65,118,0.52,0.456,0.374,10640,20.58779,75,358,0.892768079800499
"13346",238476,"CARTHAGE COLLEGE",1,0,1992,406,233,173,196,80,116,0.498,0.483,0.462,11525,22.481669,76,367,0.903940886699507
"13347",238476,"CARTHAGE COLLEGE",1,0,1993,441,227,214,216,99,117,0.515,0.49,0.463,12400,25.477544,81,399,0.904761904761905
"13348",238476,"CARTHAGE COLLEGE",1,0,1995,395,175,220,190,89,101,0.577,0.481,0.405,13850,31.37692,89,369,0.934177215189873
"13349",238476,"CARTHAGE COLLEGE",1,0,1996,401,210,191,215,87,128,0.61,0.536,0.455,14600,33.517686,93,383,0.955112219451372
"13350",238476,"CARTHAGE COLLEGE",1,0,1997,395,201,194,174,75,99,0.492,0.441,0.387,15365,24.596852,93,364,0.921518987341772
"13351",238476,"CARTHAGE COLLEGE",1,0,1998,432,216,216,190,86,104,0.482,0.44,0.398,16060,25.558173,93,405,0.9375
"13352",238476,"CARTHAGE COLLEGE",1,0,1999,427,216,211,190,78,112,0.519,0.445,0.37,16690,27.768046,91,389,0.911007025761124
"13353",238476,"CARTHAGE COLLEGE",1,0,2000,532,295,237,232,91,141,0.478,0.436,0.384,17350,31.081448,96.5,462,0.868421052631579
"13354",238476,"CARTHAGE COLLEGE",1,0,2001,578,280,298,237,112,125,0.446,0.41,0.376,18205,31.560557,102,478,0.826989619377163
"13355",238476,"CARTHAGE COLLEGE",1,0,2002,618,351,267,236,84,152,0.433,0.382,0.315,19150,36.405149,111,511,0.826860841423948
"13356",238476,"CARTHAGE COLLEGE",1,0,2003,575,307,268,249,103,146,0.476,0.433,0.384,20150,39.218545,108,469,0.815652173913043
"13357",238476,"CARTHAGE COLLEGE",1,0,2004,579,344,235,277,101,176,0.512,0.478,0.43,21250,40.674763,116,469,0.810017271157167
"13358",238476,"Carthage College",1,0,2005,593,315,278,281,120,161,0.511,0.474,0.432,22500,44.394129,122,507,0.854974704890388
"13359",238476,"Carthage College",1,0,2006,653,368,285,337,136,201,0.546,0.516,0.477,23650,44.555827,124,538,0.823889739663093
"13360",238476,"Carthage College",1,0,2007,683,350,333,371,145,226,0.646,0.543,0.435,25000,47.038801,135,575,0.841874084919473
"13361",238476,"Carthage College",1,0,2008,753,359,394,405,192,213,0.593,0.538,0.487,26500,51.38754,145,620,0.823373173970784
"13362",238476,"Carthage College",1,0,2009,721,351,370,359,158,201,0.573,0.498,0.427,28250,53.620349,145,597,0.828016643550624
"13363",238476,"Carthage College",1,0,2010,730,384,346,398,164,234,0.609,0.545,0.474,29750,58.587381,148,628,0.86027397260274
"13364",238616,"CONCORDIA UNIVERSITY-WISCONSIN",1,0,1991,205,104,101,64,27,37,0.356,0.312,0.267,7400,10.921535,62,171,0.834146341463415
"13365",238616,"CONCORDIA UNIVERSITY-WISCONSIN",1,0,1992,183,103,80,69,31,38,0.369,0.377,0.388,8100,13.151337,68,158,0.863387978142076
"13366",238616,"CONCORDIA UNIVERSITY-WISCONSIN",1,0,1993,289,139,150,81,37,44,0.316,0.28,0.247,8700,15.196757,74,246,0.85121107266436
"13367",238616,"CONCORDIA UNIVERSITY-WISCONSIN",1,0,1995,234,132,102,59,21,38,0.288,0.252,0.206,10000,20.770075,86,208,0.888888888888889
"13368",238616,"CONCORDIA UNIVERSITY-WISCONSIN",1,0,1996,254,138,116,117,44,73,0.529,0.461,0.379,10700,23.600003,96,213,0.838582677165354
"13369",238616,"CONCORDIA UNIVERSITY-WISCONSIN",1,0,1997,253,147,106,128,45,83,0.565,0.506,0.425,11300,20.962472,91,237,0.936758893280632
"13370",238616,"CONCORDIA UNIVERSITY-WISCONSIN",1,0,1998,337,187,150,126,46,80,0.428,0.374,0.307,11900,24.032708,89,249,0.738872403560831
"13371",238616,"CONCORDIA UNIVERSITY-WISCONSIN",1,0,1999,321,197,124,104,38,66,0.335,0.324,0.306,12400,26.770069,95,260,0.809968847352025
"13372",238616,"CONCORDIA UNIVERSITY-WISCONSIN",1,0,2000,285,169,116,106,43,63,0.373,0.372,0.371,12900,29.846117,93.5,239,0.83859649122807
"13373",238616,"CONCORDIA UNIVERSITY-WISCONSIN",1,0,2001,351,169,182,158,82,76,0.45,0.45,0.451,13550,30.287832,92,218,0.621082621082621
"13374",238616,"CONCORDIA UNIVERSITY-WISCONSIN",1,0,2002,287,139,148,96,42,54,0.388,0.334,0.284,14500,33.41554,93,217,0.75609756097561
"13375",238616,"CONCORDIA UNIVERSITY-WISCONSIN",1,0,2003,352,192,160,111,35,76,0.396,0.315,0.219,15590,35.94548,92,272,0.772727272727273
"13376",238616,"CONCORDIA UNIVERSITY-WISCONSIN",1,0,2004,363,198,165,145,57,88,0.444,0.399,0.345,16370,38.232124,89,309,0.851239669421488
"13377",238616,"Concordia University-Wisconsin",1,0,2005,386,207,179,134,52,82,0.396,0.347,0.291,17190,36.411362,93,315,0.816062176165803
"13378",238616,"Concordia University-Wisconsin",1,0,2006,391,214,177,135,53,82,0.383,0.345,0.299,18050,39.920942,89,320,0.818414322250639
"13379",238616,"Concordia University-Wisconsin",1,0,2007,422,232,190,143,46,97,0.418,0.339,0.242,18950,42.519072,95,363,0.860189573459716
"13380",238616,"Concordia University-Wisconsin",1,0,2008,402,222,180,139,59,80,0.36,0.346,0.328,19900,46.242073,99,330,0.82089552238806
"13381",238616,"Concordia University-Wisconsin",1,0,2009,468,266,202,171,63,108,0.406,0.365,0.312,20900,51.248978,110,401,0.856837606837607
"13382",238616,"Concordia University-Wisconsin",1,0,2010,537,317,220,198,71,127,0.401,0.369,0.323,21940,54.921995,128,436,0.811918063314711
"13383",238661,"EDGEWOOD COLLEGE",1,0,1991,126,96,30,17,1,16,0.167,0.135,0.033,6950,7.569014,50,105,0.833333333333333
"13384",238661,"EDGEWOOD COLLEGE",1,0,1992,131,90,41,25,7,18,0.2,0.191,0.171,7500,9.41473,53,98,0.748091603053435
"13385",238661,"EDGEWOOD COLLEGE",1,0,1993,161,121,40,42,7,35,0.289,0.261,0.175,8000,11.769807,59,127,0.788819875776398
"13386",238661,"EDGEWOOD COLLEGE",1,0,1995,231,155,76,44,10,34,0.219,0.19,0.132,9000,14.582577,70,178,0.770562770562771
"13387",238661,"EDGEWOOD COLLEGE",1,0,1996,210,152,58,40,4,36,0.237,0.19,0.069,9500,15.954773,74,141,0.671428571428571
"13388",238661,"EDGEWOOD COLLEGE",1,0,1997,222,164,58,53,11,42,0.256,0.239,0.19,10100,15.662562,73,151,0.68018018018018
"13389",238661,"EDGEWOOD COLLEGE",1,0,1998,213,157,56,55,13,42,0.268,0.258,0.232,10884,14.805698,76,134,0.629107981220657
"13390",238661,"EDGEWOOD COLLEGE",1,0,1999,196,132,64,49,9,40,0.303,0.25,0.141,11450,15.909089,75,108,0.551020408163265
"13391",238661,"EDGEWOOD COLLEGE",1,0,2000,274,203,71,81,13,68,0.335,0.296,0.183,12250,17.355351,78.5,128,0.467153284671533
"13392",238661,"EDGEWOOD COLLEGE",1,0,2001,291,203,88,70,21,49,0.241,0.241,0.239,13300,19.260852,82,145,0.498281786941581
"13393",238661,"EDGEWOOD COLLEGE",1,0,2002,271,205,66,70,10,60,0.293,0.258,0.152,14200,21.236539,86,237,0.874538745387454
"13394",238661,"EDGEWOOD COLLEGE",1,0,2003,307,229,78,85,14,71,0.31,0.277,0.179,15100,23.896081,92,260,0.846905537459283
"13395",238661,"EDGEWOOD COLLEGE",1,0,2004,298,214,84,95,20,75,0.35,0.319,0.238,16050,26.152609,97,270,0.906040268456376
"13396",238661,"Edgewood College",1,0,2005,281,210,71,77,21,56,0.267,0.274,0.296,17000,28.828473,97,256,0.911032028469751
"13397",238661,"Edgewood College",1,0,2006,293,220,73,101,21,80,0.364,0.345,0.288,18000,30.970762,100,258,0.880546075085324
"13398",238661,"Edgewood College",1,0,2007,302,202,100,98,28,70,0.346,0.325,0.28,19080,32.860727,102,261,0.864238410596026
"13399",238661,"Edgewood College",1,0,2008,298,219,79,108,29,79,0.361,0.362,0.367,20040,35.487294,99,259,0.869127516778524
"13400",238661,"Edgewood College",1,0,2009,285,213,72,110,27,83,0.39,0.386,0.375,21042,37.597083,104,228,0.8
"13401",238661,"Edgewood College",1,0,2010,324,243,81,130,36,94,0.387,0.401,0.444,21988,37.439849,106,284,0.876543209876543
"13402",239080,"MARIAN COLLEGE OF FOND DU LAC",1,0,1991,146,105,41,52,10,42,0.4,0.356,0.244,7500,10.111732,63,141,0.965753424657534
"13403",239080,"MARIAN COLLEGE OF FOND DU LAC",1,0,1992,190,125,65,52,14,38,0.304,0.274,0.215,8120,12.451086,67,177,0.931578947368421
"13404",239080,"MARIAN COLLEGE OF FOND DU LAC",1,0,1993,170,115,55,47,12,35,0.304,0.276,0.218,8650,14.681689,71,154,0.905882352941176
"13405",239080,"MARIAN COLLEGE OF FOND DU LAC",1,0,1995,184,117,67,44,15,29,0.248,0.239,0.224,10120,16.237759,70,170,0.923913043478261
"13406",239080,"MARIAN COLLEGE OF FOND DU LAC",1,0,1996,199,126,73,53,21,32,0.254,0.266,0.288,10730,17.345904,68,189,0.949748743718593
"13407",239080,"MARIAN COLLEGE OF FOND DU LAC",1,0,1997,208,119,89,62,16,46,0.387,0.298,0.18,11370,15.802965,60,184,0.884615384615385
"13408",239080,"MARIAN COLLEGE OF FOND DU LAC",1,0,1998,204,137,67,64,20,44,0.321,0.314,0.299,11785,15.72104,60,174,0.852941176470588
"13409",239080,"MARIAN COLLEGE OF FOND DU LAC",1,0,1999,224,156,68,71,17,54,0.346,0.317,0.25,11966,16.637607,66,195,0.870535714285714
"13410",239080,"MARIAN COLLEGE OF FOND DU LAC",1,0,2000,245,180,65,85,18,67,0.372,0.347,0.277,12624,22.07121,66,212,0.86530612244898
"13411",239080,"MARIAN COLLEGE OF FOND DU LAC",1,0,2001,227,149,78,65,18,47,0.315,0.286,0.231,13230,19.326842,66,196,0.863436123348018
"13412",239080,"MARIAN COLLEGE OF FOND DU LAC",1,0,2002,247,176,71,52,13,39,0.222,0.211,0.183,13880,20.779308,71,203,0.821862348178138
"13413",239080,"MARIAN COLLEGE OF FOND DU LAC",1,0,2003,251,170,81,72,17,55,0.324,0.287,0.21,14700,22.482395,71,221,0.880478087649402
"13414",239080,"MARIAN COLLEGE OF FOND DU LAC",1,0,2004,270,191,79,84,16,68,0.356,0.311,0.203,15500,23.613682,73,227,0.840740740740741
"13415",239080,"Marian College of Fond du Lac",1,0,2005,262,190,72,78,17,61,0.321,0.298,0.236,16380,24.827756,73,235,0.896946564885496
"13416",239080,"Marian College of Fond du Lac",1,0,2006,245,172,73,61,15,46,0.267,0.249,0.205,17300,27.217421,79,217,0.885714285714286
"13417",239080,"Marian College of Fond du Lac",1,0,2007,266,191,75,80,8,72,0.377,0.301,0.107,18330,29.41101,83,220,0.827067669172932
"13418",239080,"Marian University-Wisconsin",1,0,2008,284,210,74,103,15,88,0.419,0.363,0.203,19590,30.882963,83,232,0.816901408450704
"13419",239080,"Marian University",1,0,2009,316,228,88,88,19,69,0.303,0.278,0.216,20550,32.065066,84,221,0.699367088607595
"13420",239080,"Marian University",1,0,2010,309,219,90,92,12,80,0.365,0.298,0.133,21140,29.993294,84,236,0.763754045307443
"13421",239105,"MARQUETTE UNIVERSITY",1,0,1991,1598,852,746,870,349,521,0.612,0.544,0.468,9000,135.695138,492,1366,0.854818523153942
"13422",239105,"MARQUETTE UNIVERSITY",1,0,1992,1651,846,805,804,322,482,0.57,0.487,0.4,9900,146.871065,485,1370,0.829800121138704
"13423",239105,"MARQUETTE UNIVERSITY",1,0,1993,1684,895,789,880,339,541,0.605,0.523,0.43,10700,152.896725,483,1433,0.850950118764846
"13424",239105,"MARQUETTE UNIVERSITY",1,0,1995,1627,883,744,870,327,543,0.615,0.535,0.44,13010,179.998,492,1380,0.848186846957591
"13425",239105,"MARQUETTE UNIVERSITY",1,0,1996,1420,799,621,803,303,500,0.626,0.565,0.488,14710,198.151,478,1191,0.838732394366197
"13426",239105,"MARQUETTE UNIVERSITY",1,0,1997,1573,830,743,876,351,525,0.633,0.557,0.472,15160,154.495,481,1321,0.839796567069294
"13427",239105,"MARQUETTE UNIVERSITY",1,0,1998,1730,952,778,960,355,605,0.635,0.555,0.456,15620,164.696,473,1488,0.860115606936416
"13428",239105,"MARQUETTE UNIVERSITY",1,0,1999,1715,963,752,1064,414,650,0.675,0.62,0.551,16280,179.772,474,1497,0.872886297376093
"13429",239105,"MARQUETTE UNIVERSITY",1,0,2000,1675,926,749,963,404,559,0.604,0.575,0.539,17080,189.241,473,1426,0.85134328358209
"13430",239105,"MARQUETTE UNIVERSITY",1,0,2001,1658,950,708,947,374,573,0.603,0.571,0.528,18180,193.077,472,1410,0.850422195416164
"13431",239105,"MARQUETTE UNIVERSITY",1,0,2002,1856,1034,822,1052,433,619,0.599,0.567,0.527,19400,205.955,567,1574,0.848060344827586
"13432",239105,"MARQUETTE UNIVERSITY",1,0,2003,1882,1042,840,1125,462,663,0.636,0.598,0.55,20350,224.075,579,1648,0.875664187035069
"13433",239105,"MARQUETTE UNIVERSITY",1,0,2004,1802,979,823,1118,454,664,0.678,0.62,0.552,21550,243.286,589,1558,0.864594894561598
"13434",239105,"Marquette University",1,0,2005,1775,967,808,1083,448,635,0.657,0.61,0.554,22950,262.916,592,1488,0.83830985915493
"13435",239105,"Marquette University",1,0,2006,1842,1025,817,1096,445,651,0.635,0.595,0.545,24670,277.026,600,1494,0.811074918566775
"13436",239105,"Marquette University",1,0,2007,1811,966,845,1038,442,596,0.617,0.573,0.523,26270,290.918,609,1500,0.82827167310878
"13437",239105,"Marquette University",1,0,2008,1950,1043,907,1153,481,672,0.644,0.591,0.53,27720,313.46,622,1630,0.835897435897436
"13438",239105,"Marquette University",1,0,2009,1945,1005,940,1135,505,630,0.627,0.584,0.537,28680,327.559,627,1583,0.813881748071979
"13439",239105,"Marquette University",1,0,2010,1929,1015,914,1161,504,657,0.647,0.602,0.551,30040,330.88,629,1524,0.7900466562986
"13440",239628,"RIPON COLLEGE",1,0,1991,164,84,80,86,35,51,0.607,0.524,0.438,12900,17.551131,71,144,0.878048780487805
"13441",239628,"RIPON COLLEGE",1,0,1992,180,92,88,88,32,56,0.609,0.489,0.364,13170,18.769247,70,163,0.905555555555556
"13442",239628,"RIPON COLLEGE",1,0,1993,211,102,109,113,47,66,0.647,0.536,0.431,14340,19.797148,69,195,0.924170616113744
"13443",239628,"RIPON COLLEGE",1,0,1995,184,101,83,99,42,57,0.564,0.538,0.506,16110,22.811614,59,168,0.91304347826087
"13444",239628,"RIPON COLLEGE",1,0,1996,169,97,72,81,28,53,0.546,0.479,0.389,17000,23.546026,61,146,0.863905325443787
"13445",239628,"RIPON COLLEGE",1,0,1997,135,62,73,71,35,36,0.581,0.526,0.479,17580,15.220737,58,116,0.859259259259259
"13446",239628,"RIPON COLLEGE",1,0,1998,162,66,96,99,55,44,0.667,0.611,0.573,18240,16.033509,60,150,0.925925925925926
"13447",239628,"RIPON COLLEGE",1,0,1999,283,156,127,174,73,101,0.647,0.615,0.575,18000,17.684661,61,247,0.872791519434629
"13448",239628,"RIPON COLLEGE",1,0,2000,280,166,114,171,64,107,0.645,0.611,0.561,18000,18.424463,59,242,0.864285714285714
"13449",239628,"RIPON COLLEGE",1,0,2001,200,108,92,119,48,71,0.657,0.595,0.522,19260,20.395089,57,178,0.89
"13450",239628,"RIPON COLLEGE",1,0,2002,250,116,134,139,75,64,0.552,0.556,0.56,19260,19.781812,48,214,0.856
"13451",239628,"RIPON COLLEGE",1,0,2003,259,130,129,156,72,84,0.646,0.602,0.558,19700,18.771387,51,225,0.868725868725869
"13452",239628,"RIPON COLLEGE",1,0,2004,202,114,88,115,53,62,0.544,0.569,0.602,20490,19.08297,49,165,0.816831683168317
"13453",239628,"Ripon College",1,0,2005,261,119,142,148,70,78,0.655,0.567,0.493,21310,19.770185,50,216,0.827586206896552
"13454",239628,"Ripon College",1,0,2006,264,154,110,153,57,96,0.623,0.58,0.518,22162,21.46129,50,229,0.867424242424242
"13455",239628,"Ripon College",1,0,2007,262,124,138,158,78,80,0.645,0.603,0.565,23048,21.818547,53,232,0.885496183206107
"13456",239628,"Ripon College",1,0,2008,282,143,139,145,59,86,0.601,0.514,0.424,23970,24.697671,56,239,0.847517730496454
"13457",239628,"Ripon College",1,0,2009,248,123,125,148,68,80,0.65,0.597,0.544,25170,27.186349,62,189,0.762096774193548
"13458",239628,"Ripon College",1,0,2010,289,162,127,167,66,101,0.624,0.578,0.52,26806,28.342851,63,253,0.875432525951557
"13459",239716,"SAINT NORBERT COLLEGE",1,0,1991,442,262,180,288,95,193,0.737,0.652,0.528,10225,28.995476,110,430,0.972850678733032
"13460",239716,"SAINT NORBERT COLLEGE",1,0,1992,496,275,221,328,142,186,0.676,0.661,0.643,10805,30.379893,110,479,0.965725806451613
"13461",239716,"SAINT NORBERT COLLEGE",1,0,1993,569,320,249,352,142,210,0.656,0.619,0.57,11465,33.598495,109,538,0.945518453427065
"13462",239716,"SAINT NORBERT COLLEGE",1,0,1995,520,296,224,319,112,207,0.699,0.613,0.5,12940,38.692196,106,487,0.936538461538462
"13463",239716,"SAINT NORBERT COLLEGE",1,0,1996,508,321,187,339,121,218,0.679,0.667,0.647,13700,41.653887,108,489,0.96259842519685
"13464",239716,"SAINT NORBERT COLLEGE",1,0,1997,480,288,192,324,121,203,0.705,0.675,0.63,14234,34.311875,111,447,0.93125
"13465",239716,"SAINT NORBERT COLLEGE",1,0,1998,460,247,213,282,106,176,0.713,0.613,0.498,14789,35.66321,100,418,0.908695652173913
"13466",239716,"SAINT NORBERT COLLEGE",1,0,1999,519,296,223,332,136,196,0.662,0.64,0.61,15600,36.064222,100,480,0.92485549132948
"13467",239716,"SAINT NORBERT COLLEGE",1,0,2000,548,321,227,364,128,236,0.735,0.664,0.564,16570,36.636984,99,505,0.921532846715328
"13468",239716,"SAINT NORBERT COLLEGE",1,0,2001,558,306,252,359,142,217,0.709,0.643,0.563,17757,39.912485,98,514,0.921146953405018
"13469",239716,"SAINT NORBERT COLLEGE",1,0,2002,495,273,222,345,134,211,0.773,0.697,0.604,18834,42.584755,103,457,0.923232323232323
"13470",239716,"SAINT NORBERT COLLEGE",1,0,2003,529,289,240,336,128,208,0.72,0.635,0.533,19822,45.281753,108,493,0.931947069943289
"13471",239716,"SAINT NORBERT COLLEGE",1,0,2004,520,298,222,364,138,226,0.758,0.7,0.622,21210,45.103746,103,464,0.892307692307692
"13472",239716,"Saint Norbert College",1,0,2005,504,282,222,328,147,181,0.642,0.651,0.662,22209,44.231111,109,467,0.926587301587302
"13473",239716,"Saint Norbert College",1,0,2006,551,305,246,356,140,216,0.708,0.646,0.569,23097,45.15797,109,502,0.911070780399274
"13474",239716,"Saint Norbert College",1,0,2007,542,328,214,372,130,242,0.738,0.686,0.607,24253,47.074421,109,489,0.902214022140221
"13475",239716,"Saint Norbert College",1,0,2008,531,293,238,335,131,204,0.696,0.631,0.55,25526,50.282509,132,486,0.915254237288136
"13476",239716,"Saint Norbert College",1,0,2009,543,308,235,359,135,224,0.727,0.661,0.574,26522,52.365765,134,483,0.889502762430939
"13477",239716,"Saint Norbert College",1,0,2010,603,367,236,408,144,264,0.719,0.677,0.61,27583,55.122034,135,534,0.885572139303483
"13478",240107,"VITERBO COLLEGE",1,0,1991,201,145,56,63,14,49,0.338,0.313,0.25,7960,10.246939,72,187,0.930348258706468
"13479",240107,"VITERBO COLLEGE",1,0,1992,218,151,67,61,12,49,0.324,0.28,0.179,8360,12.194277,75,214,0.981651376146789
"13480",240107,"VITERBO COLLEGE",1,0,1993,270,205,65,67,14,53,0.258,0.248,0.215,8770,13.226135,73,257,0.951851851851852
"13481",240107,"VITERBO COLLEGE",1,0,1995,335,224,111,92,24,68,0.304,0.275,0.216,9850,18.324238,80,308,0.919402985074627
"13482",240107,"VITERBO COLLEGE",1,0,1996,284,195,89,70,10,60,0.308,0.246,0.112,10560,21.077345,81,271,0.954225352112676
"13483",240107,"VITERBO COLLEGE",1,0,1997,331,240,91,96,18,78,0.325,0.29,0.198,11150,16.433943,82,313,0.945619335347432
"13484",240107,"VITERBO COLLEGE",1,0,1998,318,220,98,88,21,67,0.304,0.277,0.214,11690,17.742295,82,290,0.911949685534591
"13485",240107,"VITERBO COLLEGE",1,0,1999,311,235,76,111,22,89,0.379,0.357,0.289,12220,19.198671,83,290,0.932475884244373
"13486",240107,"VITERBO UNIVERSITY",1,0,2000,327,252,75,98,16,82,0.325,0.3,0.213,12770,20.467693,86.5,308,0.941896024464832
"13487",240107,"VITERBO UNIVERSITY",1,0,2001,335,254,81,97,20,77,0.303,0.29,0.247,13350,21.4346,90,313,0.934328358208955
"13488",240107,"VITERBO UNIVERSITY",1,0,2002,321,236,85,91,19,72,0.305,0.283,0.224,14020,22.857265,92,298,0.928348909657321
"13489",240107,"VITERBO UNIVERSITY",1,0,2003,355,261,94,107,18,89,0.341,0.301,0.191,14900,23.491829,96,330,0.929577464788732
"13490",240107,"VITERBO UNIVERSITY",1,0,2004,308,210,98,82,19,63,0.3,0.266,0.194,15570,27.024337,106,286,0.928571428571429
"13491",240107,"Viterbo University",1,0,2005,289,207,82,82,11,71,0.343,0.284,0.134,16240,29.930476,109,271,0.937716262975779
"13492",240107,"Viterbo University",1,0,2006,308,223,85,100,21,79,0.354,0.325,0.247,17220,32.032155,110,275,0.892857142857143
"13493",240107,"Viterbo University",1,0,2007,361,252,109,108,26,82,0.325,0.299,0.239,18170,33.399391,109,341,0.944598337950138
"13494",240107,"Viterbo University",1,0,2008,357,250,107,102,27,75,0.3,0.286,0.252,19000,34.726349,107,337,0.943977591036415
"13495",240107,"Viterbo University",1,0,2009,405,287,118,119,24,95,0.331,0.294,0.203,19670,35.620824,112,373,0.920987654320988
"13496",240107,"Viterbo University",1,0,2010,340,242,98,103,21,82,0.339,0.303,0.214,20360,36.315846,119,309,0.908823529411765
"13497",240189,"UNIVERSITY OF WISCONSIN-WHITEWATER",1,0,1991,1765,990,775,200,60,140,0.141,0.113,0.077,1914,70.767662,400,1596,0.904249291784703
"13498",240189,"UNIVERSITY OF WISCONSIN-WHITEWATER",1,0,1992,1746,933,813,204,68,136,0.146,0.117,0.084,2039,72.283721,388,1575,0.902061855670103
"13499",240189,"UNIVERSITY OF WISCONSIN-WHITEWATER",1,0,1993,1823,1019,804,251,78,173,0.17,0.138,0.097,2178,80.429932,379,1671,0.916620954470653
"13500",240189,"UNIVERSITY OF WISCONSIN-WHITEWATER",1,0,1995,1856,989,867,294,108,186,0.188,0.158,0.125,2474,82.897165,368,1712,0.922413793103448
"13501",240189,"UNIVERSITY OF WISCONSIN-WHITEWATER",1,0,1996,1825,995,830,369,137,232,0.233,0.202,0.165,2586,84.50455,370,1704,0.933698630136986
"13502",240189,"UNIVERSITY OF WISCONSIN-WHITEWATER",1,0,1997,1881,944,937,349,138,211,0.224,0.186,0.147,2772,86.168338,366,1745,0.927698032961191
"13503",240189,"UNIVERSITY OF WISCONSIN-WHITEWATER",1,0,1998,1901,965,936,354,122,232,0.24,0.186,0.13,2919,89.734906,370,1756,0.923724355602315
"13504",240189,"UNIVERSITY OF WISCONSIN-WHITEWATER",1,0,1999,1877,1017,860,357,119,238,0.234,0.19,0.138,2594,96.416468,365,1718,0.915290356952584
"13505",240189,"UNIVERSITY OF WISCONSIN-WHITEWATER",1,0,2000,2052,1051,1001,423,155,268,0.255,0.206,0.155,2594,100.981438,359.5,1829,0.891325536062378
"13506",240189,"UNIVERSITY OF WISCONSIN-WHITEWATER",1,0,2001,1857,936,921,379,153,226,0.242,0.204,0.166,2776,108.850678,354,1681,0.905223478729133
"13507",240189,"UNIVERSITY OF WISCONSIN-WHITEWATER",1,0,2002,2004,1095,909,463,176,287,0.262,0.231,0.194,3106,111.930035,366,1827,0.911676646706587
"13508",240189,"UNIVERSITY OF WISCONSIN-WHITEWATER",1,0,2003,1825,975,850,459,199,260,0.267,0.252,0.234,3623,104.639092,390,1604,0.878904109589041
"13509",240189,"UNIVERSITY OF WISCONSIN-WHITEWATER",1,0,2004,1745,836,909,427,193,234,0.28,0.245,0.212,4150,112.368658,395,1474,0.844699140401146
"13510",240189,"University of Wisconsin-Whitewater",1,0,2005,1701,823,878,437,196,241,0.293,0.257,0.223,4427,113.440881,412,1509,0.887125220458554
"13511",240189,"University of Wisconsin-Whitewater",1,0,2006,1780,836,944,533,233,300,0.359,0.299,0.247,4728,118.974991,423,1615,0.907303370786517
"13512",240189,"University of Wisconsin-Whitewater",1,0,2007,2048,993,1055,564,258,306,0.308,0.275,0.245,4988,129.03101,409,1815,0.88623046875
"13513",240189,"University of Wisconsin-Whitewater",1,0,2008,2132,1025,1107,575,276,299,0.292,0.27,0.249,5262,136.584913,425,1859,0.871951219512195
"13514",240189,"University of Wisconsin-Whitewater",1,0,2009,1941,941,1000,542,250,292,0.31,0.279,0.25,5551,143.314928,423,1655,0.852653271509531
"13515",240189,"University of Wisconsin-Whitewater",1,0,2010,2033,973,1060,590,267,323,0.332,0.29,0.252,5857,155.299504,430,1750,0.860796851942941
"13516",240277,"UNIVERSITY OF WISCONSIN-GREEN BAY",1,0,1991,775,506,269,75,21,54,0.107,0.097,0.078,1806,37.847584,149,725,0.935483870967742
"13517",240277,"UNIVERSITY OF WISCONSIN-GREEN BAY",1,0,1992,780,487,293,85,22,63,0.129,0.109,0.075,1995,45.989897,153,715,0.916666666666667
"13518",240277,"UNIVERSITY OF WISCONSIN-GREEN BAY",1,0,1993,703,438,265,96,29,67,0.153,0.137,0.109,2104,46.335354,157,678,0.964438122332859
"13519",240277,"UNIVERSITY OF WISCONSIN-GREEN BAY",1,0,1995,780,522,258,98,30,68,0.13,0.126,0.116,2427,47.402331,146,755,0.967948717948718
"13520",240277,"UNIVERSITY OF WISCONSIN-GREEN BAY",1,0,1996,939,581,358,138,48,90,0.155,0.147,0.134,2548,48.861848,145,895,0.953141640042598
"13521",240277,"UNIVERSITY OF WISCONSIN-GREEN BAY",1,0,1997,895,568,327,141,39,102,0.18,0.158,0.119,2736,50.242501,151,859,0.959776536312849
"13522",240277,"UNIVERSITY OF WISCONSIN-GREEN BAY",1,0,1998,946,612,334,155,53,102,0.167,0.164,0.159,2916,55.257513,147,906,0.957716701902748
"13523",240277,"UNIVERSITY OF WISCONSIN-GREEN BAY",1,0,1999,879,578,301,164,45,119,0.206,0.187,0.15,2594,60.606249,163,828,0.9419795221843
"13524",240277,"UNIVERSITY OF WISCONSIN-GREEN BAY",1,0,2000,929,631,298,216,55,161,0.255,0.233,0.185,2594,68.351938,166,890,0.958019375672766
"13525",240277,"UNIVERSITY OF WISCONSIN-GREEN BAY",1,0,2001,866,608,258,214,45,169,0.278,0.247,0.174,2776,70.218117,169,824,0.951501154734411
"13526",240277,"UNIVERSITY OF WISCONSIN-GREEN BAY",1,0,2002,896,595,301,204,55,149,0.25,0.228,0.183,3000,65.007797,170,825,0.920758928571429
"13527",240277,"UNIVERSITY OF WISCONSIN-GREEN BAY",1,0,2003,960,640,320,241,70,171,0.267,0.251,0.219,3500,68.30934,177,896,0.933333333333333
"13528",240277,"UNIVERSITY OF WISCONSIN-GREEN BAY",1,0,2004,989,636,353,228,71,157,0.247,0.231,0.201,4000,74.310334,183,910,0.920121334681496
"13529",240277,"University of Wisconsin-Green Bay",1,0,2005,904,587,317,198,45,153,0.261,0.219,0.142,4277,73.321227,183,838,0.926991150442478
"13530",240277,"University of Wisconsin-Green Bay",1,0,2006,1019,667,352,226,63,163,0.244,0.222,0.179,4568,70.725347,175,928,0.910696761530913
"13531",240277,"University of Wisconsin-Green Bay",1,0,2007,987,644,343,201,42,159,0.247,0.204,0.122,4819,70.189292,177,904,0.915906788247214
"13532",240277,"University of Wisconsin-Green Bay",1,0,2008,1000,614,386,236,67,169,0.275,0.236,0.174,5084,74.561096,189,918,0.918
"13533",240277,"University of Wisconsin-Green Bay",1,0,2009,1037,647,390,248,58,190,0.294,0.239,0.149,5364,78.169057,188,928,0.894889103182257
"13534",240277,"University of Wisconsin-Green Bay",1,0,2010,894,572,322,214,46,168,0.294,0.239,0.143,5659,83.83104,194,804,0.899328859060403
"13535",240329,"UNIVERSITY OF WISCONSIN-LA CROSSE",1,0,1991,1648,959,689,159,57,102,0.106,0.096,0.083,1945,66.301566,362,1580,0.95873786407767
"13536",240329,"UNIVERSITY OF WISCONSIN-LA CROSSE",1,0,1992,1486,921,565,161,42,119,0.129,0.108,0.074,2076,68.989337,365,1390,0.935397039030956
"13537",240329,"UNIVERSITY OF WISCONSIN-LA CROSSE",1,0,1993,1695,1008,687,243,83,160,0.159,0.143,0.121,2217,70.897325,369,1595,0.941002949852507
"13538",240329,"UNIVERSITY OF WISCONSIN-LA CROSSE",1,0,1995,1731,1035,696,324,104,220,0.213,0.187,0.149,2513,79.554789,354,1643,0.949162333911034
"13539",240329,"UNIVERSITY OF WISCONSIN-LA CROSSE",1,0,1996,1721,1074,647,393,109,284,0.264,0.228,0.168,2633,82.750934,347,1650,0.958744915746659
"13540",240329,"UNIVERSITY OF WISCONSIN-LA CROSSE",1,0,1997,1700,1042,658,386,108,278,0.267,0.227,0.164,2857,87.987605,342,1620,0.952941176470588
"13541",240329,"UNIVERSITY OF WISCONSIN-LA CROSSE",1,0,1998,1740,1123,617,450,128,322,0.287,0.259,0.207,3009,94.408006,345,1649,0.947701149425287
"13542",240329,"UNIVERSITY OF WISCONSIN-LA CROSSE",1,0,1999,1631,1035,596,395,128,267,0.258,0.242,0.215,2594,89.61818,340,1544,0.946658491722869
"13543",240329,"UNIVERSITY OF WISCONSIN-LA CROSSE",1,0,2000,1609,1009,600,420,131,289,0.286,0.261,0.218,2594,104.076608,347,1501,0.932877563704164
"13544",240329,"UNIVERSITY OF WISCONSIN-LA CROSSE",1,0,2001,1596,1022,574,444,138,306,0.299,0.278,0.24,2776,111.661912,354,1504,0.942355889724311
"13545",240329,"UNIVERSITY OF WISCONSIN-LA CROSSE",1,0,2002,1555,1006,549,463,128,335,0.333,0.298,0.233,3000,101.219435,349,1456,0.936334405144695
"13546",240329,"UNIVERSITY OF WISCONSIN-LA CROSSE",1,0,2003,1506,984,522,507,153,354,0.36,0.337,0.293,3540,102.155666,356,1398,0.928286852589641
"13547",240329,"UNIVERSITY OF WISCONSIN-LA CROSSE",1,0,2004,1539,958,581,498,157,341,0.356,0.324,0.27,4040,105.974865,358,1411,0.916829109811566
"13548",240329,"University of Wisconsin-La Crosse",1,0,2005,1755,1056,699,579,176,403,0.382,0.33,0.252,4331,106.68451,360,1611,0.917948717948718
"13549",240329,"University of Wisconsin-La Crosse",1,0,2006,1751,1098,653,633,190,443,0.404,0.362,0.291,4623,110.896755,357,1585,0.905197030268418
"13550",240329,"University of Wisconsin-La Crosse",1,0,2007,1750,1084,666,621,196,425,0.392,0.355,0.294,4876,116.26802,370,1558,0.890285714285714
"13551",240329,"University of Wisconsin-La Crosse",1,0,2008,1779,1081,698,577,192,385,0.356,0.324,0.275,5643,118.234747,360,1573,0.884204609331085
"13552",240329,"University of Wisconsin-La Crosse",1,0,2009,1826,1128,698,660,193,467,0.414,0.361,0.277,6425,129.04209,384,1608,0.880613362541073
"13553",240329,"University of Wisconsin-La Crosse",1,0,2010,1836,1093,743,660,209,451,0.413,0.359,0.281,6809,138.852427,404,1648,0.89760348583878
"13554",240338,"WISCONSIN LUTHERAN COLLEGE",1,0,1991,71,45,26,20,8,12,0.267,0.282,0.308,7500,5.282816,22,69,0.971830985915493
"13555",240338,"WISCONSIN LUTHERAN COLLEGE",1,0,1992,77,45,32,22,7,15,0.333,0.286,0.219,8280,6.872634,24,73,0.948051948051948
"13556",240338,"WISCONSIN LUTHERAN COLLEGE",1,0,1993,80,55,25,31,10,21,0.382,0.388,0.4,8600,6.519208,25,74,0.925
"13557",240338,"WISCONSIN LUTHERAN COLLEGE",1,0,1995,109,63,46,51,18,33,0.524,0.468,0.391,9940,8.307274,29,105,0.963302752293578
"13558",240338,"WISCONSIN LUTHERAN COLLEGE",1,0,1996,101,71,30,55,12,43,0.606,0.545,0.4,11000,7.025154,31,95,0.940594059405941
"13559",240338,"WISCONSIN LUTHERAN COLLEGE",1,0,1997,109,61,48,50,21,29,0.475,0.459,0.438,11450,7.533418,29,104,0.954128440366973
"13560",240338,"WISCONSIN LUTHERAN COLLEGE",1,0,1998,124,80,44,60,20,40,0.5,0.484,0.455,11960,8.8766,33,120,0.967741935483871
"13561",240338,"WISCONSIN LUTHERAN COLLEGE",1,0,1999,161,92,69,79,23,56,0.609,0.491,0.333,12460,10.759044,39,149,0.925465838509317
"13562",240338,"WISCONSIN LUTHERAN COLLEGE",1,0,2000,194,125,69,91,33,58,0.464,0.469,0.478,12980,12.183624,42,184,0.948453608247423
"13563",240338,"WISCONSIN LUTHERAN COLLEGE",1,0,2001,200,124,76,96,31,65,0.524,0.48,0.408,13990,15.208885,45,194,0.97
"13564",240338,"WISCONSIN LUTHERAN COLLEGE",1,0,2002,158,88,70,79,31,48,0.545,0.5,0.443,14970,15.629203,50,147,0.930379746835443
"13565",240338,"WISCONSIN LUTHERAN COLLEGE",1,0,2003,207,126,81,110,31,79,0.627,0.531,0.383,15720,16.281884,43,196,0.946859903381642
"13566",240338,"WISCONSIN LUTHERAN COLLEGE",1,0,2004,186,112,74,79,28,51,0.455,0.425,0.378,16510,17.308235,44,173,0.93010752688172
"13567",240338,"Wisconsin Lutheran College",1,0,2005,180,110,70,81,33,48,0.436,0.45,0.471,17340,19.99759,50,172,0.955555555555556
"13568",240338,"Wisconsin Lutheran College",1,0,2006,198,116,82,81,31,50,0.431,0.409,0.378,18520,23.262883,57,184,0.929292929292929
"13569",240338,"Wisconsin Lutheran College",1,0,2007,181,97,84,82,34,48,0.495,0.453,0.405,19430,25.696017,61,155,0.856353591160221
"13570",240338,"Wisconsin Lutheran College",1,0,2008,223,128,95,110,43,67,0.523,0.493,0.453,20420,26.070924,60,190,0.852017937219731
"13571",240338,"Wisconsin Lutheran College",1,0,2009,202,104,98,89,33,56,0.538,0.441,0.337,21040,26.394378,61,176,0.871287128712871
"13572",240338,"Wisconsin Lutheran College",1,0,2010,246,136,110,108,32,76,0.559,0.439,0.291,21820,24.65726,58,206,0.83739837398374
"13573",240365,"UNIVERSITY OF WISCONSIN-OSHKOSH",1,0,1991,1411,787,624,136,31,105,0.133,0.096,0.05,1821,77.288906,382,1314,0.931254429482636
"13574",240365,"UNIVERSITY OF WISCONSIN-OSHKOSH",1,0,1992,1461,834,627,172,32,140,0.168,0.118,0.051,1927,79.787583,372,1356,0.928131416837782
"13575",240365,"UNIVERSITY OF WISCONSIN-OSHKOSH",1,0,1993,1465,833,632,200,53,147,0.176,0.137,0.084,2037,83.172978,356,1368,0.933788395904437
"13576",240365,"UNIVERSITY OF WISCONSIN-OSHKOSH",1,0,1995,1487,844,643,211,74,137,0.162,0.142,0.115,2300,90.292715,340,1428,0.960322797579018
"13577",240365,"UNIVERSITY OF WISCONSIN-OSHKOSH",1,0,1996,1501,855,646,227,65,162,0.19,0.151,0.101,2417,91.847798,350,1432,0.954030646235843
"13578",240365,"UNIVERSITY OF WISCONSIN-OSHKOSH",1,0,1997,1719,994,725,242,69,173,0.174,0.141,0.095,2607,93.128885,360,1656,0.963350785340314
"13579",240365,"UNIVERSITY OF WISCONSIN-OSHKOSH",1,0,1998,1894,1095,799,252,67,185,0.169,0.133,0.084,2780,97.982638,382,1820,0.960929250263992
"13580",240365,"UNIVERSITY OF WISCONSIN-OSHKOSH",1,0,1999,1834,1084,750,284,85,199,0.184,0.155,0.113,2594,103.847194,360,1750,0.954198473282443
"13581",240365,"UNIVERSITY OF WISCONSIN-OSHKOSH",1,0,2000,1624,969,655,236,65,171,0.176,0.145,0.099,2594,108.7502,342,1550,0.954433497536946
"13582",240365,"UNIVERSITY OF WISCONSIN-OSHKOSH",1,0,2001,1822,994,828,249,86,163,0.164,0.137,0.104,2776,116.444668,324,1726,0.947310647639956
"13583",240365,"UNIVERSITY OF WISCONSIN-OSHKOSH",1,0,2002,1775,1045,730,259,71,188,0.18,0.146,0.097,3000,112.329671,341,1669,0.940281690140845
"13584",240365,"UNIVERSITY OF WISCONSIN-OSHKOSH",1,0,2003,1765,1077,688,261,67,194,0.18,0.148,0.097,3551,124.327261,368,1641,0.929745042492918
"13585",240365,"UNIVERSITY OF WISCONSIN-OSHKOSH",1,0,2004,1708,1033,675,250,78,172,0.166,0.146,0.116,4110,132.347924,405,1577,0.923302107728337
"13586",240365,"University of Wisconsin-Oshkosh",1,0,2005,1617,982,635,234,81,153,0.156,0.145,0.128,4387,129.585732,385,1471,0.909709338280767
"13587",240365,"University of Wisconsin-Oshkosh",1,0,2006,1726,1024,702,272,83,189,0.185,0.158,0.118,4678,134.374606,377,1575,0.912514484356895
"13588",240365,"University of Wisconsin-Oshkosh",1,0,2007,1723,1018,705,300,96,204,0.2,0.174,0.136,4929,139.709558,386,1576,0.914683691236216
"13589",240365,"University of Wisconsin-Oshkosh",1,0,2008,1807,1048,759,294,112,182,0.174,0.163,0.148,5194,149.048664,389,1618,0.895406751521859
"13590",240365,"University of Wisconsin-Oshkosh",1,0,2009,1874,1061,813,274,95,179,0.169,0.146,0.117,5477,159.310702,413,1680,0.896478121664888
"13591",240365,"University of Wisconsin-Oshkosh",1,0,2010,1817,1039,778,328,116,212,0.204,0.181,0.149,5775,166.346529,424,1610,0.886075949367089
"13592",240374,"UNIVERSITY OF WISCONSIN-PARKSIDE",1,0,1991,627,333,294,29,11,18,0.054,0.046,0.037,1863,33.841447,164,556,0.886762360446571
"13593",240374,"UNIVERSITY OF WISCONSIN-PARKSIDE",1,0,1992,633,321,312,32,14,18,0.056,0.051,0.045,1990,34.963095,161,549,0.867298578199052
"13594",240374,"UNIVERSITY OF WISCONSIN-PARKSIDE",1,0,1993,668,355,313,51,17,34,0.096,0.076,0.054,2113,35.422157,163,566,0.847305389221557
"13595",240374,"UNIVERSITY OF WISCONSIN-PARKSIDE",1,0,1995,637,369,268,42,13,29,0.079,0.066,0.049,2406,38.350656,158,532,0.835164835164835
"13596",240374,"UNIVERSITY OF WISCONSIN-PARKSIDE",1,0,1996,606,354,252,49,14,35,0.099,0.081,0.056,2523,38.680288,157,530,0.874587458745875
"13597",240374,"UNIVERSITY OF WISCONSIN-PARKSIDE",1,0,1997,726,440,286,87,24,63,0.143,0.12,0.084,2705,39.210083,153,583,0.803030303030303
"13598",240374,"UNIVERSITY OF WISCONSIN-PARKSIDE",1,0,1998,790,441,349,83,24,59,0.134,0.105,0.069,2840,41.819555,143,644,0.815189873417722
"13599",240374,"UNIVERSITY OF WISCONSIN-PARKSIDE",1,0,1999,811,419,392,78,30,48,0.115,0.096,0.077,2594,44.927893,152,644,0.794081381011097
"13600",240374,"UNIVERSITY OF WISCONSIN-PARKSIDE",1,0,2000,747,413,334,82,31,51,0.124,0.11,0.093,2594,49.777471,157.5,578,0.77376171352075
"13601",240374,"UNIVERSITY OF WISCONSIN-PARKSIDE",1,0,2001,854,486,368,84,21,63,0.13,0.098,0.057,2776,53.965203,163,678,0.793911007025761
"13602",240374,"UNIVERSITY OF WISCONSIN-PARKSIDE",1,0,2002,760,418,342,70,24,46,0.11,0.092,0.07,3000,48.108757,177,627,0.825
"13603",240374,"UNIVERSITY OF WISCONSIN-PARKSIDE",1,0,2003,863,469,394,68,27,41,0.087,0.079,0.069,3500,50.187817,170,713,0.826187717265353
"13604",240374,"UNIVERSITY OF WISCONSIN-PARKSIDE",1,0,2004,890,491,399,87,34,53,0.108,0.098,0.085,4000,53.272728,174,670,0.752808988764045
"13605",240374,"University of Wisconsin-Parkside",1,0,2005,783,442,341,61,27,34,0.077,0.078,0.079,4277,56.16469,170,582,0.743295019157088
"13606",240374,"University of Wisconsin-Parkside",1,0,2006,814,442,372,60,18,42,0.095,0.074,0.048,4568,57.452913,175,587,0.721130221130221
"13607",240374,"University of Wisconsin-Parkside",1,0,2007,833,418,415,75,38,37,0.088,0.09,0.092,4819,58.491679,171,600,0.720288115246098
"13608",240374,"University of Wisconsin-Parkside",1,0,2008,833,420,413,70,36,34,0.081,0.084,0.087,5084,59.658644,173,544,0.653061224489796
"13609",240374,"University of Wisconsin-Parkside",1,0,2009,788,427,361,88,31,57,0.134,0.112,0.086,5364,66.352545,174,557,0.706852791878173
"13610",240374,"University of Wisconsin-Parkside",1,0,2010,711,355,356,40,14,26,0.073,0.056,0.039,5659,75.508969,177,492,0.691983122362869
"13611",240417,"UNIVERSITY OF WISCONSIN-STOUT",1,0,1991,1158,606,552,77,19,58,0.096,0.066,0.034,1933,71.575546,310,1086,0.937823834196891
"13612",240417,"UNIVERSITY OF WISCONSIN-STOUT",1,0,1992,988,530,458,114,25,89,0.168,0.115,0.055,2054,73.160475,298,909,0.92004048582996
"13613",240417,"UNIVERSITY OF WISCONSIN-STOUT",1,0,1993,1023,488,535,143,36,107,0.219,0.14,0.067,2175,74.692344,300,962,0.940371456500489
"13614",240417,"UNIVERSITY OF WISCONSIN-STOUT",1,0,1995,1133,542,591,143,36,107,0.197,0.126,0.061,2461,79.93944,287,1085,0.957634598411297
"13615",240417,"UNIVERSITY OF WISCONSIN-STOUT",1,0,1996,1275,644,631,194,61,133,0.206,0.152,0.097,2619,78.278898,294,1226,0.96156862745098
"13616",240417,"UNIVERSITY OF WISCONSIN-STOUT",1,0,1997,1241,604,637,170,47,123,0.204,0.137,0.074,2806,79.910277,276,1185,0.954875100725222
"13617",240417,"UNIVERSITY OF WISCONSIN-STOUT",1,0,1998,1333,614,719,209,74,135,0.22,0.157,0.103,2938,89.080487,290,1287,0.965491372843211
"13618",240417,"UNIVERSITY OF WISCONSIN-STOUT",1,0,1999,1317,661,656,185,57,128,0.194,0.14,0.087,2724,93.349135,282,1259,0.955960516324981
"13619",240417,"UNIVERSITY OF WISCONSIN-STOUT",1,0,2000,1307,668,639,195,58,137,0.205,0.149,0.091,2724,98.961355,276.5,1258,0.962509563886764
"13620",240417,"UNIVERSITY OF WISCONSIN-STOUT",1,0,2001,1272,652,620,202,62,140,0.215,0.159,0.1,2916,109.955008,271,1225,0.963050314465409
"13621",240417,"UNIVERSITY OF WISCONSIN-STOUT",1,0,2002,1303,658,645,219,51,168,0.255,0.168,0.079,3150,94.220904,282,1243,0.953952417498081
"13622",240417,"UNIVERSITY OF WISCONSIN-STOUT",1,0,2003,1267,654,613,244,75,169,0.258,0.193,0.122,5024,97.823313,295,1216,0.959747434885556
"13623",240417,"UNIVERSITY OF WISCONSIN-STOUT",1,0,2004,1277,649,628,254,67,187,0.288,0.199,0.107,5580,101.31888,310,1178,0.92247454972592
"13624",240417,"University of Wisconsin-Stout",1,0,2005,1699,863,836,322,103,219,0.254,0.19,0.123,4745,102.352856,304,1565,0.921130076515597
"13625",240417,"University of Wisconsin-Stout",1,0,2006,1507,792,715,275,90,185,0.234,0.182,0.126,5087,111.06355,312,1394,0.925016589250166
"13626",240417,"University of Wisconsin-Stout",1,0,2007,1489,763,726,309,108,201,0.263,0.208,0.149,5367,114.260199,308,1375,0.923438549361988
"13627",240417,"University of Wisconsin-Stout",1,0,2008,1633,837,796,313,103,210,0.251,0.192,0.129,5662,121.491356,327,1502,0.919779546846295
"13628",240417,"University of Wisconsin-Stout",1,0,2009,1517,788,729,350,111,239,0.303,0.231,0.152,5974,127.833803,336,1395,0.919578114700066
"13629",240417,"University of Wisconsin-Stout",1,0,2010,1571,756,815,324,124,200,0.265,0.206,0.152,6302,135.142055,333,1428,0.90897517504774
"13630",240426,"UNIVERSITY OF WISCONSIN-SUPERIOR",1,0,1991,443,220,223,24,10,14,0.064,0.054,0.045,1806,27.711058,90,420,0.948081264108352
"13631",240426,"UNIVERSITY OF WISCONSIN-SUPERIOR",1,0,1992,350,189,161,35,14,21,0.111,0.1,0.087,1917,28.918791,101,319,0.911428571428571
"13632",240426,"UNIVERSITY OF WISCONSIN-SUPERIOR",1,0,1993,323,182,141,41,14,27,0.148,0.127,0.099,2036,29.303042,100,306,0.947368421052632
"13633",240426,"UNIVERSITY OF WISCONSIN-SUPERIOR",1,0,1995,288,173,115,52,17,35,0.202,0.181,0.148,2335,31.664442,95,268,0.930555555555556
"13634",240426,"UNIVERSITY OF WISCONSIN-SUPERIOR",1,0,1996,308,158,150,42,13,29,0.184,0.136,0.087,2463,31.330124,97,286,0.928571428571429
"13635",240426,"UNIVERSITY OF WISCONSIN-SUPERIOR",1,0,1997,326,182,144,36,13,23,0.126,0.11,0.09,2652,32.134265,102,300,0.920245398773006
"13636",240426,"UNIVERSITY OF WISCONSIN-SUPERIOR",1,0,1998,376,218,158,55,16,39,0.179,0.146,0.101,2770,34.402788,98,356,0.946808510638298
"13637",240426,"UNIVERSITY OF WISCONSIN-SUPERIOR",1,0,1999,406,241,165,38,6,32,0.133,0.094,0.036,2594,37.191845,106,387,0.95320197044335
"13638",240426,"UNIVERSITY OF WISCONSIN-SUPERIOR",1,0,2000,395,234,161,57,21,36,0.154,0.144,0.13,2594,40.911808,100.5,367,0.929113924050633
"13639",240426,"UNIVERSITY OF WISCONSIN-SUPERIOR",1,0,2001,339,192,147,53,24,29,0.151,0.156,0.163,2776,45.64373,95,297,0.876106194690266
"13640",240426,"UNIVERSITY OF WISCONSIN-SUPERIOR",1,0,2002,286,150,136,37,15,22,0.147,0.129,0.11,3000,35.372016,97,254,0.888111888111888
"13641",240426,"UNIVERSITY OF WISCONSIN-SUPERIOR",1,0,2003,336,213,123,66,14,52,0.244,0.196,0.114,3650,35.254777,113,303,0.901785714285714
"13642",240426,"UNIVERSITY OF WISCONSIN-SUPERIOR",1,0,2004,329,190,139,54,20,34,0.179,0.164,0.144,4150,40.046105,114,293,0.890577507598784
"13643",240426,"University of Wisconsin-Superior",1,0,2005,336,208,128,61,11,50,0.24,0.182,0.086,4427,39.725064,114,290,0.863095238095238
"13644",240426,"University of Wisconsin-Superior",1,0,2006,293,143,150,53,26,27,0.189,0.181,0.173,4718,45.98148,115,255,0.870307167235495
"13645",240426,"University of Wisconsin-Superior",1,0,2007,343,197,146,47,14,33,0.168,0.137,0.096,4969,44.656559,116,307,0.895043731778426
"13646",240426,"University of Wisconsin-Superior",1,0,2008,303,168,135,59,15,44,0.262,0.195,0.111,5291,45.307272,114,259,0.854785478547855
"13647",240426,"University of Wisconsin-Superior",1,0,2009,364,194,170,58,22,36,0.186,0.159,0.129,5571,50.764722,116,297,0.815934065934066
"13648",240426,"University of Wisconsin-Superior",1,0,2010,369,197,172,80,27,53,0.269,0.217,0.157,5866,57.002818,126,303,0.821138211382114
"13649",240444,"UNIVERSITY OF WISCONSIN-MADISON",1,0,1991,4582,2387,2195,1516,589,927,0.388,0.331,0.268,2188,1192.036811,1647,4138,0.903099083369708
"13650",240444,"UNIVERSITY OF WISCONSIN-MADISON",1,0,1992,4390,2244,2146,1514,599,915,0.408,0.345,0.279,2346,1263.373043,1641,3910,0.890660592255125
"13651",240444,"UNIVERSITY OF WISCONSIN-MADISON",1,0,1993,4585,2396,2189,1686,659,1027,0.429,0.368,0.301,2540,1343.045292,1637,4052,0.883751363140676
"13652",240444,"UNIVERSITY OF WISCONSIN-MADISON",1,0,1995,5101,2779,2322,2037,768,1269,0.457,0.399,0.331,2881,1401.707301,1495,4547,0.891393844344246
"13653",240444,"UNIVERSITY OF WISCONSIN-MADISON",1,0,1996,5394,2954,2440,2090,769,1321,0.447,0.387,0.315,3030,1437.810172,1474,4772,0.884686688913608
"13654",240444,"UNIVERSITY OF WISCONSIN-MADISON",1,0,1997,5828,3156,2672,2303,835,1468,0.465,0.395,0.312,3241,1205.241497,1421,5148,0.883321894303363
"13655",240444,"UNIVERSITY OF WISCONSIN-MADISON",1,0,1998,5548,3038,2510,2190,844,1346,0.443,0.395,0.336,3408,1301.522564,1436,4850,0.874188896899784
"13656",240444,"UNIVERSITY OF WISCONSIN-MADISON",1,0,1999,5520,2985,2535,2263,847,1416,0.474,0.41,0.334,3290,1332.182882,1397,4831,0.87518115942029
"13657",240444,"UNIVERSITY OF WISCONSIN-MADISON",1,0,2000,5636,3120,2516,2500,963,1537,0.493,0.444,0.383,3290,1479.290777,1445.5,4979,0.883427963094393
"13658",240444,"UNIVERSITY OF WISCONSIN-MADISON",1,0,2001,6050,3370,2680,2758,1046,1712,0.508,0.456,0.39,3658,1610.3083,1494,5223,0.863305785123967
"13659",240444,"UNIVERSITY OF WISCONSIN-MADISON",1,0,2002,5488,3016,2472,2729,1037,1692,0.561,0.497,0.419,3854,1536.515881,1461,4742,0.864067055393586
"13660",240444,"UNIVERSITY OF WISCONSIN-MADISON",1,0,2003,5553,2968,2585,2689,1114,1575,0.531,0.484,0.431,4554,1643.577596,1614,4649,0.837205114352602
"13661",240444,"UNIVERSITY OF WISCONSIN-MADISON",1,0,2004,5617,3124,2493,2792,1096,1696,0.543,0.497,0.44,5254,1796.248705,1623,4607,0.820188712836033
"13662",240444,"University of Wisconsin-Madison",1,0,2005,6118,3434,2684,3174,1255,1919,0.559,0.519,0.468,5618,1878.040572,1646,4942,0.807780320366133
"13663",240444,"University of Wisconsin-Madison",1,0,2006,5633,3033,2600,2965,1202,1763,0.581,0.526,0.462,6000,1931.143253,1686,4458,0.791407775608024
"13664",240444,"University of Wisconsin-Madison",1,0,2007,5980,3197,2783,3291,1332,1959,0.613,0.55,0.479,6330,1988.673506,1650,4658,0.778929765886288
"13665",240444,"University of Wisconsin-Madison",1,0,2008,5759,3027,2732,3148,1333,1815,0.6,0.547,0.488,6678,2125.029369,1641,4465,0.775308213231464
"13666",240444,"University of Wisconsin-Madison",1,0,2009,5673,3033,2640,3179,1277,1902,0.627,0.56,0.484,7296,2277.086731,1658,4394,0.774546095540279
"13667",240444,"University of Wisconsin-Madison",1,0,2010,5920,3108,2812,3337,1328,2009,0.646,0.564,0.472,7933,2298.77243,1665,4676,0.789864864864865
"13668",240453,"UNIVERSITY OF WISCONSIN-MILWAUKEE",1,0,1991,1392,730,662,145,53,92,0.126,0.104,0.08,2231,209.217843,813,1241,0.891522988505747
"13669",240453,"UNIVERSITY OF WISCONSIN-MILWAUKEE",1,0,1992,1187,566,621,113,40,73,0.129,0.095,0.064,2391,217.583793,806,1056,0.889637742207245
"13670",240453,"UNIVERSITY OF WISCONSIN-MILWAUKEE",1,0,1993,1712,849,863,117,51,66,0.078,0.068,0.059,2548,226.457268,797,1411,0.824182242990654
"13671",240453,"UNIVERSITY OF WISCONSIN-MILWAUKEE",1,0,1995,1785,926,859,186,75,111,0.12,0.104,0.087,2947,240.596115,782,1467,0.821848739495798
"13672",240453,"UNIVERSITY OF WISCONSIN-MILWAUKEE",1,0,1996,2033,1113,920,233,88,145,0.13,0.115,0.096,3102,242.063118,754,1690,0.831283817019184
"13673",240453,"UNIVERSITY OF WISCONSIN-MILWAUKEE",1,0,1997,2272,1263,1009,327,124,203,0.161,0.144,0.123,3327,248.659129,743,1866,0.821302816901408
"13674",240453,"UNIVERSITY OF WISCONSIN-MILWAUKEE",1,0,1998,2513,1367,1146,273,102,171,0.125,0.109,0.089,3482,266.259641,724,2019,0.803422204536411
"13675",240453,"UNIVERSITY OF WISCONSIN-MILWAUKEE",1,0,1999,2694,1523,1171,356,127,229,0.15,0.132,0.108,3194,281.714543,751,2243,0.832590942835932
"13676",240453,"UNIVERSITY OF WISCONSIN-MILWAUKEE",1,0,2000,2663,1449,1214,395,142,253,0.175,0.148,0.117,3194,290.831192,763,2187,0.821254224558768
"13677",240453,"UNIVERSITY OF WISCONSIN-MILWAUKEE",1,0,2001,2884,1532,1352,423,160,263,0.172,0.147,0.118,3462,324.949071,775,2335,0.809639389736477
"13678",240453,"UNIVERSITY OF WISCONSIN-MILWAUKEE",1,0,2002,3178,1736,1442,457,175,282,0.162,0.144,0.121,3738,320.909434,809,2633,0.828508495909377
"13679",240453,"UNIVERSITY OF WISCONSIN-MILWAUKEE",1,0,2003,3716,2023,1693,552,217,335,0.166,0.149,0.128,4439,333.801501,902,3089,0.831270182992465
"13680",240453,"UNIVERSITY OF WISCONSIN-MILWAUKEE",1,0,2004,3714,2000,1714,555,216,339,0.169,0.149,0.126,5138,351.388831,935,3051,0.821486268174475
"13681",240453,"University of Wisconsin-Milwaukee",1,0,2005,4218,2233,1985,604,258,346,0.155,0.143,0.13,5494,371.98765,964,3456,0.819345661450925
"13682",240453,"University of Wisconsin-Milwaukee",1,0,2006,3977,2064,1913,554,247,307,0.149,0.139,0.129,5868,389.710029,991,3280,0.824742268041237
"13683",240453,"University of Wisconsin-Milwaukee",1,0,2007,4465,2228,2237,585,259,326,0.146,0.131,0.116,6191,419.625586,996,3619,0.810526315789474
"13684",240453,"University of Wisconsin-Milwaukee",1,0,2008,4002,2100,1902,572,246,326,0.155,0.143,0.129,6531,443.326857,1022,3124,0.780609695152424
"13685",240453,"University of Wisconsin-Milwaukee",1,0,2009,4051,2020,2031,578,250,328,0.162,0.143,0.123,6890,460.903168,1041,3138,0.774623549740805
"13686",240453,"University of Wisconsin-Milwaukee",1,0,2010,3731,1876,1855,506,225,281,0.15,0.136,0.121,7269,487.327861,1075,2737,0.733583489681051
"13687",240462,"UNIVERSITY OF WISCONSIN-PLATTEVILLE",1,0,1991,986,339,647,110,56,54,0.159,0.112,0.087,1955,48.09629,227,939,0.952332657200811
"13688",240462,"UNIVERSITY OF WISCONSIN-PLATTEVILLE",1,0,1992,878,304,574,98,48,50,0.164,0.112,0.084,2087,50.059803,234,843,0.960136674259681
"13689",240462,"UNIVERSITY OF WISCONSIN-PLATTEVILLE",1,0,1993,917,276,641,109,51,58,0.21,0.119,0.08,2207,50.665176,221,871,0.949836423118866
"13690",240462,"UNIVERSITY OF WISCONSIN-PLATTEVILLE",1,0,1995,926,315,611,125,59,66,0.21,0.135,0.097,2485,55.320288,219,883,0.953563714902808
"13691",240462,"UNIVERSITY OF WISCONSIN-PLATTEVILLE",1,0,1996,933,300,633,120,59,61,0.203,0.129,0.093,2591,56.686168,206,907,0.972132904608789
"13692",240462,"UNIVERSITY OF WISCONSIN-PLATTEVILLE",1,0,1997,978,304,674,138,69,69,0.227,0.141,0.102,2775,57.851495,197,940,0.961145194274029
"13693",240462,"UNIVERSITY OF WISCONSIN-PLATTEVILLE",1,0,1998,1118,369,749,134,63,71,0.192,0.12,0.084,2916,61.095707,219,1070,0.957066189624329
"13694",240462,"UNIVERSITY OF WISCONSIN-PLATTEVILLE",1,0,1999,1093,377,716,148,61,87,0.231,0.135,0.085,2594,63.705838,212,1059,0.968892955169259
"13695",240462,"UNIVERSITY OF WISCONSIN-PLATTEVILLE",1,0,2000,958,340,618,129,53,76,0.224,0.135,0.086,2594,65.870336,210,925,0.965553235908142
"13696",240462,"UNIVERSITY OF WISCONSIN-PLATTEVILLE",1,0,2001,1039,373,666,176,85,91,0.244,0.169,0.128,2776,72.862389,208,1010,0.9720885466795
"13697",240462,"UNIVERSITY OF WISCONSIN-PLATTEVILLE",1,0,2002,1120,395,725,184,75,109,0.276,0.164,0.103,3000,68.944825,209,1076,0.960714285714286
"13698",240462,"UNIVERSITY OF WISCONSIN-PLATTEVILLE",1,0,2003,1116,406,710,203,105,98,0.241,0.182,0.148,3500,75.063829,237,1081,0.968637992831541
"13699",240462,"UNIVERSITY OF WISCONSIN-PLATTEVILLE",1,0,2004,1164,398,766,205,90,115,0.289,0.176,0.117,4000,75.435109,243,1103,0.947594501718213
"13700",240462,"University of Wisconsin-Platteville",1,0,2005,1218,426,792,187,83,104,0.244,0.154,0.105,4277,77.189826,248,1152,0.945812807881773
"13701",240462,"University of Wisconsin-Platteville",1,0,2006,1387,467,920,259,145,114,0.244,0.187,0.158,4568,81.882817,268,1292,0.931506849315068
"13702",240462,"University of Wisconsin-Platteville",1,0,2007,1466,500,966,275,127,148,0.296,0.188,0.131,4819,89.136995,278,1371,0.935197817189632
"13703",240462,"University of Wisconsin-Platteville",1,0,2008,1468,496,972,235,117,118,0.238,0.16,0.12,5184,93.658825,286,1353,0.921662125340599
"13704",240462,"University of Wisconsin-Platteville",1,0,2009,1531,512,1019,304,166,138,0.27,0.199,0.163,5466,99.981013,291,1409,0.920313520574788
"13705",240462,"University of Wisconsin-Platteville",1,0,2010,1534,508,1026,297,170,127,0.25,0.194,0.166,5766,101.962265,294,1428,0.930899608865711
"13706",240471,"UNIVERSITY OF WISCONSIN-RIVER FALLS",1,0,1991,1022,557,465,122,48,74,0.133,0.119,0.103,2199,52.166482,244,966,0.945205479452055
"13707",240471,"UNIVERSITY OF WISCONSIN-RIVER FALLS",1,0,1992,1009,543,466,151,68,83,0.153,0.15,0.146,2024,55.783022,234,962,0.953419226957384
"13708",240471,"UNIVERSITY OF WISCONSIN-RIVER FALLS",1,0,1993,838,443,395,162,64,98,0.221,0.193,0.162,2145,57.834935,238,776,0.926014319809069
"13709",240471,"UNIVERSITY OF WISCONSIN-RIVER FALLS",1,0,1995,957,548,409,204,73,131,0.239,0.213,0.178,2445,61.469649,222,909,0.949843260188088
"13710",240471,"UNIVERSITY OF WISCONSIN-RIVER FALLS",1,0,1996,1149,688,461,249,82,167,0.243,0.217,0.178,2565,63.326434,214,1106,0.962576153176675
"13711",240471,"UNIVERSITY OF WISCONSIN-RIVER FALLS",1,0,1997,1144,698,446,269,79,190,0.272,0.235,0.177,2750,64.675068,209,1100,0.961538461538462
"13712",240471,"UNIVERSITY OF WISCONSIN-RIVER FALLS",1,0,1998,1199,773,426,287,87,200,0.259,0.239,0.204,2890,68.640335,212,1149,0.958298582151793
"13713",240471,"UNIVERSITY OF WISCONSIN-RIVER FALLS",1,0,1999,1104,684,420,277,95,182,0.266,0.251,0.226,2594,73.212201,216,1038,0.940217391304348
"13714",240471,"UNIVERSITY OF WISCONSIN-RIVER FALLS",1,0,2000,1096,669,427,259,81,178,0.266,0.236,0.19,2594,80.009781,218,1018,0.928832116788321
"13715",240471,"UNIVERSITY OF WISCONSIN-RIVER FALLS",1,0,2001,1108,680,428,265,86,179,0.263,0.239,0.201,2776,85.364001,220,1028,0.927797833935018
"13716",240471,"UNIVERSITY OF WISCONSIN-RIVER FALLS",1,0,2002,1045,642,403,277,81,196,0.305,0.265,0.201,3000,61.477484,214,971,0.929186602870813
"13717",240471,"UNIVERSITY OF WISCONSIN-RIVER FALLS",1,0,2003,1220,757,463,305,98,207,0.273,0.25,0.212,3500,66.163827,221,1113,0.912295081967213
"13718",240471,"UNIVERSITY OF WISCONSIN-RIVER FALLS",1,0,2004,1197,722,475,311,109,202,0.28,0.26,0.229,4000,68.530144,223,1086,0.907268170426065
"13719",240471,"University of Wisconsin-River Falls",1,0,2005,1192,734,458,268,80,188,0.256,0.225,0.175,4277,71.288768,231,1076,0.902684563758389
"13720",240471,"University of Wisconsin-River Falls",1,0,2006,1289,773,516,281,77,204,0.264,0.218,0.149,4568,75.869581,238,1176,0.91233514352211
"13721",240471,"University of Wisconsin-River Falls",1,0,2007,1276,743,533,297,103,194,0.261,0.233,0.193,4891,86.273479,237,1184,0.927899686520376
"13722",240471,"University of Wisconsin-River Falls",1,0,2008,1332,783,549,365,136,229,0.292,0.274,0.248,5156,90.710984,241,1228,0.921921921921922
"13723",240471,"University of Wisconsin-River Falls",1,0,2009,1325,836,489,382,108,274,0.328,0.288,0.221,5436,92.532447,231,1214,0.91622641509434
"13724",240471,"University of Wisconsin-River Falls",1,0,2010,1230,758,472,360,112,248,0.327,0.293,0.237,5731,96.300899,240,1104,0.897560975609756
"13725",240480,"UNIVERSITY OF WISCONSIN-STEVENS POINT",1,0,1991,1494,763,731,183,62,121,0.159,0.122,0.085,1955,80.109568,367,1434,0.959839357429719
"13726",240480,"UNIVERSITY OF WISCONSIN-STEVENS POINT",1,0,1992,1388,772,616,229,61,168,0.218,0.165,0.099,2078,82.685612,349,1315,0.947406340057637
"13727",240480,"UNIVERSITY OF WISCONSIN-STEVENS POINT",1,0,1993,1359,702,657,201,72,129,0.184,0.148,0.11,2218,82.789049,344,1298,0.955114054451803
"13728",240480,"UNIVERSITY OF WISCONSIN-STEVENS POINT",1,0,1995,1474,817,657,285,82,203,0.249,0.193,0.125,2488,90.968201,324,1392,0.944369063772049
"13729",240480,"UNIVERSITY OF WISCONSIN-STEVENS POINT",1,0,1996,1555,806,749,301,97,204,0.253,0.194,0.13,2601,92.366546,314,1485,0.954983922829582
"13730",240480,"UNIVERSITY OF WISCONSIN-STEVENS POINT",1,0,1997,1527,837,690,262,78,184,0.22,0.172,0.113,2790,94.889823,308,1445,0.946299934512115
"13731",240480,"UNIVERSITY OF WISCONSIN-STEVENS POINT",1,0,1998,1503,868,635,310,85,225,0.259,0.206,0.134,2929,97.345165,311,1442,0.959414504324684
"13732",240480,"UNIVERSITY OF WISCONSIN-STEVENS POINT",1,0,1999,1490,849,641,285,99,186,0.219,0.191,0.154,2594,101.933374,311,1409,0.945637583892617
"13733",240480,"UNIVERSITY OF WISCONSIN-STEVENS POINT",1,0,2000,1518,925,593,333,107,226,0.244,0.219,0.18,2594,105.656449,314.5,1438,0.94729907773386
"13734",240480,"UNIVERSITY OF WISCONSIN-STEVENS POINT",1,0,2001,1505,849,656,297,108,189,0.223,0.197,0.165,2776,114.2242,318,1424,0.946179401993355
"13735",240480,"UNIVERSITY OF WISCONSIN-STEVENS POINT",1,0,2002,1464,806,658,286,109,177,0.22,0.195,0.166,3000,108.912459,316,1369,0.935109289617486
"13736",240480,"UNIVERSITY OF WISCONSIN-STEVENS POINT",1,0,2003,1498,853,645,335,101,234,0.274,0.224,0.157,3500,113.867037,369,1403,0.936582109479306
"13737",240480,"UNIVERSITY OF WISCONSIN-STEVENS POINT",1,0,2004,1525,857,668,322,118,204,0.238,0.211,0.177,4000,121.605466,366,1413,0.92655737704918
"13738",240480,"University of Wisconsin-Stevens Point",1,0,2005,1521,832,689,365,136,229,0.275,0.24,0.197,4277,119.153975,362,1414,0.92965154503616
"13739",240480,"University of Wisconsin-Stevens Point",1,0,2006,1640,888,752,395,153,242,0.272,0.241,0.203,4568,124.965474,349,1529,0.932317073170732
"13740",240480,"University of Wisconsin-Stevens Point",1,0,2007,1611,892,719,358,145,213,0.239,0.222,0.202,4819,133.727205,359,1458,0.905027932960894
"13741",240480,"University of Wisconsin-Stevens Point",1,0,2008,1608,882,726,412,145,267,0.303,0.256,0.2,5084,138.435098,355,1441,0.896144278606965
"13742",240480,"University of Wisconsin-Stevens Point",1,0,2009,1632,835,797,422,156,266,0.319,0.259,0.196,5364,141.570769,355,1454,0.89093137254902
"13743",240480,"University of Wisconsin-Stevens Point",1,0,2010,1644,881,763,499,213,286,0.325,0.304,0.279,5659,155.103886,375,1479,0.89963503649635
"13744",240727,"UNIVERSITY OF WYOMING",1,0,1991,1257,534,723,174,73,101,0.189,0.138,0.101,1293,172.941457,635,1105,0.879077167859984
"13745",240727,"UNIVERSITY OF WYOMING",1,0,1992,1281,640,641,221,73,148,0.231,0.173,0.114,1430,190.318057,600,1134,0.885245901639344
"13746",240727,"UNIVERSITY OF WYOMING",1,0,1993,1212,560,652,207,79,128,0.229,0.171,0.121,1648,192.223747,591,1080,0.891089108910891
"13747",240727,"UNIVERSITY OF WYOMING",1,0,1995,1267,661,606,276,88,188,0.284,0.218,0.145,2005,213.509458,626,1076,0.849250197316496
"13748",240727,"UNIVERSITY OF WYOMING",1,0,1996,1203,628,575,297,101,196,0.312,0.247,0.176,2144,205.061438,620,1035,0.860349127182045
"13749",240727,"UNIVERSITY OF WYOMING",1,0,1997,1119,562,557,276,97,179,0.318,0.247,0.174,2326,207.963777,615,956,0.854334226988382
"13750",240727,"UNIVERSITY OF WYOMING",1,0,1998,1225,660,565,306,104,202,0.306,0.25,0.184,2330,212.275713,612,1042,0.850612244897959
"13751",240727,"UNIVERSITY OF WYOMING",1,0,1999,1194,654,540,352,124,228,0.349,0.295,0.23,2016,219.420689,606,1042,0.872696817420435
"13752",240727,"UNIVERSITY OF WYOMING",1,0,2000,1313,658,655,337,126,211,0.321,0.257,0.192,2166,213.16853,605,1138,0.866717440974867
"13753",240727,"UNIVERSITY OF WYOMING",1,0,2001,1411,724,687,369,135,234,0.323,0.262,0.197,2316,249.593293,604,1256,0.890148830616584
"13754",240727,"UNIVERSITY OF WYOMING",1,0,2002,1443,733,710,328,113,215,0.293,0.227,0.159,2400,246.008038,612,1284,0.88981288981289
"13755",240727,"UNIVERSITY OF WYOMING",1,0,2003,1388,709,679,310,102,208,0.293,0.223,0.15,2520,273.593337,624,1224,0.881844380403458
"13756",240727,"UNIVERSITY OF WYOMING",1,0,2004,1496,754,742,336,133,203,0.269,0.225,0.179,2088,289.694461,643,1302,0.870320855614973
"13757",240727,"University of Wyoming",1,0,2005,1399,739,660,320,107,213,0.288,0.229,0.162,2208,307.911441,688,1219,0.871336669049321
"13758",240727,"University of Wyoming",1,0,2006,1543,761,782,359,118,241,0.317,0.233,0.151,2256,315.180324,666,1283,0.83149708360337
"13759",240727,"University of Wyoming",1,0,2007,1614,831,783,389,132,257,0.309,0.241,0.169,2256,334.864229,692,1356,0.840148698884758
"13760",240727,"University of Wyoming",1,0,2008,1674,851,823,408,148,260,0.306,0.244,0.18,2256,373.425537,715,1406,0.839904420549582
"13761",240727,"University of Wyoming",1,0,2009,1568,799,769,405,136,269,0.337,0.258,0.177,2256,405.223407,730,1331,0.848852040816326
"13762",240727,"University of Wyoming",1,0,2010,1451,711,740,386,144,242,0.34,0.266,0.195,2376,430.562185,740,1210,0.833907649896623
"13763",243443,"UNIVERSITY OF SACRED HEART",1,0,1991,518,370,148,1,0,1,0.003,0.002,0,2795,29.373834,168,0,0
"13764",243443,"UNIVERSITY OF SACRED HEART",1,0,1992,584,396,188,47,7,40,0.101,0.08,0.037,3245,27.532108,167,0,0
"13765",243443,"UNIVERSITY OF SACRED HEART",1,0,1993,796,541,255,44,8,36,0.066,0.055,0.031,3245,25.874677,141,0,0
"13766",243443,"UNIVERSITY OF SACRED HEART",1,0,1995,728,466,262,33,8,25,0.054,0.045,0.031,3745,27.451065,126,0,0
"13767",243443,"UNIVERSITY OF SACRED HEART",1,0,1996,780,483,297,46,11,35,0.072,0.059,0.037,3800,28.970351,123,0,0
"13768",243443,"UNIVERSITY OF SACRED HEART",1,0,1997,723,471,252,50,6,44,0.093,0.069,0.024,4000,20.578177,119,0,0
"13769",243443,"UNIVERSITY OF SACRED HEART",1,0,1998,885,567,318,76,10,66,0.116,0.086,0.031,4000,21.687269,118,0,0
"13770",243443,"UNIVERSITY OF SACRED HEART",1,0,1999,799,506,293,63,13,50,0.099,0.079,0.044,3900,22.673669,114,0,0
"13771",243443,"UNIVERSITY OF SACRED HEART",1,0,2000,540,350,190,59,10,49,0.14,0.109,0.053,4050,23.380745,110,0,0
"13772",243443,"UNIVERSITY OF SACRED HEART",1,0,2001,478,333,145,52,7,45,0.135,0.109,0.048,4200,26.290497,106,0,0
"13773",243443,"UNIVERSITY OF SACRED HEART",1,0,2002,496,320,176,43,8,35,0.109,0.087,0.045,4200,27.880471,108,0,0
"13774",243443,"UNIVERSITY OF SACRED HEART",1,0,2003,425,274,151,10,3,7,0.025,0.024,0.02,4350,30.026804,108,0,0
"13775",243443,"UNIVERSITY OF SACRED HEART",1,0,2004,519,340,179,50,11,39,0.115,0.096,0.061,4350,31.359384,105,0,0
"13776",243443,"University of Sacred Heart",1,0,2005,796,500,296,66,8,58,0.116,0.083,0.027,4500,34.940937,104,0,0
"13777",243443,"University of Sacred Heart",1,0,2006,764,532,232,66,13,53,0.1,0.086,0.056,4650,33.023301,100,0,0
"13778",243443,"University of Sacred Heart",1,0,2007,690,422,268,41,10,31,0.074,0.059,0.037,3840,32.158333,98,0,0
"13779",243443,"University of Sacred Heart",1,0,2008,750,435,315,43,9,34,0.078,0.057,0.029,3960,35.781694,99,0,0
"13780",243443,"University of Sacred Heart",1,0,2009,726,461,265,43,12,31,0.067,0.059,0.045,4080,38.585184,101,0,0
"13781",243443,"University of Sacred Heart",1,0,2010,933,541,392,63,19,44,0.081,0.068,0.048,4200,39.253544,100,0,0
"13782",243780,"PURDUE UNIVERSITY MAIN CAMPUS",1,0,1991,5754,2516,3238,1682,790,892,0.355,0.292,0.244,2324,567.065473,1485,5057,0.87886687521724
"13783",243780,"PURDUE UNIVERSITY MAIN CAMPUS",1,0,1992,5583,2396,3187,1589,761,828,0.346,0.285,0.239,2520,603.053451,1475,4886,0.875156725774673
"13784",243780,"PURDUE UNIVERSITY-MAIN CAMPUS",1,0,1993,5725,2560,3165,1625,773,852,0.333,0.284,0.244,2696,627.264029,1443,5059,0.883668122270742
"13785",243780,"PURDUE UNIVERSITY-MAIN CAMPUS",1,0,1995,6064,2696,3368,1625,786,839,0.311,0.268,0.233,3056,670.004914,1457,5375,0.886378627968338
"13786",243780,"PURDUE UNIVERSITY-MAIN CAMPUS",1,0,1996,6339,2713,3626,1843,903,940,0.346,0.291,0.249,3208,697.184789,1462,5548,0.875216911184729
"13787",243780,"PURDUE UNIVERSITY-MAIN CAMPUS",1,0,1997,6369,2806,3563,1994,953,1041,0.371,0.313,0.267,3352,756.600835,1469,5521,0.866855079290312
"13788",243780,"PURDUE UNIVERSITY-MAIN CAMPUS",1,0,1998,6625,2825,3800,2040,998,1042,0.369,0.308,0.263,3532,770.628106,1505,5820,0.878490566037736
"13789",243780,"PURDUE UNIVERSITY-MAIN CAMPUS",1,0,1999,6895,2945,3950,2083,974,1109,0.377,0.302,0.247,3409,836.154651,1481,5965,0.865119651921682
"13790",243780,"PURDUE UNIVERSITY-MAIN CAMPUS",1,0,2000,6403,2646,3757,2209,1046,1163,0.44,0.345,0.278,3552,882.379659,1652.5,5548,0.86646884272997
"13791",243780,"PURDUE UNIVERSITY-MAIN CAMPUS",1,0,2001,6567,2601,3966,2218,1059,1159,0.446,0.338,0.267,3830,936.519134,1824,5611,0.854423633318106
"13792",243780,"PURDUE UNIVERSITY-MAIN CAMPUS",1,0,2002,6294,2535,3759,2230,1046,1184,0.467,0.354,0.278,5228,968.153089,1831,5139,0.816491897044805
"13793",243780,"PURDUE UNIVERSITY-MAIN CAMPUS",1,0,2003,6459,2559,3900,2254,1121,1133,0.443,0.349,0.287,5498,1012.294646,1857,5345,0.827527481034216
"13794",243780,"PURDUE UNIVERSITY-MAIN CAMPUS",1,0,2004,6766,2781,3985,2419,1066,1353,0.486,0.358,0.268,5962,1093.749603,2131,5604,0.828258941767662
"13795",243780,"Purdue University-Main Campus",1,0,2005,7167,2860,4307,2547,1189,1358,0.475,0.355,0.276,6320,1217.891578,2183,5851,0.816380633458909
"13796",243780,"Purdue University-Main Campus",1,0,2006,7430,3019,4411,2764,1350,1414,0.468,0.372,0.306,6700,1210.225215,2255,5954,0.801345895020188
"13797",243780,"Purdue University-Main Campus",1,0,2007,6830,2882,3948,2702,1260,1442,0.5,0.396,0.319,7002,1264.493933,2347,5431,0.795168374816984
"13798",243780,"Purdue University-Main Campus",1,0,2008,7058,3083,3975,3028,1409,1619,0.525,0.429,0.354,7317,1367.653109,2311,5628,0.797393029186738
"13799",243780,"Purdue University-Main Campus",1,0,2009,6308,2660,3648,2868,1412,1456,0.547,0.455,0.387,8183,1443.567929,2367,4560,0.72289156626506
"13800",243780,"Purdue University-Main Campus",1,0,2010,6454,2706,3748,3133,1579,1554,0.574,0.485,0.421,8592,1505.591136,2393,4593,0.711651688875116
